MOVIE_TITLE;RELEASE_YEAR;TOMATOMETER_STATUS;RATING_TOMATOMETER;RATING_AUDIENCE;FRESH_CRITICS_COUNT;ROTTEN_CRITICS_COUNT;CRITICS_COUNT;TOP_CRITICS_COUNT
Percy Jackson & the Olympians: The Lightning Thief;2010;Rotten;49;53;73;76;149;43
Please Give;2010;Certified-Fresh;87;64;123;19;142;44
10;1979;Fresh;67;53;16;8;24;2
12 Angry Men (Twelve Angry Men);1957;Certified-Fresh;100;97;54;0;54;6
20,000 Leagues Under The Sea;1954;Fresh;89;74;24;3;27;5
10,000 B.C.;2008;Rotten;8;37;12;137;149;37
The 39 Steps;1935;Certified-Fresh;96;86;49;2;51;8
3:10 to Yuma;1957;Fresh;96;79;27;1;28;6
Charly (A Heartbeat Away);2002;Rotten;20;87;2;8;10;0
Abraham Lincoln;1930;Fresh;82;40;9;2;11;4
Dark Water;2002;Fresh;80;66;12;3;15;3
The Accused;1988;Fresh;91;79;20;2;22;1
The Lost City;2005;Rotten;25;64;21;62;83;37
The Breaking Point;1950;Fresh;100;86;10;0;10;1
Adam's Rib;1949;Fresh;96;86;27;1;28;6
The Bridge of San Luis Rey;2005;Rotten;4;35;1;23;24;13
The Prowler (Cost of Living );1951;Fresh;100;86;18;0;18;6
Criminal;2004;Fresh;69;57;85;39;124;35
The Adventures of Mark Twain;1985;Fresh;80;82;4;1;5;1
Deep Blue;2005;Fresh;67;80;35;17;52;18
The Adventures of Robin Hood;1938;Certified-Fresh;100;89;48;0;48;8
Man Hunt;1941;Fresh;92;75;11;1;12;0
Dead End;2003;Fresh;75;60;6;2;8;1
Bandwagon;1997;Fresh;80;91;4;1;5;1
Whore;2004;Rotten;0;63;0;6;6;4
Tristan & Isolde;2006;Rotten;31;71;38;83;121;36
Wild Side;2005;Fresh;63;80;10;6;16;4
A Tale of Two Pizzas;2003;Rotten;38;;3;5;8;5
Running Scared;2006;Rotten;41;79;54;77;131;39
Going the Distance;2004;Rotten;0;61;0;5;5;2
Ultraviolet;2006;Rotten;8;30;7;76;83;21
Home of the Brave;2004;Fresh;93;48;14;1;15;7
Arthur and the Invisibles;2007;Rotten;22;56;20;72;92;30
Malevolence;2004;Rotten;33;83;6;12;18;4
Eternal;2004;Rotten;21;39;7;27;34;10
A Farewell To Arms;1957;Rotten;0;37;0;12;12;6
The Narrow Margin;1952;Fresh;100;88;11;0;11;0
The Matador;2006;Certified-Fresh;75;65;117;39;156;39
Smile;2005;Rotten;15;66;2;11;13;6
The Intruder (L'Intrus);2005;Fresh;87;73;26;4;30;10
Saint Ralph;2005;Fresh;64;85;44;25;69;26
The Baxter;2005;Rotten;32;75;24;51;75;25
Oliver Twist;2005;Fresh;61;63;87;56;143;39
The Alamo;1960;Rotten;52;63;11;10;21;4
G;2005;Rotten;24;60;7;22;29;17
Alexander the Great;1956;Rotten;0;42;0;8;8;1
Alfie;1966;Fresh;96;76;26;1;27;6
Neverwas;2005;Rotten;14;65;1;6;7;1
The Second Chance;2006;Rotten;44;78;7;9;16;8
Moonlight;2003;Fresh;60;67;6;4;10;6
Aliens;1986;Certified-Fresh;97;94;74;2;76;17
Rise: Blood Hunter;2007;Rotten;36;20;5;9;14;2
All About Eve;1950;Certified-Fresh;99;94;76;1;77;22
When Do We Eat?;2006;Rotten;42;68;16;22;38;19
The Mostly Unfabulous Social Life of Ethan Green;2006;Rotten;30;58;8;19;27;13
Dirty;2006;Rotten;21;42;6;22;28;10
Stay Alive;2006;Rotten;10;55;6;53;59;18
All of Me;1984;Certified-Fresh;85;67;35;6;41;10
All Quiet on the Western Front;1900;Fresh;100;69;5;0;5;0
Dreamland;2006;Fresh;67;65;10;5;15;5
Independent Lens;2006;Certified-Fresh;84;84;42;8;50;22
All the King's Men;1949;Certified-Fresh;95;78;40;2;42;9
Street Fight;2005;Fresh;100;93;22;0;22;11
Lost Horizon;1973;Rotten;20;45;1;4;5;2
The Motel;2005;Fresh;88;64;28;4;32;14
Once in a Lifetime: The Extraordinary Story of the New York Cosmos;2006;Certified-Fresh;81;80;48;11;59;22
Requiem;2006;Fresh;86;66;31;5;36;17
Gui si (Silk);2006;Rotten;40;57;2;3;5;2
Park;2006;Rotten;36;48;4;7;11;6
The 4th Dimension;2006;Fresh;63;31;5;3;8;2
Bon Cop, Bad Cop;2006;Fresh;78;82;7;2;9;2
Amazing Grace;2007;Fresh;67;85;85;41;126;37
The Silence;1900;Rotten;50;38;3;3;6;4
Cocaine Cowboys;2006;Fresh;69;79;35;16;51;25
Gone;2007;Rotten;54;20;7;6;13;4
The Situation;2006;Rotten;35;58;17;31;48;25
Snow Blind;2006;Rotten;20;;1;4;5;4
Four Sheets to the Wind;2007;Fresh;100;61;7;0;7;2
The Tiger's Tail;2006;Rotten;14;30;3;18;21;5
It's a Boy Girl Thing;2006;Fresh;67;61;6;3;9;0
Slipstream;2007;Rotten;25;29;10;30;40;14
Delirious;2007;Certified-Fresh;83;57;52;11;63;25
Interview;2007;Rotten;58;55;72;53;125;44
American Anthem;1986;Rotten;0;65;0;16;16;6
The Ten;2007;Rotten;35;40;29;53;82;28
The Happening;2008;Rotten;17;24;32;151;183;42
Moliere;2007;Fresh;69;79;61;28;89;32
Straightheads (Closure);2007;Rotten;40;32;8;12;20;7
Borderland;2007;Fresh;100;43;8;0;8;0
Spiral;2007;Rotten;55;59;6;5;11;1
Alexandra;2007;Certified-Fresh;88;69;52;7;59;24
Blood and Tears: The Arab-Israeli Conflict;2007;Rotten;50;33;3;3;6;2
The Cool School;2008;Fresh;92;63;24;2;26;12
Pathology;2008;Rotten;45;39;10;12;22;6
Disney's A Christmas Carol;2009;Rotten;52;58;105;96;201;47
Deep Water;2006;Certified-Fresh;96;87;53;2;55;22
Road to Victory;2007;Fresh;78;78;7;2;9;0
Beverly Hills Chihuahua;2008;Rotten;40;52;40;59;99;29
Fireflies in the Garden;2011;Rotten;22;45;12;42;54;23
The Eye;2008;Rotten;21;43;17;63;80;13
Day of the Dead;2008;Rotten;13;22;1;7;8;0
My Best Friend's Girl;2008;Rotten;14;46;8;51;59;17
The Burrowers;2008;Fresh;75;34;9;3;12;1
The Midnight Meat Train;2008;Fresh;73;50;24;9;33;5
The Lucky Ones;2008;Rotten;37;54;28;47;75;29
Run Fatboy Run;2007;Rotten;47;64;72;82;154;39
Closing Escrow;2007;Rotten;54;36;7;6;13;7
Whiteout;2009;Rotten;7;21;8;108;116;28
Randy and the Mob;2007;Rotten;56;39;5;4;9;4
Black Irish;2007;Rotten;31;58;4;9;13;3
Wild Child;2008;Rotten;41;61;11;16;27;9
Powder Blue;2009;Rotten;25;40;2;6;8;2
King Corn;2007;Fresh;96;78;25;1;26;12
L' Avocat de la Terreur (Terror's Advocate);2007;Certified-Fresh;87;67;40;6;46;18
Darfur Now;2007;Fresh;73;73;43;16;59;29
Laaga Chunari Mein Daag - Journey of a Woman;2007;Rotten;50;58;3;3;6;1
Rails & Ties;2007;Rotten;34;58;16;31;47;22
Mr. Untouchable;2007;Fresh;73;54;19;7;26;15
House;2008;Rotten;0;27;0;13;13;1
Canvas;2007;Fresh;78;62;21;6;27;16
Skid Row;2007;Fresh;83;55;5;1;6;2
Saawariya;2007;Rotten;38;46;8;13;21;10
Aaja Nachle;2007;Fresh;67;72;4;2;6;2
Flawless;2008;Rotten;55;54;52;43;95;29
What Happens in Vegas;2008;Rotten;26;65;34;99;133;38
Appaloosa;2008;Certified-Fresh;76;55;125;39;164;43
Good;2008;Rotten;32;32;23;48;71;27
The Visitor;2008;Certified-Fresh;89;84;107;13;120;30
Meet Bill;2008;Rotten;20;44;4;16;20;6
Married Life;2008;Rotten;54;36;64;54;118;38
Badland;2007;Rotten;16;54;3;16;19;7
The Oxford Murders;2010;Rotten;17;33;2;10;12;3
Untraceable;2008;Rotten;16;52;24;124;148;41
The Informers;2009;Rotten;12;18;13;92;105;38
Meeting Resistance;2007;Fresh;82;47;18;4;22;11
The Freshman;;Certified-Fresh;94;61;46;3;49;17
Guta-yubalja-deul (A Bloody Aria);2006;Rotten;42;40;10;14;24;12
Kenny;2008;Fresh;100;86;25;0;25;11
The Rocker;2008;Rotten;41;46;50;73;123;39
The Perfect Holiday;2007;Rotten;19;52;11;48;59;25
La Graine et le Mulet (The Secret of the Grain) (Couscous);2007;Certified-Fresh;93;76;50;4;54;19
Land of the Lost;2009;Rotten;26;32;49;141;190;50
[Rec];2007;Fresh;89;82;34;4;37;5
Look;2007;Fresh;60;56;21;14;35;11
And God Created Woman;1988;Rotten;38;33;3;5;8;1
The Box;2009;Rotten;44;24;68;87;155;30
Man in the Chair;2007;Rotten;50;68;18;18;36;15
Undoing;2006;Rotten;31;26;4;9;13;5
Black Water;2008;Fresh;80;39;16;4;20;8
21;2008;Rotten;35;66;60;110;170;40
The Duchess of Langeais (Ne Touchez Pas La Hache)(Don't Touch the Axe);2007;Fresh;70;52;46;20;66;30
Ben X;2007;Fresh;68;80;26;12;38;15
Body of Lies;2008;Rotten;55;62;117;96;213;54
Passengers;2008;Rotten;19;35;6;25;31;11
The Grand;2008;Rotten;40;43;17;26;43;17
The Hammer;2007;Certified-Fresh;80;90;32;8;40;17
Shutter;2008;Rotten;9;33;6;60;66;13
Priest;2011;Rotten;15;46;15;85;100;18
The Broken;1900;Rotten;49;25;19;20;39;10
The Escapist;2008;Fresh;64;63;29;16;45;13
Sugar;2008;Certified-Fresh;92;80;126;11;137;45
Quid Pro Quo;2008;Fresh;61;54;22;14;36;17
Red;2008;Fresh;70;68;19;8;27;11
The Guitar;2008;Rotten;33;55;6;12;18;10
The Road;2009;Certified-Fresh;73;68;158;57;215;53
G-Force;2009;Rotten;22;39;28;99;127;37
The Other Man;2008;Rotten;15;18;6;33;39;17
The Duchess;2008;Fresh;62;67;105;65;170;48
The Women;2008;Rotten;14;38;20;128;148;44
Public Enemies;2009;Fresh;68;59;188;90;278;58
Night and Day (Bam gua nat);2009;Fresh;93;68;13;1;14;5
Julia;2009;Certified-Fresh;72;67;42;16;58;20
Angel and the Badman;1947;Fresh;71;67;5;2;7;0
Fade to Black;2006;Rotten;29;34;2;5;7;4
Angel Heart;1987;Fresh;79;81;23;6;29;3
Old Dogs;2009;Rotten;5;44;6;104;110;35
Surrogates;2009;Rotten;37;38;43;73;116;27
The Promotion;2008;Rotten;53;28;41;36;77;28
Notorious;2009;Rotten;52;65;76;70;146;50
Soul Men;2008;Rotten;46;58;45;53;98;33
Igor;2008;Rotten;39;38;36;57;93;30
The Matador;2008;Fresh;73;65;11;4;15;6
The Auteur;2008;Fresh;67;41;4;2;6;1
The Caller;2008;Rotten;13;19;2;14;16;6
Sin Nombre;2009;Certified-Fresh;88;89;106;14;120;40
Das Haus der Schlafenden Schonen (House of the Sleeping Beauties);2008;Rotten;28;17;5;13;18;7
The Stone Angel;2007;Rotten;44;58;11;14;25;11
Alvin and the Chipmunks: The Squeakquel;2009;Rotten;20;49;17;67;84;30
Un Conte de Noel (A Christmas Tale);2008;Certified-Fresh;86;66;113;19;132;39
The Rebound;2009;Rotten;41;46;11;16;27;3
Ripple Effect;2008;Rotten;29;;2;5;7;3
1,000 Times Good Night;2014;Fresh;71;65;39;16;55;22
Harold;2008;Rotten;31;41;5;11;16;6
Push;2009;Rotten;23;42;29;98;127;31
Felon;2008;Fresh;63;82;15;9;24;13
Scar;2007;Rotten;0;11;0;18;18;7
The Unborn;2009;Rotten;10;30;12;107;119;25
Bitch Slap;2010;Rotten;29;29;5;12;17;4
Forever Strong;2008;Rotten;29;75;6;15;21;10
Chocolate;2008;Fresh;74;73;25;9;34;11
Fireproof;2008;Rotten;38;82;8;13;21;7
Dostana;2008;Fresh;87;68;13;2;15;4
The Garden;2008;Fresh;79;85;19;5;24;10
Splinter;2008;Fresh;73;49;27;10;37;16
Leaves of Grass;2010;Fresh;61;49;23;15;38;15
Rab Ne Bana Di Jodi (A Couple Made by God) (A Match Made in Heaven);2008;Fresh;78;71;7;2;9;2
The Proposal;2009;Rotten;45;67;84;104;188;47
Gigantic;2009;Rotten;36;34;30;53;83;27
Fuel;2008;Fresh;72;82;13;5;18;7
Hush;2009;Rotten;50;37;4;4;8;2
Anna Karenina;1935;Fresh;93;69;13;1;14;0
Orphan;2009;Rotten;56;63;86;68;154;42
My Sister's Keeper;2009;Rotten;48;72;66;71;137;42
The Hangover;2009;Certified-Fresh;78;84;187;52;239;51
The Stepfather;2009;Rotten;11;35;7;56;63;15
Okuribito (Departures);2009;Certified-Fresh;80;92;86;22;108;37
Boogie (Summer Holiday);2008;Fresh;100;67;10;0;10;4
Prima Ballerina;2009;Fresh;81;100;21;5;26;10
Season of the Witch;2011;Rotten;11;30;14;110;124;30
Shuttle;2009;Rotten;50;36;11;11;22;7
Miss March;2009;Rotten;5;29;4;76;80;21
An American Affair;2009;Rotten;16;41;6;31;37;17
Grace;2009;Fresh;71;31;22;9;31;4
Endgame;2009;Fresh;71;57;5;2;7;2
The Red Baron (Der rote Baron);2008;Rotten;20;43;5;20;25;9
The Objective;2008;Rotten;33;32;4;8;12;3
Happy Tears;2010;Rotten;27;21;9;24;33;15
The Missing Person;2009;Fresh;64;44;16;9;25;12
Polanski (Polanski Unauthorized);2009;Rotten;0;38;0;6;6;2
Mammoth (Mammut);2009;Rotten;45;63;19;23;42;19
Crude;2009;Certified-Fresh;95;85;63;3;66;28
The Messenger;2009;Certified-Fresh;90;75;145;17;162;41
Lake Mungo;2009;Fresh;95;62;20;1;21;2
Venkovsky Ucitel (The Country Teacher);2008;Fresh;81;72;22;5;27;10
The Apartment;1960;Certified-Fresh;93;94;66;5;71;17
Chatham (The Golden Boys);2009;Rotten;28;22;5;13;18;6
The Ape;1940;Rotten;43;12;3;4;7;0
Fame;2009;Rotten;24;36;29;93;122;36
Outrage;2009;Certified-Fresh;77;76;46;14;60;24
Skin;2009;Certified-Fresh;84;79;54;10;64;28
Helen;2008;Fresh;67;36;14;7;21;10
Bakjwi (Thirst);2009;Certified-Fresh;81;75;93;22;115;35
Vengeance (Fuk sau);2010;Fresh;91;60;20;2;22;10
New World Order;2009;Rotten;56;48;5;4;9;4
April Fool's Day;1986;Rotten;50;47;10;10;20;1
Blood: The Last Vampire;2009;Rotten;25;33;13;40;53;15
Shrink;2009;Rotten;27;50;17;47;64;32
Ong Bak 2;2009;Rotten;48;53;33;36;69;21
Bananas!;2009;Fresh;86;44;6;1;7;4
Last Ride;2012;Fresh;93;65;26;2;28;10
Tron Legacy;2010;Rotten;51;63;123;120;243;54
The Canyon;2009;Rotten;27;32;4;11;15;6
Manson, My Name Is Evil;2009;Fresh;67;27;6;3;9;2
Broken Hill;2009;Rotten;50;61;3;3;6;2
A Beautiful Life;2009;Rotten;0;24;0;12;12;8
Suck;2010;Rotten;50;53;5;5;10;2
Chloe;2010;Rotten;51;39;83;80;163;46
Armed and Dangerous;1986;Rotten;10;39;1;9;10;2
The Hole;2012;Fresh;81;46;29;7;36;8
NoBody's Perfect;2008;Fresh;73;87;8;3;11;6
The Good Soldier;2009;Fresh;75;80;12;4;16;5
High Life;2009;Fresh;80;43;4;1;5;2
Around the World in 80 Days;1956;Fresh;69;57;29;13;42;9
The Fall;2009;Rotten;20;;1;4;5;2
The Good Heart;2010;Rotten;30;58;11;26;37;17
Wonderful World;2010;Rotten;42;33;13;18;31;15
Collapse;2009;Certified-Fresh;83;83;34;7;41;19
Three Blind Mice;1900;Fresh;80;50;4;1;5;1
The Last Song;2010;Rotten;21;66;25;95;120;35
Babies;2010;Fresh;68;62;79;37;116;36
Lottery Ticket;2010;Rotten;34;44;28;54;82;24
Going the Distance;2010;Rotten;54;52;90;77;167;39
Life as We Know It;2010;Rotten;29;61;44;107;151;41
The Final;2010;Rotten;13;32;1;7;8;1
Frozen;2010;Fresh;63;46;61;36;97;32
Prodigal Sons;2010;Fresh;87;79;26;4;30;12
The Ghost Writer;2010;Certified-Fresh;84;70;173;33;206;47
Repo Men;2010;Rotten;22;41;33;119;152;35
7 Days (Les 7 jours du talion);2010;Fresh;80;68;12;3;15;2
Daddy Longlegs;2010;Fresh;78;52;25;7;32;18
Veer;2010;Rotten;40;47;2;3;5;0
Winter's Bone;2010;Certified-Fresh;94;76;164;10;174;44
The Kids Are All Right;2010;Certified-Fresh;92;74;207;17;224;49
Lucky;2010;Fresh;60;39;3;2;5;2
High School;2012;Rotten;28;48;15;39;54;18
Stolen;2010;Rotten;0;39;0;20;20;12
The Killing Jar;2010;Rotten;0;36;0;8;8;6
La MISSION;2010;Rotten;50;72;13;13;26;9
Predators;2010;Fresh;64;52;130;72;202;32
Stonewall Uprising;2010;Fresh;84;76;26;5;31;15
The Oath;2010;Fresh;91;79;21;2;23;10
The Wild Hunt;2010;Fresh;82;74;9;2;11;2
Arthur;1981;Fresh;88;77;29;4;33;7
The Lottery;2010;Fresh;64;76;9;5;14;7
Assault on Precinct 13;1976;Certified-Fresh;98;80;42;1;43;5
Asylum;1972;Fresh;67;48;8;4;12;2
Attack of the 50 Foot Woman;1958;Fresh;75;20;9;3;12;0
Avenging Angel;1900;Rotten;33;25;2;4;6;1
The Aviator;1985;Rotten;20;41;1;4;5;0
The Awakening;1980;Rotten;0;22;0;5;5;0
Babes in Toyland;1961;Rotten;36;59;4;7;11;1
Bad Company;1972;Fresh;92;71;11;1;12;4
The Bad News Bears;1976;Fresh;97;80;31;1;32;8
The Bad Seed;1956;Fresh;63;83;17;10;27;5
Bang The Drum Slowly;1973;Fresh;92;62;35;3;38;10
Battleground;1949;Fresh;75;82;6;2;8;1
Beauty and The Beast (La Belle et la bete);1946;Certified-Fresh;95;90;63;3;66;16
The Belles of St. Trinian's;1900;Fresh;67;70;4;2;6;0
1001 Grams;2015;Fresh;82;48;18;4;22;7
The Best of Times;1986;Rotten;31;43;4;9;13;2
Betrayed;1988;Rotten;42;52;5;7;12;3
The Big Brawl (Battle Creek Brawl);1980;Fresh;67;44;4;2;6;0
Big Business;1988;Rotten;44;69;8;10;18;2
The Big Heat;1900;Fresh;100;90;31;0;31;7
The Big Sleep;1946;Certified-Fresh;97;91;63;2;65;15
The Big Sleep;1900;Fresh;67;26;4;2;6;1
Billy Budd;1962;Fresh;90;86;9;1;10;0
The Birds;1963;Certified-Fresh;95;83;53;3;56;10
Black Christmas;1974;Fresh;71;75;24;10;34;4
The Black Hole;1979;Rotten;38;45;12;20;32;4
The Black Pirate;1926;Fresh;100;68;12;0;12;1
Black Rain;1900;Rotten;50;55;11;11;22;1
Black Sunday;1977;Fresh;69;64;18;8;26;6
Black Widow;1987;Rotten;50;40;11;11;22;2
Blackmail;1929;Fresh;86;65;19;3;22;4
Blind Date;1987;Rotten;21;42;5;19;24;3
Blood and Sand;1941;Fresh;100;67;9;0;9;0
Blood Feast;1963;Rotten;38;44;5;8;13;0
Der Blaue Engel (The Blue Angel);1930;Certified-Fresh;96;87;43;2;45;12
Bluebeard;1944;Fresh;100;38;12;0;12;3
The Border;1982;Fresh;80;53;8;2;10;1
Born Yesterday;1950;Fresh;97;86;33;1;34;6
The Boston Strangler;1968;Fresh;86;78;12;2;14;2
The Bounty;1984;Fresh;74;72;14;5;19;4
The Boys from Brazil;1978;Fresh;69;66;22;10;32;5
Brainstorm;1983;Rotten;55;56;11;9;20;1
Breakout;1900;Rotten;40;41;4;6;10;1
Brewster's Millions;1985;Rotten;35;55;8;15;23;0
Brian's Song;1970;Fresh;92;82;12;1;13;2
Brief Encounter;1945;Certified-Fresh;91;91;40;4;44;15
Broken Arrow;1950;Fresh;89;70;8;1;9;3
Broken Blossoms;1919;Fresh;95;71;21;1;22;5
The Brotherhood;1968;Fresh;67;25;6;3;9;2
Bug;1975;Rotten;33;25;4;8;12;3
Burglar;1987;Rotten;27;39;3;8;11;1
Bus Stop;1956;Fresh;79;62;11;3;14;0
Butch Cassidy and the Sundance Kid;1969;Certified-Fresh;90;92;46;5;51;8
Bye Bye Birdie;1963;Fresh;89;66;25;3;28;6
Calamity Jane;1953;Fresh;71;87;15;6;21;4
Camelot;1967;Rotten;41;69;7;10;17;1
Camille;1936;Fresh;93;83;13;1;14;2
Cape Fear;1962;Fresh;100;86;22;0;22;1
Captain Blood;1935;Fresh;100;89;27;0;27;4
Captains Courageous;1937;Fresh;94;89;17;1;18;0
Carnival of Souls;1962;Fresh;86;73;31;5;36;5
Carny;1980;Rotten;50;52;3;3;6;2
Carrie;1976;Certified-Fresh;93;77;62;5;67;13
Casablanca;1942;Certified-Fresh;99;95;91;1;92;23
Casino Royale;1967;Rotten;25;34;10;30;40;8
The Cat and the Canary;1927;Fresh;94;74;24;1;16;8
Cat on a Hot Tin Roof;1958;Fresh;97;92;36;1;37;5
Cat People;1942;Certified-Fresh;95;73;53;3;56;6
Cat People;1982;Fresh;61;46;28;18;46;7
Caught;1949;Fresh;100;78;8;0;8;0
The Champ;1979;Rotten;36;82;8;14;22;5
Champion;1949;Fresh;93;74;13;1;14;5
Charade;1963;Certified-Fresh;94;92;46;3;49;9
Charlotte's Web;1973;Fresh;77;67;17;5;22;1
The Chase;1966;Fresh;89;74;8;1;9;0
Checking Out;1989;Rotten;20;18;1;4;5;1
Children of the Corn;1984;Rotten;35;40;9;17;26;0
The Chosen;1981;Fresh;75;79;9;3;12;5
A Christmas Carol;1938;Fresh;100;74;13;0;13;0
Christmas in Connecticut;1945;Fresh;88;75;15;2;17;3
A Christmas Story;1983;Certified-Fresh;89;88;51;6;57;7
Cimarron;1931;Rotten;50;25;12;12;24;6
Cleopatra;1963;Fresh;62;69;24;15;39;10
College;1927;Fresh;89;73;17;2;19;4
Colors;1988;Fresh;82;72;28;6;34;7
Coma;1978;Fresh;81;66;21;5;26;5
Commando;1985;Fresh;71;67;24;10;34;4
Convoy;1978;Rotten;43;73;6;8;14;3
Countdown;1968;Fresh;67;27;4;2;6;1
The Country Girl;1954;Fresh;86;77;6;1;7;0
Cover Girl;1944;Fresh;95;70;18;1;19;4
Creature from the Black Lagoon;1954;Certified-Fresh;79;73;33;9;42;5
Crossroads;1986;Fresh;73;82;11;4;15;2
Cutting Class;1989;Rotten;25;22;2;6;8;0
Damn Yankees;1958;Fresh;76;69;13;4;17;5
Dangerous;1935;Fresh;83;61;5;1;6;0
Dangerous Liaisons;1988;Fresh;93;83;28;2;30;8
The Dark Mirror;1946;Fresh;71;56;5;2;7;1
Darling;1965;Fresh;67;71;12;6;18;3
Day of the Dead;1985;Fresh;81;75;30;7;37;3
The Day the Earth Stood Still;1951;Certified-Fresh;95;87;53;3;56;6
Days of Wine and Roses;1962;Fresh;100;88;12;0;12;1
Dead Heat;1988;Rotten;11;49;1;8;9;3
Dead Reckoning;1947;Fresh;67;66;4;2;6;0
Death in Venice;1971;Fresh;71;81;17;7;24;4
Death of a Salesman;1985;Fresh;100;75;8;0;8;0
Demoni (Demons);1985;Fresh;60;65;6;4;10;0
The Desperate Hours;1955;Fresh;86;79;6;1;7;0
Devil Doll;1964;Rotten;20;28;1;4;5;0
Dillinger;1973;Fresh;92;73;12;1;13;1
Dinner at Eight;1933;Fresh;90;74;18;2;20;1
Distant Thunder;1988;Rotten;43;45;3;4;7;1
Doctor Zhivago;1965;Certified-Fresh;84;88;41;8;49;15
Dodge City;1939;Fresh;100;74;13;0;13;1
Dolls;1987;Fresh;60;51;9;6;15;1
Dr. Jekyll and Mr. Hyde;1931;Certified-Fresh;90;80;36;4;40;10
How the Grinch Stole Christmas;1967;Fresh;100;98;25;0;25;5
Dracula;1931;Certified-Fresh;92;81;44;4;48;7
Dracula;1973;Fresh;60;43;3;2;5;0
Dracula;1979;Rotten;59;58;10;7;17;1
Dragnet;1900;Rotten;51;41;18;17;35;8
The Dream Team;1989;Rotten;57;61;8;6;14;1
Dressed to Kill;1980;Certified-Fresh;80;74;40;10;50;5
Duel;1972;Fresh;88;84;36;5;41;4
Dune;1984;Rotten;53;66;26;23;49;9
The Eagle Has Landed;1900;Fresh;67;67;6;3;9;0
East of Eden;1955;Fresh;85;90;33;6;39;5
Easy Money;1983;Fresh;60;58;6;4;10;3
Eaten Alive;1977;Rotten;35;30;6;11;17;0
Edipo re (Oedipus Rex);1967;Fresh;88;77;7;1;8;4
The Elephant Man;1980;Certified-Fresh;92;93;49;4;53;10
The Enforcer;1976;Fresh;68;59;23;11;34;4
The Enforcer;1951;Fresh;88;70;7;1;8;0
Escape from New York;1981;Certified-Fresh;86;77;55;9;64;9
Exodus;1960;Fresh;63;69;10;6;16;3
Eyewitness;1981;Fresh;75;38;9;3;12;5
Fahrenheit 451;1966;Fresh;81;72;29;7;36;5
The Fan;1981;Rotten;38;32;6;10;16;1
Fandango;1985;Rotten;50;78;3;3;6;0
Far From the Madding Crowd;1967;Fresh;64;76;18;10;28;14
Farewell, My Lovely;1975;Fresh;76;73;16;5;21;5
Fatal Attraction;1987;Certified-Fresh;76;72;41;13;54;9
Father of the Bride;1950;Fresh;90;74;28;3;31;6
Fire and Ice;1983;Fresh;60;53;3;2;5;0
Flash Gordon;1980;Certified-Fresh;83;69;40;8;48;7
Flashback;;Rotten;43;60;6;8;14;1
Flesh & Blood (Flesh+Blood) (The Rose and the Sword);1985;Fresh;85;63;17;3;20;2
The Flight of the Phoenix;1965;Fresh;90;81;19;2;21;1
Flipper;1963;Rotten;40;49;2;3;5;0
The Fly;1958;Certified-Fresh;95;70;38;2;40;5
The Fly;1986;Certified-Fresh;92;83;60;5;65;12
Flying Tigers;1942;Fresh;67;68;6;3;9;0
Footloose;1984;Rotten;52;71;22;20;42;6
The Four Feathers;1939;Fresh;100;85;9;0;9;0
Frantic;1988;Certified-Fresh;76;64;32;10;42;6
Freaky Friday;1976;Fresh;70;57;16;7;23;4
Fright Night;1985;Fresh;92;76;34;3;37;5
From Here to Eternity;1953;Certified-Fresh;92;84;56;5;61;16
Frosty the Snowman;1969;Fresh;73;72;11;4;15;5
The Fugitive;1947;Fresh;86;61;6;1;7;0
Fun with Dick and Jane;1900;Rotten;50;51;7;7;14;1
Funny Farm;1988;Fresh;65;50;13;7;20;2
The Fury;1978;Fresh;75;49;21;7;28;1
Galaxy of Terror (Mindwarp: An Infinity of Terror) (Planet of Horrors) (Quest);1981;Rotten;31;29;4;9;13;0
Gallipoli;1981;Certified-Fresh;91;83;41;4;45;10
The Gambler;1974;Fresh;78;77;7;2;9;1
Game of Death;1978;Rotten;50;64;6;6;12;1
The General;1927;Certified-Fresh;93;92;53;4;57;11
The Getaway;1972;Fresh;86;81;18;3;21;2
Girls! Girls! Girls!;1962;Rotten;33;50;2;4;6;0
Gloria;1980;Fresh;93;80;25;2;27;6
Glory;1989;Certified-Fresh;93;93;41;3;44;10
Go West;1940;Fresh;89;59;8;1;9;0
Gone in 60 Seconds;1974;Rotten;43;66;6;8;14;1
The Goodbye Girl;1977;Fresh;84;84;16;3;19;1
Goodbye, Mr. Chips;1939;Fresh;82;87;14;3;17;0
The Great Gatsby;1974;Rotten;39;47;14;22;36;7
The Great Race;1965;Fresh;74;83;17;6;23;2
The Green Berets;1968;Rotten;23;61;3;10;13;2
Grizzly;1976;Rotten;40;31;4;6;10;1
The Group;1966;Fresh;60;58;3;2;5;0
Gulliver's Travels;1939;Fresh;69;53;9;4;13;0
The Gunfighter;1950;Fresh;100;89;13;0;13;1
Gung Ho;1986;Rotten;33;46;7;14;21;6
Gypsy;1962;Fresh;64;74;9;5;14;0
Hairspray;1988;Certified-Fresh;98;80;41;1;42;9
Halloween;1978;Certified-Fresh;96;89;69;3;72;10
Hamlet;1948;Certified-Fresh;95;80;38;2;40;8
The Hand;1981;Rotten;11;28;1;8;9;1
Hard Times;1900;Fresh;92;81;12;1;13;2
Hardcore;1979;Fresh;76;67;19;6;25;1
The Harder They Fall;1956;Fresh;100;80;12;0;12;1
The Haunting;1963;Certified-Fresh;88;82;36;5;41;7
Hawaii;1966;Fresh;67;53;6;3;9;4
Heat;1986;Rotten;17;26;1;5;6;2
Heaven;1987;Fresh;67;67;4;2;6;1
Heaven Can Wait;1978;Certified-Fresh;88;68;36;5;41;8
Heidi;1937;Fresh;100;74;16;0;16;2
The Hidden Fortress (kakushi-toride No San-akunin);1958;Fresh;97;93;32;1;33;4
The Hills Have Eyes;1977;Fresh;65;54;17;9;26;2
The Hindenburg;1975;Rotten;36;37;5;9;14;1
The Hit;1984;Fresh;86;75;12;2;14;5
A Hole in the Head;1959;Fresh;75;49;6;2;8;0
Hot Pursuit;1987;Rotten;0;43;0;5;5;0
100 Bloody Acres;2013;Fresh;79;47;30;8;38;13
100 Girls;2000;Fresh;60;50;3;2;5;0
100 Streets;2017;Rotten;41;36;16;23;39;10
The Hound of the Baskervilles;1939;Fresh;91;83;10;1;11;0
The Hound of the Baskervilles;1959;Fresh;94;72;17;1;18;1
House (Ding Dong, You're Dead);1986;Rotten;57;46;8;6;14;1
House of Wax;1953;Certified-Fresh;95;72;40;2;42;6
House On Haunted Hill;1959;Fresh;88;73;23;3;26;4
Hud;1963;Fresh;82;89;23;5;28;4
The Human Factor;1979;Rotten;33;23;2;4;6;1
The Hunchback of Notre Dame;1923;Fresh;92;76;22;2;24;3
The Hunchback of Notre Dame;1900;Fresh;93;87;14;1;15;0
The Hunter;1980;Rotten;50;49;6;6;12;2
Hustle;1975;Fresh;63;48;5;3;8;1
I, the Jury;1982;Rotten;40;39;4;6;10;5
Imitation of Life;1959;Fresh;81;91;22;5;27;9
The Importance of Being Earnest;1900;Fresh;88;83;21;3;24;6
Impulse;;Rotten;25;21;2;6;8;2
In Cold Blood;1967;Fresh;84;88;32;6;38;10
The Incubus;1982;Rotten;29;22;2;5;7;0
Indiscreet;1958;Fresh;100;69;20;0;20;6
The Informer;1935;Fresh;94;77;15;1;16;0
Inherit the Wind;1960;Fresh;92;91;24;2;26;2
Intolerance;1916;Fresh;97;77;36;1;37;7
Invaders from Mars;1953;Fresh;82;56;9;2;11;0
Invaders From Mars;1986;Rotten;33;33;5;10;15;0
Invasion of the Body Snatchers;1956;Certified-Fresh;98;85;56;1;57;10
Invasion of the Body Snatchers;1978;Certified-Fresh;93;81;54;4;58;9
The Invisible Man;1933;Certified-Fresh;94;85;48;3;51;9
The Island;1980;Rotten;40;51;2;3;5;0
The Island of Dr. Moreau;1977;Rotten;56;40;14;11;25;3
Islands in the Stream;1977;Fresh;88;63;7;1;8;1
It;1927;Fresh;87;81;13;2;15;2
It's Alive;1973;Fresh;74;40;17;6;23;0
Ivanhoe;1952;Fresh;81;64;13;3;16;3
Jack and the Beanstalk;1952;Rotten;43;38;3;4;7;0
Jack Frost;1979;Rotten;57;61;4;3;7;3
Jamaica Inn;1939;Rotten;57;36;12;9;21;5
Jason and the Argonauts;1963;Certified-Fresh;89;79;40;5;45;5
The Jazz Singer;1927;Fresh;75;56;21;7;28;4
The Jazz Singer;1980;Rotten;19;70;4;17;21;4
Jesus Christ Superstar;1973;Rotten;52;76;13;12;25;3
Johnny Belinda;1948;Fresh;89;88;8;1;9;0
Judex;1963;Fresh;90;82;9;1;10;1
Julius Caesar;1953;Fresh;95;81;21;1;22;6
Julius Caesar;1970;Rotten;40;35;2;3;5;2
Jungle Book;1942;Rotten;57;56;8;6;14;4
Kansas;1988;Rotten;20;19;2;8;10;1
Kickboxer;1989;Rotten;36;65;4;7;11;3
Kid Galahad;1962;Rotten;40;57;2;3;5;0
The Killer Elite;1975;Rotten;50;34;7;7;14;3
The King and I;1956;Fresh;96;83;25;1;26;4
King Kong;1933;Certified-Fresh;98;86;63;1;64;12
King Kong;1976;Rotten;53;31;21;19;40;7
The King of Comedy;1983;Certified-Fresh;89;90;55;7;62;11
King of Kings;1961;Fresh;85;77;17;3;20;5
King Solomon's Mines;1950;Fresh;92;59;11;1;12;0
The Lady Vanishes;1938;Certified-Fresh;98;88;43;1;44;7
The Ladykillers;1955;Fresh;100;87;26;0;26;3
Laura;1944;Certified-Fresh;100;90;64;0;64;12
Legend;1985;Rotten;38;73;15;25;40;8
Les Miserables;1935;Fresh;83;85;10;2;12;3
The Letter;1940;Fresh;100;82;13;0;13;0
Lilies of the Field;1963;Fresh;91;86;21;2;23;4
The Lion in Winter;1968;Certified-Fresh;90;90;36;4;40;10
The Little Drummer Boy;1900;Fresh;75;57;9;3;12;5
Little Lord Fauntleroy;1936;Fresh;88;73;7;1;8;0
The Little Princess;1939;Fresh;88;81;7;1;8;0
A Little Romance;1979;Fresh;71;85;20;8;28;8
The Little Shop of Horrors;1960;Fresh;92;55;12;1;13;0
Little Shop of Horrors;1986;Certified-Fresh;90;79;46;5;51;10
Little Women;1933;Fresh;94;78;16;2;16;3
Little Women;1949;Fresh;71;83;5;2;7;3
Lock Up;1989;Rotten;23;50;3;10;13;0
Lolita;1962;Fresh;91;84;39;4;43;4
Long Day's Journey Into Night;1962;Fresh;94;86;16;1;17;2
The Long, Hot Summer;1958;Fresh;89;82;16;2;18;5
The Longest Yard;1974;Fresh;79;75;27;7;34;5
Look Back in Anger;1958;Fresh;92;76;11;1;12;1
The Lost Patrol;1934;Fresh;100;65;6;0;6;0
The Love Bug;1969;Fresh;76;66;13;4;17;5
Lovesick;1983;Rotten;40;29;2;3;5;0
Lust for Life;1956;Fresh;100;81;10;0;10;0
M;1931;Certified-Fresh;100;95;58;0;58;16
Madame X;1966;Fresh;60;80;3;2;5;0
Made in Heaven;1900;Rotten;50;83;6;6;12;1
The Magic Flute (Trollflojten);1975;Fresh;91;85;21;2;23;6
The Magnificent Ambersons;1942;Certified-Fresh;89;85;39;5;44;14
The Magnificent Seven;1960;Certified-Fresh;89;87;39;5;44;7
The Main Event;1979;Rotten;40;42;4;6;10;2
The Maltese Falcon;1941;Certified-Fresh;100;91;56;0;56;9
A Man for All Seasons;1966;Certified-Fresh;83;87;35;7;42;7
The Manchurian Candidate;1962;Certified-Fresh;97;90;57;2;59;10
The Manhattan Project;1986;Rotten;50;46;9;9;18;1
Manhunter;1986;Certified-Fresh;93;77;39;3;42;7
Mannequin;1987;Rotten;21;55;8;31;39;9
The Mark of Zorro;1920;Fresh;88;71;7;1;8;1
Marty;1955;Certified-Fresh;98;87;41;1;42;8
Masquerade;1988;Rotten;50;50;8;8;16;1
The Mechanic;1972;Rotten;25;66;2;6;8;1
The Men;1950;Fresh;77;74;10;3;13;4
Meteor;1979;Rotten;5;12;1;19;20;3
Metropolis;1927;Certified-Fresh;97;92;127;4;131;39
A Midsummer Night's Dream;1935;Fresh;91;62;10;1;11;0
Mighty Joe Young;1949;Fresh;95;63;19;1;20;1
The Miracle Worker;1962;Fresh;96;88;23;1;24;4
Missing in Action;1984;Rotten;19;42;3;13;16;1
The Mission;1986;Fresh;64;87;16;9;25;7
Mister Roberts;1955;Fresh;92;84;23;2;25;4
Moby Dick;1956;Fresh;86;73;19;3;22;5
Monkey Business;1931;Fresh;94;84;17;1;18;0
Monkey Business;1952;Fresh;88;68;22;3;25;5
Moonraker;1979;Fresh;60;43;31;21;52;9
Morning Glory;1933;Fresh;64;45;7;4;11;0
Moulin Rouge;1952;Fresh;78;90;7;2;9;1
Mr. & Mrs. Smith;1941;Fresh;67;48;14;7;21;5
Mrs. Soffel;1984;Rotten;36;45;4;7;11;4
The Mummy;1932;Certified-Fresh;88;72;37;5;42;7
The Mummy;1959;Fresh;89;64;8;1;9;0
Murder!;1930;Fresh;88;39;15;2;17;4
The Music Man;1962;Fresh;94;85;16;1;17;0
Mutiny on the Bounty;1935;Certified-Fresh;93;83;38;3;41;9
Mutiny on the Bounty;1962;Fresh;68;73;13;6;19;3
My Man Godfrey;1936;Fresh;97;90;36;1;37;7
Mysterious Island;1961;Fresh;80;63;12;3;15;0
Near Dark;1987;Certified-Fresh;88;74;44;6;50;9
Neighbors;1981;Rotten;57;49;4;3;7;1
Next of Kin;1989;Rotten;56;45;5;4;9;0
Nicholas and Alexandra;1971;Fresh;67;78;10;5;15;6
Night and Day;1946;Fresh;60;42;3;2;5;0
A Night at the Opera;1935;Certified-Fresh;98;91;39;1;40;6
Night of the Living Dead;1968;Certified-Fresh;97;87;68;2;70;10
A Night to Remember;1958;Fresh;100;90;21;0;21;4
Nighthawks;1981;Fresh;70;54;14;6;20;4
No Man's Land;1987;Rotten;50;63;3;3;6;1
No Mercy;1986;Rotten;27;28;4;11;15;5
No Way Out;1987;Certified-Fresh;91;72;41;4;45;13
The Nutty Professor;1963;Fresh;85;67;22;4;26;0
Obsession;1976;Fresh;73;59;19;7;26;4
The Odd Couple;1968;Fresh;97;89;35;1;36;6
Odd Man Out;1947;Fresh;100;86;30;0;30;8
The Odessa File;1974;Fresh;64;64;9;5;14;3
The Omen;1976;Certified-Fresh;86;80;43;7;50;7
On the Beach;1959;Fresh;76;69;16;5;21;3
On the Town;1949;Fresh;93;83;26;2;28;5
Only When I Laugh;1981;Rotten;57;42;4;3;7;1
Our Town;1940;Fresh;86;46;6;1;7;0
Out of the Dark;1989;Rotten;50;29;3;3;6;0
The Out-of-Towners;1970;Fresh;63;69;10;6;16;2
The Parent Trap;1961;Fresh;90;75;18;2;20;1
The Party;1968;Fresh;82;88;18;4;22;1
Pennies From Heaven;1981;Fresh;82;65;23;5;28;7
Peter Pan;1953;Fresh;81;80;29;7;36;6
The Phantom of the Opera;1989;Rotten;38;53;5;8;13;0
Phantom Of The Opera;1925;Certified-Fresh;90;84;45;5;50;11
The Picture of Dorian Gray;1945;Fresh;93;76;13;1;14;1
The Pink Panther;1963;Fresh;89;78;31;4;35;1
Piranha;1978;Fresh;69;41;18;8;26;0
The Pirates of Penzance;1983;Fresh;81;83;13;3;16;3
Pit and the Pendulum (The Pit and the Pendulum);1961;Fresh;87;74;20;3;23;2
Planet of the Apes;1968;Certified-Fresh;87;87;52;8;60;11
Point Blank;1967;Fresh;95;84;35;2;37;6
Pollyanna;1960;Fresh;86;79;12;2;14;2
Poltergeist;1982;Certified-Fresh;86;79;54;9;63;8
Popeye;1980;Fresh;61;39;20;13;33;5
The Poseidon Adventure;1972;Fresh;80;75;20;5;25;1
Posse;1975;Fresh;67;52;4;2;6;0
The Postman Always Rings Twice;1946;Fresh;89;79;24;3;27;1
The Postman Always Rings Twice;1981;Fresh;79;59;11;3;14;1
Power;1986;Rotten;50;45;6;6;12;3
Pride and Prejudice;1940;Fresh;100;77;11;0;11;2
The Prince and the Pauper;1937;Fresh;67;63;4;2;6;0
The Prisoner of Zenda;1937;Fresh;100;80;10;0;10;0
The Prisoner;1955;Fresh;71;71;5;2;7;0
The Producers;1968;Certified-Fresh;90;85;64;7;71;12
Project X;1987;Fresh;75;55;15;5;20;9
Prom Night;1980;Rotten;48;35;11;12;23;4
Promised Land;2013;Rotten;53;46;81;73;154;42
Prophecy;1979;Rotten;24;36;4;13;17;0
The Protector;1985;Rotten;20;45;1;4;5;0
The Prowler;1981;Fresh;67;49;4;2;6;0
The Public Enemy;1931;Fresh;100;84;31;0;31;4
Pulse;1988;Fresh;62;30;8;5;13;4
Quo Vadis?;1951;Fresh;88;73;15;2;17;6
A Raisin in the Sun;1961;Fresh;94;86;17;1;18;1
Raw Deal;1986;Rotten;23;28;3;10;13;1
The Razor's Edge;1946;Fresh;71;72;5;2;7;0
The Razor's Edge;1984;Rotten;50;77;8;8;16;2
Rear Window;1954;Certified-Fresh;99;95;73;1;74;19
Reckless;1984;Rotten;0;69;0;5;5;3
Red Dawn;1984;Rotten;46;65;11;13;24;1
Red Heat;1988;Fresh;67;37;16;8;24;6
The Red Shoes;1948;Certified-Fresh;97;92;57;2;59;16
Red Sonja;1985;Rotten;15;28;4;22;26;6
Monanieba (Repentance);1984;Fresh;67;90;8;4;12;5
Return to Oz;1985;Rotten;53;71;18;16;34;10
Revenge;;Rotten;35;54;6;11;17;2
Rich and Famous;1981;Rotten;57;38;8;6;14;2
Risky Business;1983;Certified-Fresh;92;72;45;4;49;7
Road House;1989;Rotten;39;66;17;27;44;12
Robin Hood;1973;Rotten;54;81;15;13;28;6
RoboCop;1987;Certified-Fresh;90;84;61;7;68;12
Rock 'n' Roll High School;1979;Fresh;81;75;22;5;27;3
Rocky;1976;Certified-Fresh;94;69;61;4;65;11
The Roman Spring of Mrs. Stone;1961;Rotten;0;60;0;5;5;0
Romeo and Juliet;1968;Fresh;95;74;35;2;37;5
Rudolph the Red-Nosed Reindeer;1964;Fresh;95;84;19;1;20;4
Runaway;1984;Rotten;47;32;9;10;19;3
Running Scared;1986;Rotten;57;58;12;9;21;6
Sabotage;1937;Fresh;100;69;11;0;11;1
Sabrina;1954;Fresh;92;89;35;3;38;8
Sahara;1943;Fresh;100;86;10;0;10;3
Samson and Delilah;1949;Fresh;63;59;5;3;8;4
Scanners;1981;Fresh;70;64;26;11;37;6
Scarecrow;1973;Fresh;75;79;18;6;24;8
Scarface;1932;Certified-Fresh;98;86;43;1;44;8
Scrooge;1970;Fresh;74;84;14;5;19;5
The Sea Hawk;1940;Fresh;93;87;13;1;14;0
Second Sight;1989;Rotten;0;29;0;0;6;0
Blind Terror (See No Evil);1971;Rotten;56;56;5;4;9;1
Separate Tables;1958;Fresh;69;76;11;5;16;0
Shadow of a Doubt;1943;Certified-Fresh;100;89;47;0;47;10
Shaft;1971;Certified-Fresh;88;68;37;5;42;7
The Shaggy Dog;1959;Fresh;68;48;13;6;19;4
Shakedown;1988;Fresh;63;40;5;3;8;6
Shall We Dance;1937;Fresh;89;85;8;1;9;0
The Shooting;1967;Fresh;100;65;20;0;20;2
Short Circuit;1986;Rotten;59;67;22;15;37;6
A Shot in the Dark;1964;Fresh;94;87;30;2;32;4
Show Boat;1951;Fresh;89;71;8;1;9;0
Silent Night, Deadly Night;1984;Rotten;35;39;7;13;20;2
The Silent Partner;1978;Fresh;71;85;4;2;7;1
Silver Streak;1976;Fresh;81;71;17;4;21;1
Simon;1980;Rotten;57;69;4;3;7;2
Sinbad the Sailor;1900;Fresh;80;60;4;1;5;0
Skin Deep;1989;Rotten;38;56;6;10;16;1
Sleeping Beauty;1959;Certified-Fresh;89;80;39;5;44;7
Something to Sing About;1937;Fresh;83;29;5;1;6;0
Sorcerer;1977;Fresh;79;83;31;8;39;8
Sparkle;1976;Rotten;10;90;1;9;10;2
Spartacus;1960;Certified-Fresh;93;87;57;4;61;9
Splash;1984;;;;39;4;;8
Spring Break;1983;Rotten;20;41;2;8;10;2
The Squeeze;1987;Rotten;14;29;1;6;7;1
The St. Valentine's Day Massacre;1967;Fresh;89;66;8;1;9;1
Stagecoach;1939;Certified-Fresh;100;86;45;0;45;7
Stage Fright;1950;Fresh;90;68;19;2;21;6
Stakeout;1987;Fresh;88;56;23;3;26;6
A Star Is Born;1937;Fresh;100;78;20;0;20;5
A Star Is Born;1954;Certified-Fresh;98;82;40;1;41;6
A Star is Born;1976;Rotten;36;64;14;25;39;7
101 Dalmatians;1961;Certified-Fresh;98;76;50;1;51;7
101 Dalmatians II: Patch's London Adventure;2002;Fresh;67;41;4;2;6;1
The Sting;1973;Certified-Fresh;94;95;59;4;63;10
The Stranger;1946;Fresh;96;81;27;1;28;5
A Streetcar Named Desire;1951;Certified-Fresh;98;90;59;1;60;13
Suddenly;1954;Fresh;100;63;9;0;9;1
Summer School;1987;Fresh;63;58;19;11;30;6
The Sundowners;1960;Fresh;75;62;9;3;12;2
The Sunshine Boys;1975;Fresh;71;73;20;8;28;3
Suspect;1987;Fresh;67;58;12;6;18;1
Suspicion;1941;Fresh;97;78;32;1;33;7
Svengali;1931;Fresh;83;80;5;1;6;0
Sweet Bird of Youth;1962;Fresh;72;72;13;5;18;4
Swing Time;1936;Fresh;97;87;28;1;29;5
Swiss Family Robinson;1960;Fresh;82;78;18;4;22;2
A Tale of Two Cities;1935;Fresh;92;84;12;1;13;0
The Taming of the Shrew;1967;Fresh;83;74;19;4;23;3
Target;1985;Fresh;71;35;5;2;7;0
Tarzan, the Ape Man;1981;Rotten;10;19;2;18;20;4
Tempest;1982;Rotten;55;74;6;5;11;2
The Ten Commandments;1923;Fresh;83;73;5;1;6;0
The Ten Commandments;1956;Fresh;89;87;33;4;37;6
Tales of Terror;1962;Fresh;71;63;10;4;14;0
That Championship Season;1900;Fresh;71;50;5;2;7;0
Them!;1954;Fresh;100;77;28;0;28;4
Shivers (They Came from Within) (The Parasite Murders);1975;Fresh;84;59;21;4;25;3
They Drive by Night;1940;Fresh;92;71;22;2;24;4
Thief;1981;Fresh;94;81;29;2;31;4
The Thing from Another World;1951;Fresh;89;73;32;4;36;4
The Thing;1982;Certified-Fresh;85;92;56;10;66;9
Thirst;1979;Fresh;100;41;5;0;5;1
This Gun for Hire;1942;Fresh;93;82;14;1;15;1
Three Amigos!;1986;Rotten;45;67;18;22;40;12
Tre Fratelli (Three Brothers);1981;Fresh;100;60;5;0;5;1
The Three Musketeers;1948;Fresh;78;74;7;2;9;1
The Three Musketeers;1973;Fresh;86;78;12;2;14;0
The Time Machine;1960;Fresh;76;79;28;9;37;3
Tommy;1975;Fresh;70;72;23;10;33;8
The Toolbox Murders;1978;Rotten;0;30;0;5;5;0
Top Secret!;1984;Fresh;77;80;27;8;35;7
I corpi presentano tracce di violenza carnale (Torso) (Bodies Bear Traces of Carnal Violence);1973;Rotten;50;55;4;4;8;1
Touch of Evil;1958;Certified-Fresh;95;92;74;4;78;23
Tough Guys;1986;Rotten;57;55;8;6;14;2
Treasure Island;1934;Fresh;100;74;7;0;7;0
Treasure Island;1950;Fresh;100;67;7;0;7;0
Le Proces (The Trial);1962;Fresh;83;87;30;6;36;8
The Trip;1967;Rotten;39;52;9;14;23;5
Twelve O'Clock High;1949;Fresh;96;87;24;1;25;5
Twins;1988;Rotten;43;39;18;24;42;10
Uncommon Valor;1983;Rotten;56;62;5;4;9;1
The Undefeated;1969;Rotten;29;65;2;5;7;2
Unfaithfully Yours;1948;Fresh;93;87;14;1;15;4
The Unforgiven;1960;Fresh;60;59;3;2;5;0
Valley Girl;1983;Fresh;83;72;24;5;29;4
Venom;1981;Rotten;43;31;3;4;7;1
Vice Versa;1988;Rotten;43;41;6;8;14;1
Victory;1981;Fresh;63;71;5;3;8;3
Village of the Damned;1900;Fresh;92;77;24;2;26;4
Walking Tall;1973;Fresh;75;71;9;3;12;0
The Warriors;1979;Fresh;90;88;35;4;39;4
Water;1900;Rotten;0;68;0;6;6;6
We're No Angels;1989;Rotten;47;41;9;10;19;2
Weird Science;1985;Rotten;57;69;20;15;35;5
When a Stranger Calls;1979;Rotten;41;49;7;10;17;2
Where the Boys Are;1960;Fresh;88;70;7;1;8;0
White Christmas;1954;Certified-Fresh;77;88;33;10;43;10
Willard;1900;Rotten;57;38;13;10;23;2
Winchester '73;1950;Fresh;100;86;27;0;27;6
Witness;1985;Certified-Fresh;93;80;38;3;41;10
A Woman's Face;1941;Fresh;100;82;7;0;7;0
The Women;1939;Fresh;92;88;23;2;25;8
The Wrong Man;1956;Fresh;92;75;23;2;25;2
Wuthering Heights;1939;Fresh;96;85;22;1;23;1
Year of the Dragon;1985;Rotten;56;52;10;8;18;2
The Yearling;1946;Fresh;100;76;14;0;14;0
Yours, Mine and Ours;1968;Rotten;50;80;6;6;12;2
Blue Steel;;Fresh;75;35;18;6;24;6
Where the Heart Is;;Rotten;10;58;1;9;10;1
The Guardian;;Rotten;30;32;3;7;10;1
Mystery Train;1989;Fresh;89;87;31;4;35;6
Revolution;1985;Rotten;10;32;2;18;20;6
Henry V;1989;Certified-Fresh;100;89;40;0;40;11
Kiss of Death;1947;Fresh;88;76;15;2;17;2
Conquest;1937;Fresh;100;50;5;0;5;1
Alice in Wonderland;1951;Fresh;81;78;26;6;32;6
My Blue Heaven;;Fresh;71;59;12;5;17;2
State Fair;1945;Fresh;83;78;5;1;6;0
Dick Tracy;;Fresh;63;53;34;20;54;13
Bombshell (Blonde Bombshell);1933;Fresh;90;74;9;1;10;0
Navy Seals;;Rotten;19;42;6;26;32;11
Goodbye, Mr. Chips;1969;Fresh;100;71;5;0;5;1
102 Dalmatians;2000;Rotten;31;32;28;62;90;28
The Champ;1931;Fresh;90;74;9;1;10;2
Narrow Margin;;Rotten;57;50;8;6;14;3
Red Dust;1932;Fresh;100;78;8;0;8;0
Desperate Hours;;Rotten;36;23;4;7;11;3
Ghost;;Certified-Fresh;74;80;55;19;74;18
Memphis Belle;;Fresh;67;79;16;8;24;8
Faust;1926;Fresh;94;91;29;2;31;10
Gun Crazy (Deadly Is the Female);1950;Certified-Fresh;98;84;39;1;40;10
The Jungle Book;1967;Certified-Fresh;88;82;35;5;40;5
The Long Goodbye;1973;Certified-Fresh;93;88;42;3;45;9
Houdini;1953;Fresh;85;59;11;2;13;0
Avalon;;Fresh;85;77;22;4;26;3
The Rookie;;Rotten;29;36;4;10;14;4
The Long Walk Home;1990;Fresh;87;84;13;2;15;4
Anastasia;1956;Fresh;91;78;11;1;11;0
Jane Eyre;1944;Fresh;100;83;13;0;13;0
The Pit and the Pendulum;1991;Rotten;56;39;5;4;9;1
GoodFellas;;Certified-Fresh;96;97;96;4;100;28
After Hours;1985;Certified-Fresh;89;87;50;6;56;12
White Fang;1991;Fresh;65;63;13;7;20;7
Boy Meets Girl (1984);1984;Fresh;100;73;10;0;10;3
Mata Hari;1932;Fresh;63;55;5;3;8;4
Alice;;Fresh;75;57;21;7;28;6
Hidden Agenda;;Fresh;85;72;17;3;20;6
The Connection;1900;Fresh;95;79;19;1;20;7
The Entertainer;1960;Fresh;77;73;10;3;13;0
Sorry, Wrong Number;1948;Fresh;86;78;19;3;22;5
Awakenings;;Fresh;88;89;29;4;33;4
Diabolique (Les Diaboliques);1955;Certified-Fresh;96;93;45;2;47;10
True Colors;1991;Rotten;47;45;7;8;15;5
Switch;1991;Rotten;32;43;6;13;19;3
The Field;;Rotten;43;81;6;8;14;6
Oscar;1991;Rotten;12;63;2;15;17;2
Night Nurse;1931;Fresh;86;73;6;1;7;0
Fury;1936;Fresh;100;89;16;0;16;0
Possessed;1947;Fresh;90;76;9;1;10;1
Born to Kill;1947;Fresh;83;75;5;1;6;0
Toy Soldiers;1991;Rotten;36;66;5;9;14;3
Come and See (Idi i smotri);1985;Fresh;97;95;33;1;34;7
The Miracle;1991;Fresh;67;62;6;3;9;3
Hot Shots!;1991;Fresh;83;65;20;4;24;2
Dogfight;1991;Fresh;78;87;14;4;18;3
The Hitman;1991;Rotten;13;45;1;7;8;0
Teacher's Pet;1958;Fresh;86;71;6;1;7;1
Shattered;1991;Rotten;36;56;5;9;14;2
Romeo and Juliet;1936;Fresh;78;50;7;2;9;0
The Doctor;1991;Fresh;82;72;14;3;17;4
Paradise;1991;Rotten;36;50;4;7;11;2
The Commitments;1991;Certified-Fresh;89;90;39;5;44;11
Frankie & Johnny;1991;Fresh;66;67;19;10;29;10
Deceived;1991;Rotten;37;42;7;12;19;4
The Star;1952;Rotten;29;60;2;5;7;1
Poison;1991;Fresh;77;68;17;5;22;8
Cape Fear;1991;Certified-Fresh;74;77;37;13;50;12
Homo Faber (Voyager);1991;Rotten;56;72;5;4;9;2
My Girl;1991;Rotten;53;77;9;8;17;3
JFK;1991;Certified-Fresh;84;88;53;10;63;13
The Man in the Moon;1991;Fresh;90;85;18;2;20;5
The Prize;1963;Rotten;50;68;5;5;10;2
The Train;1965;Fresh;92;89;12;1;13;0
Father of the Bride;1991;Fresh;70;70;30;13;43;9
Rush;1991;Fresh;71;72;20;8;28;10
Medicine Man;1992;Rotten;19;46;4;17;21;3
Platinum Blonde;1931;Fresh;88;66;7;1;8;0
The Uninvited;1944;Fresh;95;81;19;1;20;4
The Italian Job;1969;Fresh;83;86;24;5;29;7
Beethoven;1992;Rotten;30;35;8;19;27;7
Tacones Lejanos (High Heels);1991;Rotten;53;83;8;7;15;4
The Babe;1992;Rotten;46;37;17;20;37;14
The Cutting Edge;1992;Rotten;57;76;20;15;35;12
Gladiator;1900;Rotten;31;68;4;9;13;6
Kid Galahad;1937;Fresh;100;68;5;0;5;0
Deep Cover;1992;Fresh;82;77;18;4;22;9
All I Want for Christmas;1991;Rotten;0;59;0;14;14;5
Class Act;1992;Rotten;17;72;2;10;12;1
Edward II;1992;Fresh;100;75;10;0;10;1
A Midnight Clear;1992;Certified-Fresh;88;79;35;5;40;13
Boomerang;1992;Rotten;43;59;15;20;35;10
Rapid Fire;1992;Rotten;45;55;10;12;22;5
Live Wire;1992;Rotten;0;30;0;5;5;0
Of Mice and Men;1992;Fresh;97;82;28;1;29;7
Body Parts;1991;Rotten;41;33;7;10;17;1
Cool World;1992;Rotten;6;31;3;45;48;11
Singles;1992;Certified-Fresh;79;72;41;11;52;15
The Naked City;1948;Fresh;88;80;21;3;24;4
Conquest of Space;1955;Fresh;60;26;3;2;5;2
Wind;1992;Rotten;50;82;6;6;12;3
The Last of the Mohicans;1992;Certified-Fresh;93;88;39;3;42;9
Consenting Adults;1992;Rotten;25;24;3;9;12;2
Husbands and Wives;1992;Certified-Fresh;93;87;38;3;41;13
Hero;1992;Fresh;67;50;14;7;21;1
Ned Kelly (Ned Kelly, Outlaw);1970;Rotten;27;26;3;8;11;3
Hallelujah;1929;Fresh;83;55;10;2;12;3
The Sea Wolf;1941;Fresh;100;76;5;0;5;0
Forever Young;1992;Rotten;57;53;13;10;23;6
Matinee;1992;Fresh;92;62;33;3;36;4
Unforgiven;1992;Certified-Fresh;96;93;102;4;106;28
Leap of Faith;1992;Fresh;64;45;14;8;22;2
Malcolm X;1992;Certified-Fresh;88;91;52;7;59;12
Love on the Run;1936;Fresh;80;61;4;1;5;0
Scent of a Woman;1992;Certified-Fresh;89;92;39;5;44;9
Nowhere to Run;1993;Rotten;30;32;7;16;23;8
Sniper;1993;Rotten;38;55;5;8;13;2
The Vanishing;1993;Rotten;49;46;18;19;37;8
The Crush;1993;Rotten;25;41;7;21;28;4
Boiling Point;1993;Rotten;18;21;2;9;11;1
Indian Summer;1993;Rotten;58;65;11;8;19;5
Alive;1993;Rotten;59;68;16;11;27;6
Point of No Return (The Assassin);1993;Rotten;50;50;12;12;24;5
Brother's Keeper;1992;Fresh;100;88;17;0;17;3
Born Yesterday;1993;Rotten;23;27;6;20;26;11
Stalker;1979;Certified-Fresh;100;93;41;0;41;12
The Browning Version;1951;Fresh;89;95;17;2;19;4
Posse;1993;Rotten;29;48;5;12;17;5
Made in America;1993;Rotten;31;30;9;20;29;3
Cliffhanger;1993;Fresh;69;52;37;17;54;20
Frankenstein;1992;Rotten;17;47;1;5;6;1
The Firm;1993;Certified-Fresh;75;64;42;14;56;11
The Black Scorpion;1957;Fresh;60;33;3;2;5;0
The Lodger: A Story of the London Fog;1928;Fresh;96;76;24;1;25;7
Equinox;1992;Rotten;33;42;3;6;9;1
Gypsy;1900;Rotten;57;76;4;3;7;0
Wide Sargasso Sea;1993;Fresh;65;37;13;7;20;8
The Secret Garden;1993;Certified-Fresh;88;80;37;5;42;17
Strictly Ballroom;1992;Certified-Fresh;93;87;40;3;43;6
Calendar Girl;1900;Rotten;11;31;2;17;19;10
Savage Messiah;1972;Fresh;60;79;6;4;10;3
Deadfall;1993;Rotten;0;25;0;6;6;1
Much Ado About Nothing;1993;Certified-Fresh;90;86;44;5;49;13
Airborne;1900;Rotten;21;59;3;11;14;8
Gettysburg;1993;Fresh;77;89;17;5;22;6
Fatal Instinct;1993;Rotten;18;40;4;18;22;8
High Noon;1952;Certified-Fresh;97;89;56;2;58;10
A Home of Our Own;1993;Rotten;50;73;6;6;12;3
The Fugitive;1993;Certified-Fresh;96;89;74;3;77;19
Fearless;1993;Fresh;85;80;33;6;39;9
Trauma (Dario Argento's Trauma);1993;Rotten;57;41;4;3;7;0
Cool Runnings;1993;Certified-Fresh;76;81;32;10;42;11
The Skin Game;1931;Rotten;38;17;3;5;8;4
The Man Who Loved Women;1983;Rotten;33;37;4;8;12;2
Impact;1949;Fresh;60;54;3;2;5;1
Into the West;1993;Fresh;77;79;10;3;13;3
The Three Musketeers;1993;Rotten;28;62;8;21;29;7
Alice in Wonderland;1999;Rotten;33;62;2;4;6;0
Scared Stiff;1900;Fresh;71;74;5;2;7;0
Gunmen;1993;Rotten;15;35;2;11;13;5
Dangerous Game;1993;Rotten;31;45;5;11;16;3
The Getaway;1994;Rotten;32;28;7;15;22;3
Angels in the Outfield;1951;Fresh;83;63;5;1;6;2
Heaven & Earth;1994;Rotten;40;70;8;12;20;7
Snow White and the Seven Dwarfs;1937;Certified-Fresh;98;78;52;1;53;8
Sugar Hill;1994;Rotten;20;69;2;8;10;2
Thumbelina;1994;Rotten;27;66;3;8;11;2
The Young Americans;1993;Rotten;33;41;2;4;6;0
Alice (Neco z Alenky);1988;Fresh;100;80;20;0;20;5
The Last Man on Earth;1964;Fresh;80;69;20;5;25;1
Sherman's March;1986;Fresh;100;85;12;0;12;0
Bad Girls;1994;Rotten;9;40;2;21;23;5
Dream Lover;1994;Rotten;57;40;8;6;14;2
Black Beauty;1994;Fresh;80;75;12;3;15;8
The Circus;1928;Fresh;96;94;25;1;26;4
The Kid;1921;Certified-Fresh;100;95;43;0;43;7
Wyatt Earp;1994;Rotten;44;61;12;15;27;3
Betty;1992;Fresh;90;59;9;1;10;2
Blown Away;1994;Rotten;38;40;8;13;21;3
The Mask;1994;Certified-Fresh;77;68;41;12;53;16
Wolf;1994;Fresh;60;42;33;21;53;9
Orlacs Hande (The Hands of Orlac);1924;Fresh;86;81;6;1;7;3
The Shadow;1994;Rotten;35;44;17;32;49;10
It Could Happen to You;1994;Fresh;71;54;24;10;34;9
Robin Hood;1922;Fresh;100;72;8;0;8;0
Milk Money;1994;Rotten;12;37;5;37;42;15
Barcelona;1994;Fresh;82;80;29;6;34;11
The Browning Version;1994;Fresh;78;79;14;4;18;4
Only You;1994;Rotten;54;68;19;16;35;10
The Specialist;1994;Rotten;7;29;2;27;29;7
Titanic;1953;Fresh;91;66;10;1;11;0
Beloved;1998;Certified-Fresh;78;71;52;15;67;23
Rudyard Kipling's The Jungle Book;1994;Certified-Fresh;80;55;33;8;41;13
The Life and Times of Allen Ginsberg;1994;Fresh;77;71;10;3;13;1
Junior;1994;Rotten;36;22;12;21;33;10
Street Fighter;1994;Rotten;10;20;4;36;40;9
Little Women;1994;Fresh;92;84;36;3;39;12
Shallow Grave;1995;Fresh;69;83;34;15;49;14
Bad Company;1995;Rotten;27;31;3;8;11;3
Three Colors: Red (Trois couleurs: Rouge);1994;Certified-Fresh;100;95;54;0;54;14
True Crime;1995;Rotten;0;43;0;5;5;0
L'Enfer;1994;Fresh;100;74;9;0;9;1
Nobody's Fool;1994;Certified-Fresh;91;81;49;5;54;18
The Wild Bunch;1969;Certified-Fresh;90;91;57;6;63;18
The Quick and the Dead;1995;Rotten;59;53;24;17;41;10
Top Dog;1994;Rotten;0;32;0;8;8;2
Man of the House;1995;Rotten;14;33;2;12;14;1
Born to Be Wild;1995;Rotten;0;48;0;9;9;3
Hideaway;1995;Rotten;20;39;3;12;15;5
The Babysitter;1995;Rotten;17;16;1;5;6;0
The Old Dark House;1932;Fresh;96;72;25;1;26;6
She;1935;Rotten;50;52;3;3;6;0
School for Scoundrels;1900;Fresh;100;70;6;0;6;0
Village of the Damned;1995;Rotten;29;27;11;25;35;5
A Little Princess;1995;Fresh;97;88;34;1;35;9
Mad Love;1995;Rotten;28;49;7;18;25;9
Bad Boys;1995;Rotten;42;78;27;37;64;17
Smoke;1995;Fresh;93;89;27;2;29;6
Pocahontas;1995;Rotten;55;64;31;25;56;16
Contraband;1940;Fresh;100;67;6;0;6;1
Raw Deal;1948;Fresh;100;81;9;0;9;0
Cowboy;1958;Fresh;86;57;6;2;7;0
Babe;1995;Certified-Fresh;97;67;68;2;70;21
The Prophecy;1995;Rotten;43;64;10;13;23;2
Braveheart;1995;Certified-Fresh;78;85;64;18;82;27
Copycat;1995;Fresh;78;64;29;8;37;6
Fair Game;1995;Rotten;12;14;3;22;25;9
The Scarlet Letter;1995;Rotten;13;41;5;33;38;15
Home for the Holidays;1995;Fresh;63;72;31;18;49;14
Kicking and Screaming;1995;Rotten;57;76;21;16;37;13
Shadows;1959;Fresh;100;81;23;0;23;6
Persuasion;1995;Fresh;86;84;24;4;28;10
To Die For;1995;Certified-Fresh;88;65;50;7;57;15
It Takes Two;1995;Rotten;8;60;2;22;24;9
Boomerang!;1947;Fresh;80;63;16;4;20;4
Casino;1995;Certified-Fresh;80;93;51;13;64;17
Jumanji;1995;Rotten;55;62;21;17;38;8
Richard III;1995;Certified-Fresh;94;85;46;3;49;15
Heat;1995;Certified-Fresh;87;94;72;11;83;26
Zhong Nan Hai bao biao (The Defender) (The Bodyguard from Beijing);1994;Fresh;71;67;5;2;7;0
The Addiction;1995;Fresh;75;69;21;7;28;6
Sabrina;1995;Fresh;65;64;31;17;48;18
Heavy Metal;1981;Fresh;60;67;18;12;30;6
The Hill;1965;Fresh;71;93;5;2;7;0
Sudden Death;1995;Rotten;50;39;18;18;36;11
Dead Man Walking;1995;Certified-Fresh;95;86;58;3;61;20
Cry, the Beloved Country;1995;Fresh;85;73;11;2;13;4
Georgia;1995;Fresh;80;66;20;5;25;7
Wuthering Heights;1900;Fresh;60;63;6;4;10;3
Broken Arrow;1996;Rotten;52;44;17;16;33;7
Restoration;1996;Fresh;70;59;23;10;33;12
Black Sheep;1996;Rotten;28;70;9;23;32;6
Screamers;1996;Rotten;28;45;10;26;36;11
Othello;1995;Fresh;67;64;26;13;39;12
The Substitute;1995;Rotten;43;40;10;13;23;8
Diabolique;1996;Rotten;18;34;5;23;28;7
Before and After;1996;Rotten;32;35;6;13;19;5
The Old Man and the Sea;1958;Fresh;78;67;7;2;9;0
The Convent (O Convento);1995;Rotten;38;32;3;5;8;0
August;1996;Rotten;14;48;1;6;7;2
Carried Away;1996;Fresh;64;40;14;8;22;7
The Quest;1996;Rotten;14;36;3;18;21;5
Flipper;1996;Rotten;32;34;6;13;19;5
Primal Fear;1996;Certified-Fresh;76;89;34;11;45;6
Twister;1996;Rotten;58;58;32;23;55;13
Fear;1996;Rotten;46;63;17;20;37;5
The Arrival;1996;Fresh;65;44;22;12;34;7
Charlotte Bronte's Jane Eyre;1996;Fresh;74;68;20;7;27;8
Last Dance;1996;Rotten;32;50;7;15;22;9
Moll Flanders;1996;Rotten;43;72;10;13;23;7
The Last Supper;1996;Fresh;63;70;22;13;35;15
Cold Comfort Farm;1996;Certified-Fresh;83;82;33;7;40;11
Independence Day;1996;Fresh;67;75;50;25;75;23
The Rock;1996;Fresh;66;85;43;22;65;22
The Phantom;1996;Rotten;43;31;20;27;47;12
Matilda;1996;Fresh;90;73;19;2;21;5
The Island of Dr. Moreau;1996;Rotten;24;20;8;26;34;6
The Struggle;1931;Rotten;29;31;2;5;7;3
A Time to Kill;1996;Fresh;67;85;37;18;55;15
Kingpin;1996;Rotten;50;69;19;19;38;6
Chain Reaction;1996;Rotten;18;27;6;27;33;10
Infinity;1996;Fresh;62;34;8;5;13;4
The Dentist;1996;Rotten;0;29;0;7;7;0
Alaska;1996;Rotten;18;44;2;9;11;3
Jack;1996;Rotten;18;49;6;28;34;7
Freeway;1996;Certified-Fresh;76;76;31;10;41;9
Girls Town;1995;Fresh;88;81;22;3;25;10
The Fan;1996;Rotten;37;34;11;19;30;7
Harriet the Spy;1996;Rotten;48;50;15;16;31;15
House Arrest;1996;Rotten;10;45;3;27;30;12
The Hunchback of Notre Dame;1996;Fresh;71;70;40;16;56;17
Bulletproof;1996;Rotten;8;44;3;36;39;8
Foxfire;1996;Rotten;27;65;3;8;11;4
The Associate;1996;Rotten;28;53;5;13;18;8
Emma;1996;Certified-Fresh;85;77;44;8;52;15
Les Visiteurs (The Visitors );1993;Rotten;31;79;4;9;13;4
Selena;1997;Fresh;64;77;30;17;47;14
Lone Star;1996;Certified-Fresh;94;83;44;3;47;10
101 Dalmatians;1996;Rotten;41;40;15;22;37;8
Ransom;1996;Certified-Fresh;75;62;54;18;72;23
Scream;1996;Certified-Fresh;78;79;58;16;74;22
One Fine Day;1996;Rotten;50;66;17;17;34;8
Michael;1996;Rotten;34;45;14;27;41;10
In Love and War;1996;Rotten;11;50;3;24;27;7
Turbulence;1997;Rotten;17;19;3;15;18;4
Touch;1997;Rotten;33;34;6;12;18;3
Metro;1997;Rotten;15;27;5;29;34;9
The Crucible;1996;Fresh;68;66;42;20;62;24
That Darn Cat;1997;Rotten;13;23;2;13;15;4
Hamlet;1996;Certified-Fresh;95;90;53;3;56;13
Private Parts;1997;Certified-Fresh;75;68;40;13;53;14
Mother;1996;Certified-Fresh;88;75;37;5;42;14
Iron Monkey;2001;Certified-Fresh;91;86;87;9;96;28
McHale's Navy;1997;Rotten;3;38;1;28;29;7
Volcano;1997;Rotten;50;31;23;23;46;13
Anna Karenina;1997;Rotten;26;66;5;14;19;8
Get Carter;1971;Fresh;84;85;27;5;32;5
Traveller;1997;Fresh;79;53;22;6;28;9
Batman & Robin;1997;Rotten;11;16;10;83;93;29
The Van;1997;Rotten;38;71;8;13;21;6
Breakdown;1997;Certified-Fresh;81;67;42;10;52;14
Pippi Longstocking;1997;Rotten;43;54;3;4;7;1
Joyride;1996;Rotten;20;29;1;4;5;1
Out to Sea;1997;Rotten;36;52;8;14;22;5
Nothing to Lose;1997;Rotten;28;68;7;18;25;7
Jack Frost;1996;Rotten;7;31;1;14;15;0
George of the Jungle;1997;Rotten;56;41;30;24;54;17
Contact;1997;Fresh;66;78;44;23;67;21
Buddy;1997;Rotten;25;31;5;15;20;7
Hoodlum;1997;Rotten;43;65;9;12;21;7
Steel;1997;Rotten;12;15;3;23;26;5
Fire Down Below;1997;Rotten;11;35;3;24;27;8
Bliss;1997;Rotten;46;54;6;7;13;5
Picture Perfect;1997;Rotten;47;37;20;23;43;11
Shall We Dance? (Shall We Dansu?);1996;Fresh;91;89;31;3;34;6
The Game;1997;Fresh;74;84;43;15;58;16
Most Wanted;1997;Rotten;15;40;4;22;26;10
The Keeper;1900;Rotten;17;;1;5;6;2
The Assignment;1997;Fresh;60;62;12;8;20;5
The Peacemaker;1997;Rotten;43;39;15;20;35;8
No Way Out;1950;Fresh;90;82;9;1;10;0
Seven Years in Tibet;1997;Fresh;60;73;21;14;35;7
One Night Stand;1997;Rotten;32;38;10;21;31;9
Anastasia;1997;Certified-Fresh;86;77;48;8;56;12
12 Angry Men;1997;Fresh;92;87;11;1;12;0
Firestorm;1998;Rotten;12;26;3;23;26;6
The Killers;1946;Fresh;100;89;34;0;34;6
Requiem for a Heavyweight;1962;Fresh;92;89;11;1;12;2
The Rainmaker;1997;Certified-Fresh;82;77;40;9;49;14
Fallen;1997;Rotten;40;72;23;34;57;14
Fall;1997;Rotten;0;84;0;7;7;3
Great Expectations;1998;Rotten;37;78;13;22;35;7
The Borrowers;1998;Fresh;73;49;19;7;26;8
Senseless;1998;Rotten;6;45;1;16;17;6
Merlin;1998;Fresh;82;73;9;2;11;1
The Man in the Iron Mask;1998;Rotten;32;55;13;28;41;9
Mr. Nice Guy (Yat goh hiu yan);1997;Rotten;43;44;13;17;30;8
Nightwatch;1998;Rotten;28;46;8;21;29;6
Wide Awake;1998;Rotten;44;67;14;18;32;8
Imitation of Life;1934;Fresh;92;85;22;2;24;7
Twilight;1998;Fresh;60;30;33;22;55;14
Hush;1998;Rotten;12;35;5;36;41;10
Passion (Godard's Passion);1982;Rotten;57;62;4;3;7;1
The Mark of Zorro;1940;Fresh;91;79;10;1;11;0
Of Mice and Men;1939;Fresh;100;85;14;0;14;1
A Perfect Murder;1998;Rotten;56;51;29;23;52;14
Les Miserables;1998;Certified-Fresh;74;83;32;11;43;11
Madeline;1998;Fresh;65;43;20;11;31;7
The Parent Trap;1998;Certified-Fresh;86;70;44;7;51;11
Out of Sight;1998;Certified-Fresh;93;74;84;6;90;26
The Avengers;1998;Rotten;5;15;4;78;82;21
Dirty Work;1998;Rotten;17;65;5;24;29;6
The Negotiator;1998;Certified-Fresh;74;79;42;15;57;10
Blade;1998;Rotten;56;78;58;46;104;31
Mafia!;1998;Rotten;14;47;6;36;42;7
Rounders;1998;Fresh;65;87;52;28;80;22
Return to Paradise;1998;Fresh;71;74;32;13;45;13
Funny Games;1998;Fresh;69;83;24;11;35;5
Soldier;1998;Rotten;13;44;7;46;53;15
Whatever;1998;Fresh;75;71;12;4;16;2
Tango;1998;Fresh;68;86;15;7;22;6
The Thin Red Line;1998;Certified-Fresh;80;80;82;20;102;27
Elizabeth;1998;Certified-Fresh;82;86;51;11;62;13
Happiness;1998;Certified-Fresh;81;89;39;9;48;12
Cousin Bette;1998;Rotten;41;40;9;13;22;6
Life Is Beautiful (La Vita e bella);1997;Certified-Fresh;80;96;70;17;87;16
Mighty Joe Young;1998;Rotten;54;40;27;23;50;8
At First Sight;1999;Rotten;32;46;12;26;38;7
Supernova;2000;Rotten;10;17;6;55;61;18
Lolita;1997;Fresh;68;75;17;8;25;4
True Crime;1999;Rotten;54;49;22;19;41;8
Psycho;1998;Rotten;38;28;30;48;78;18
The Siege;1998;Rotten;44;53;27;35;62;13
Gloria;1999;Rotten;14;31;4;25;29;6
The Impostors;1999;Fresh;62;73;23;14;37;7
Gunshy;1998;Rotten;20;53;1;4;5;0
Wishful Thinking;1997;Rotten;0;25;0;6;6;0
Virus;1999;Rotten;12;21;6;43;49;14
Life;1999;Rotten;50;77;27;27;54;15
Lost and Found;1999;Rotten;13;28;7;45;52;18
Go;1999;Certified-Fresh;91;78;69;7;76;21
The Mummy;1999;Fresh;61;75;62;39;101;23
The Winslow Boy;1999;Fresh;97;77;36;1;37;8
The King and I;1999;Rotten;13;40;3;21;24;6
The General;1998;Certified-Fresh;82;81;40;9;49;12
Payback;1999;Rotten;55;69;42;34;76;22
Bent;1997;Fresh;73;77;16;6;22;6
Buena Vista Social Club;1999;Certified-Fresh;92;90;44;4;48;8
Friends & Lovers;1999;Rotten;7;33;1;14;15;7
The Confession;1999;Rotten;40;36;2;3;5;1
I'll Be Home for Christmas;1998;Rotten;23;41;10;33;43;17
Underground;1995;Fresh;86;96;30;5;35;11
The Thirteenth Floor;1999;Rotten;30;64;19;45;64;19
Der Unhold (The Ogre);1999;Fresh;89;72;8;1;9;3
Black and White;1999;Rotten;20;26;2;8;10;0
Jack Frost;1998;Rotten;19;39;11;47;58;16
The War at Home;1979;Fresh;100;79;5;0;5;1
Deep Blue Sea;1999;Rotten;59;39;67;46;113;32
After Sex;1997;Fresh;78;64;14;4;18;5
The Haunting;1999;Rotten;16;28;16;84;100;26
Dick;1999;Fresh;71;53;52;21;73;26
William Shakespeare's 'A Midsummer Night's Dream';1999;Fresh;67;60;53;26;79;22
Deja Vu;1998;Fresh;65;61;13;7;20;6
An Ideal Husband;1999;Certified-Fresh;85;69;55;10;65;16
K-911;1999;Rotten;17;45;1;5;6;0
Fireworks (Hana-bi);1997;Fresh;96;93;23;1;24;2
Animal Farm;1999;Rotten;40;38;2;3;5;0
In Too Deep;1999;Rotten;39;75;22;35;57;20
The Best Man;1999;Fresh;72;86;51;20;71;25
Man on the Moon;1999;Fresh;63;79;76;44;120;32
Anna and the King;2000;Rotten;51;64;52;49;101;29
Double Jeopardy;1999;Rotten;27;61;23;63;86;23
The Hurricane;1999;Certified-Fresh;83;87;94;19;113;31
Diamonds;1999;Rotten;26;27;9;26;35;11
The End of the Affair;1999;Fresh;67;74;44;22;66;16
Guinevere;1999;Fresh;86;54;30;5;35;9
Mansfield Park;1999;Certified-Fresh;77;77;54;16;70;20
Miss Julie;1999;Rotten;39;52;9;14;23;8
Superstar;1999;Rotten;32;60;24;50;74;24
House on Haunted Hill;1999;Rotten;30;42;18;43;61;13
Tumbleweeds;1999;Certified-Fresh;82;65;56;12;68;22
The Bachelor;1999;Rotten;9;28;6;64;70;25
Last Night;1998;Certified-Fresh;84;85;42;8;50;9
A Dog of Flanders;1999;Rotten;21;63;5;19;24;3
Eye of the Beholder;2000;Rotten;9;32;8;79;87;22
The Celebration (Festen);1998;Certified-Fresh;91;94;41;4;45;9
Excellent Cadavers;1999;Fresh;63;47;5;3;8;3
Boiler Room;2000;Fresh;66;78;67;34;101;22
What Planet Are You From?;2000;Rotten;42;28;32;45;77;23
Witness Protection;1999;Fresh;60;72;3;2;5;1
The End of the Affair;1954;Fresh;80;58;4;1;5;0
Whatever It Takes;2000;Rotten;16;45;11;56;67;25
High Fidelity;2000;Certified-Fresh;91;90;150;15;165;46
Inferno (Pilgrim);2000;Rotten;20;26;1;4;5;1
Coming Soon;1999;Rotten;29;26;2;5;7;1
Where the Heart Is;2000;Rotten;35;76;34;63;97;32
Committed;2000;Rotten;43;35;20;26;46;15
Dinosaur;2000;Fresh;64;48;79;44;123;33
Screwed;2000;Rotten;13;48;4;26;30;4
Hamlet;2000;Rotten;59;46;55;38;93;23
Road Trip;2000;Rotten;58;65;53;39;92;23
Running Free;2000;Rotten;27;72;8;22;30;12
Sunshine;2000;Fresh;74;81;48;17;65;15
Gone in 60 Seconds (Gone in Sixty Seconds);2000;Rotten;25;77;35;103;138;38
George Washington;2000;Certified-Fresh;84;85;52;10;62;17
Shaft;2000;Fresh;67;41;77;38;115;26
The Patriot;2000;Fresh;61;81;83;52;135;32
Who's Minding the Store?;1963;Rotten;40;64;2;3;5;0
Slow Burn;2000;Rotten;12;9;2;15;17;4
The In Crowd;2000;Rotten;2;38;1;59;60;20
Loser;2000;Rotten;24;35;23;73;96;28
American Virgin;2000;Rotten;29;9;0;0;7;0
Wildflowers;2000;Rotten;57;44;4;3;7;1
Saving Grace;1900;Fresh;63;83;56;33;89;25
The Art of War;2000;Rotten;16;36;13;68;81;27
The Crew;2000;Rotten;20;34;17;68;85;25
Backstage;2000;Rotten;31;78;4;9;13;4
Beowulf;1999;Rotten;0;23;0;7;7;0
10 Cent Pistol;2015;Rotten;43;29;3;4;7;2
10 Cloverfield Lane;2016;Certified-Fresh;90;79;278;31;309;52
10 Minutes Gone;2019;Rotten;0;18;0;7;7;3
10 Questions for the Dalai Lama;2007;Fresh;79;73;11;3;14;8
10 Rules For Sleeping Around;2014;Rotten;0;11;0;8;8;5
10 Things I Hate About You;1999;Fresh;69;69;54;24;78;19
10 Years;2012;Fresh;60;40;35;23;58;19
10th & Wolf;2006;Rotten;19;52;5;22;27;12
10x10;2018;Fresh;67;21;6;3;9;3
Bait;2000;Rotten;26;40;21;61;82;24
Duets;2000;Rotten;21;48;19;73;92;28
Beautiful;2000;Rotten;16;55;10;54;64;24
Under Suspicion;2000;Rotten;49;49;22;23;45;13
Circus;2000;Rotten;9;47;1;10;11;3
Get Carter;2000;Rotten;11;28;7;54;61;20
Attack;1956;Fresh;100;78;6;0;6;0
The Contender;2000;Certified-Fresh;76;73;99;31;130;35
The Ladies Man;2000;Rotten;11;42;8;65;73;22
Lost Souls;1900;Rotten;8;22;7;84;91;30
Bedazzled;1900;Rotten;50;42;57;58;115;32
Blow Dry;2001;Rotten;19;55;12;52;64;25
A Kiss Before Dying;1956;Fresh;100;47;10;0;10;2
Malena;2000;Rotten;54;84;42;36;78;32
Lies;1999;Rotten;54;51;7;6;13;3
La Ciudad (The City);1998;Fresh;83;100;10;2;12;2
The Gift;2000;Rotten;57;55;70;52;122;31
Traffic;2000;Certified-Fresh;93;85;149;12;161;40
Double Take;2001;Rotten;12;50;9;69;78;25
The Pledge;2001;Certified-Fresh;78;59;97;27;124;36
Panic;2000;Certified-Fresh;91;62;51;5;56;18
Hannibal;2001;Rotten;39;62;67;104;171;44
Down to Earth;2001;Rotten;20;40;19;77;96;32
Sweet November;2001;Rotten;15;76;15;83;98;35
The Interview;2000;Fresh;100;81;9;0;9;1
The Brothers;2001;Fresh;63;85;42;25;67;26
Heartbreakers;2001;Rotten;53;51;65;57;122;35
Someone Like You;2001;Rotten;42;56;50;68;118;33
Hamlet;2000;Fresh;70;;7;3;10;4
L.I.E.;2001;Certified-Fresh;84;78;71;14;85;28
Driven;2001;Rotten;14;33;15;96;111;30
Ace in the Hole (The Big Carnival);1951;Fresh;92;92;33;3;36;7
Bad Seed;2001;Rotten;20;47;1;4;5;0
Brother;2001;Rotten;47;79;35;39;74;22
Angel Eyes;2001;Rotten;33;46;43;89;132;38
The Animal;2001;Rotten;30;28;25;58;83;25
Evolution;2001;Rotten;43;48;60;78;138;32
The Fast and the Furious;2001;Rotten;53;74;80;70;150;37
Pearl Harbor;2001;Rotten;24;66;47;147;194;50
Time and Tide (Shun liu Ni liu);2001;Fresh;64;74;28;16;44;15
The Road Home (Wo de fu qin mu qin);2001;Certified-Fresh;89;90;71;9;80;24
Planet of the Apes;2001;Rotten;44;27;70;89;159;34
The Score;2001;Certified-Fresh;73;67;94;34;128;36
Heist;2001;Fresh;66;60;85;44;129;32
The Others;2001;Certified-Fresh;83;77;137;28;165;39
On the Edge;2001;Fresh;67;79;6;3;9;1
Hamlet;;Fresh;76;59;28;9;37;9
Big Trouble;2002;Rotten;48;54;54;58;112;33
Sidewalks of New York;2001;Rotten;56;54;53;41;94;26
The Pornographer;1999;Rotten;38;23;3;5;8;0
The Wash;2001;Rotten;8;64;4;46;50;19
Collateral Damage;2002;Rotten;19;27;27;116;143;34
The Count of Monte Cristo;2002;Fresh;73;88;105;38;143;32
On the Line;2001;Rotten;19;47;13;56;69;23
Uprising;2001;Fresh;100;84;6;0;6;2
Invincible;2002;Rotten;54;51;28;24;52;19
Texas Rangers;2001;Rotten;2;29;1;50;51;15
Iris;2001;Certified-Fresh;79;73;87;23;110;36
James Dean;2001;Fresh;93;76;14;1;15;9
Behind Enemy Lines;2001;Rotten;37;62;49;82;131;33
The Order;2002;Rotten;0;28;0;6;6;0
Scooby-Doo;2002;Rotten;30;38;44;101;145;31
Crossroads;2002;Rotten;14;40;15;89;104;26
The New Guy;2002;Rotten;7;54;7;92;99;28
Conspiracy;2001;Fresh;100;86;7;0;7;4
The Time Machine;2002;Rotten;29;37;44;109;153;34
The Rookie;2002;Certified-Fresh;84;70;130;25;155;42
Perfume;2001;Rotten;11;51;0;0;9;0
Showtime;2002;Rotten;25;25;31;92;123;33
Human Nature;2002;Rotten;49;61;47;48;95;28
Murder by Numbers;2002;Rotten;31;49;40;88;128;33
Enigma;2002;Fresh;72;55;76;30;106;31
Joshua;2002;Rotten;22;76;5;18;23;4
11:14;2003;Fresh;92;76;11;1;12;1
Enough;2002;Rotten;22;67;27;98;125;34
Insomnia;2002;Certified-Fresh;92;77;187;16;203;48
Shiner;2001;Rotten;46;29;6;7;13;3
They;2002;Rotten;38;24;21;35;56;13
Brother's Keeper;2002;Rotten;57;23;4;3;7;2
Trapped;2002;Rotten;17;48;10;49;59;15
Beat;2000;Rotten;57;37;4;3;7;1
The Dogwalker;2002;Rotten;50;;5;5;10;3
Derailed;1900;Rotten;0;21;0;5;5;0
Swept Away;2002;Rotten;5;28;4;75;79;31
All or Nothing;2002;Certified-Fresh;82;81;75;17;92;28
Femme Fatale;2002;Rotten;49;49;67;70;137;33
The Quiet American;2003;Certified-Fresh;87;72;135;21;156;42
Door to Door;2002;Fresh;60;83;3;2;5;1
One Week;2001;Fresh;80;81;8;2;10;7
Empire;2002;Rotten;21;62;21;80;101;28
Adaptation;2002;Certified-Fresh;91;85;191;19;210;41
Pinocchio;2002;Rotten;0;32;0;55;55;18
Nicholas Nickleby;2002;Certified-Fresh;78;75;100;28;128;35
The Gathering Storm;2002;Fresh;83;82;5;1;6;2
Lockdown;2002;Rotten;58;79;7;5;12;5
The Hunted;2003;Rotten;29;47;43;106;149;36
Down (The Shaft);2001;Rotten;20;18;1;4;5;0
Avenging Angelo;2002;Rotten;13;33;1;7;8;0
Anger Management;2003;Rotten;42;60;82;112;194;45
Devdas;2002;Fresh;89;88;17;2;19;4
Lift;2001;Rotten;50;70;5;5;10;3
Spellbound;2002;Certified-Fresh;97;83;135;4;139;33
Carrie;2002;Rotten;20;50;2;8;10;5
Double Vision;2002;Fresh;60;44;3;2;5;0
Unconditional Love;2002;Rotten;14;68;1;6;7;1
Le Divorce;2003;Rotten;36;26;51;90;141;40
Grind;2003;Rotten;8;79;6;68;74;27
Cabin Fever;2002;Fresh;62;44;87;53;140;34
Luther;2003;Rotten;45;74;28;34;62;22
Dummy;2003;Fresh;71;74;24;10;34;10
Suicide Club;2002;Rotten;57;69;4;3;7;0
Good Boy!;2003;Rotten;44;40;38;49;87;30
House of the Dead;2003;Rotten;3;10;2;59;61;14
Mayor of the Sunset Strip;2004;Certified-Fresh;87;76;68;10;78;30
The Missing;2003;Rotten;58;50;101;72;173;40
The Big Empty;2003;Fresh;71;48;5;2;7;1
Big Fish;2003;Certified-Fresh;75;89;165;54;219;46
Highwaymen;2004;Rotten;13;37;2;13;15;3
American Gun;2002;Rotten;40;41;8;12;20;5
The Company;2003;Fresh;72;49;96;38;134;34
Peter Pan;2003;Certified-Fresh;77;74;111;34;145;38
Torque;2004;Rotten;23;41;26;89;115;32
112 Weddings;2013;Fresh;76;61;13;4;17;6
The Reckoning;2004;Rotten;39;56;35;54;89;34
The Girl Next Door;2004;Rotten;56;69;90;70;160;34
Ned Kelly;2003;Rotten;55;53;32;26;58;16
Envy;2004;Rotten;8;27;9;109;118;35
The Punisher;2004;Rotten;29;63;49;121;170;42
Valentin;2004;Fresh;61;93;41;26;67;27
The Terminal;2004;Fresh;61;74;125;81;206;46
Madeleine;1950;Fresh;83;70;5;1;6;1
King Arthur;2004;Rotten;31;59;59;132;191;41
Let's Get Frank;2003;Rotten;54;44;7;6;13;7
Heartlands;2002;Fresh;60;79;3;2;5;2
7 Days in September;2002;Fresh;100;80;11;0;11;3
Kal Ho Naa Ho;2003;Fresh;70;92;7;3;10;5
The 24th Day;2004;Rotten;27;58;4;11;15;8
Uncovered: The War on Iraq;2004;Certified-Fresh;78;69;38;11;49;22
Almost Peaceful;2004;Fresh;73;68;22;8;30;16
Lightning in a Bottle;2004;Certified-Fresh;87;88;54;8;62;24
Pride and Prejudice;2003;Fresh;66;56;19;10;29;8
Journey Into Amazing Caves;2001;Fresh;80;72;8;2;10;0
Late Night Shopping;2001;Fresh;67;78;4;2;6;1
Black Cloud;2005;Rotten;29;80;2;5;7;2
Lana's Rain;2004;Rotten;22;60;2;7;9;6
Spin;2004;Rotten;43;69;3;4;7;1
Everyday People;2004;Fresh;67;40;6;3;9;4
Beauty Shop;2005;Rotten;38;62;45;74;119;31
A Snake of June (Rokugatsu no hebi);2002;Fresh;60;73;6;4;10;1
Dead Birds;2004;Rotten;50;40;4;4;8;0
Hostage;2005;Rotten;35;62;55;103;158;41
Are We There Yet?;2005;Rotten;12;45;14;102;116;34
Hide and Seek;2005;Rotten;13;50;20;138;158;38
Sacred Planet;2004;Rotten;58;62;14;10;24;12
Employee of the Month;2004;Rotten;11;52;1;8;9;0
The Private Lives of Elizabeth and Essex;1939;Fresh;71;64;5;2;7;0
Union Square;2004;Rotten;53;55;8;7;15;7
Cursed;2005;Rotten;17;30;16;80;96;17
Sky High;2005;Fresh;73;57;96;35;131;30
The Snow Walker;2003;Fresh;86;78;12;2;14;3
Devour;2005;Rotten;20;42;1;4;5;0
Appurushido (Appleseed);2004;Rotten;25;74;8;24;32;18
Sahara;2005;Rotten;38;53;68;110;178;38
Nightmare Alley;1947;Fresh;100;87;11;0;11;3
Arven (The Inheritance);2004;Fresh;75;84;27;9;36;16
Moog;2004;Rotten;29;43;5;12;17;8
Crash;2004;Certified-Fresh;74;88;179;62;241;53
Antares;2004;Rotten;0;57;0;5;5;2
The Honeymooners;2005;Rotten;13;30;14;98;112;33
Stealth;2005;Rotten;12;40;17;124;141;33
The Muppets' Wizard of Oz;2005;Rotten;30;36;3;7;10;0
No Direction Home: Bob Dylan;2005;Fresh;88;95;15;2;17;6
Bad Timing;1980;Rotten;50;75;5;5;10;3
Pom Poko (Heisei tanuki gassen pompoko) (The Raccoon War);1994;Fresh;85;77;11;2;13;1
The Skeleton Key;2005;Rotten;38;58;58;96;154;35
Red Eye;2005;Certified-Fresh;79;64;153;40;193;42
Wall (Mur);2004;Fresh;68;68;21;10;31;12
Bomb the System;2003;Rotten;32;84;7;15;22;10
Hellbent;2005;Rotten;48;41;20;22;42;13
Venom;2005;Rotten;11;21;7;56;63;21
Capote;2005;Certified-Fresh;90;82;176;20;196;43
Nine Lives;2005;Certified-Fresh;75;67;64;21;85;26
Festival;2005;Fresh;80;54;8;2;10;1
Good Night, And Good Luck;2005;Certified-Fresh;93;83;211;15;226;51
Kids in America;2005;Rotten;17;65;6;30;36;17
Rent;2005;Rotten;46;83;81;94;175;37
Jarhead;2005;Fresh;61;68;122;78;200;48
Godzilla: Final Wars;2004;Rotten;50;70;6;6;12;1
The New World;2005;Fresh;63;58;118;70;188;46
Pride and Prejudice;2005;Certified-Fresh;86;89;155;25;180;42
The Ringer;2005;Rotten;40;68;36;53;89;28
Land of Plenty;2004;Fresh;62;62;16;10;26;8
Breakfast on Pluto;2005;Rotten;57;80;70;52;122;33
Mystery of the Nile;2005;Fresh;69;71;11;5;16;7
The Football Factory;2004;Rotten;38;83;3;5;8;3
Curious George;2006;Fresh;70;69;75;32;107;35
Big Momma's House 2;2006;Rotten;5;58;4;69;73;23
The Promise (Master of Crimson Armor) (Wu ji);2005;Rotten;31;44;24;54;78;27
Pariah;1998;Rotten;43;49;6;8;14;5
11:55;2017;Fresh;100;79;5;0;5;3
Hoodwinked;2005;Rotten;46;56;58;67;125;36
Glory Road;2006;Rotten;55;81;84;68;152;35
Date Movie;2006;Rotten;7;35;6;84;90;19
Why We Fight;2006;Certified-Fresh;78;88;89;25;114;36
Casanova;2005;Rotten;43;58;58;76;134;41
Doogal;2006;Rotten;8;22;4;45;49;17
Summer Storm (Sommersturm);2006;Rotten;48;78;16;17;33;15
Adam & Steve;2005;Rotten;55;56;21;17;38;17
On a Clear Day;2006;Fresh;68;72;46;22;68;27
Clean;2005;Fresh;73;66;48;18;66;30
The Panic in Needle Park;1971;Fresh;85;75;11;2;13;4
London;2006;Rotten;14;60;5;31;36;15
Little Fish;2006;Fresh;90;57;27;3;30;10
Evil (Ondskan);2006;Fresh;68;87;26;12;38;14
The Devil and Daniel Johnston;2006;Certified-Fresh;88;91;99;13;112;36
See No Evil;2006;Rotten;9;50;5;53;58;14
Marie Antoinette;2006;Rotten;57;56;122;93;215;53
Goal! The Dream Begins (Goal!: The Impossible Dream);2005;Rotten;42;77;35;48;83;27
The Dark;2004;Rotten;40;32;4;6;10;0
Sleeping Dogs Lie;2006;Fresh;64;41;34;19;53;19
The Oh in Ohio;2006;Rotten;23;35;16;54;70;26
Christmas in the Clouds;2005;Fresh;69;64;24;11;35;15
The Hoax;2007;Certified-Fresh;86;58;132;22;154;42
For Your Consideration;2006;Rotten;52;43;83;78;161;51
Free Zone;2006;Rotten;26;35;12;34;46;16
Standing Still;2005;Rotten;36;37;8;14;22;9
Superhero Movie;2008;Rotten;17;32;9;44;53;15
The Blue Butterfly;2004;Rotten;44;64;4;5;9;3
Straight Into Darkness;2005;Rotten;57;38;4;3;7;0
Look Both Ways;2006;Certified-Fresh;76;75;44;14;58;25
The Big White;2005;Rotten;30;56;3;7;10;2
Bobby;2006;Rotten;47;72;82;94;176;50
Cavite;2006;Fresh;73;54;29;11;40;15
Land of the Blind;2006;Rotten;17;63;3;15;18;11
Coastlines;2006;Rotten;48;28;12;13;25;15
A Slight Case of Murder;1938;Fresh;80;74;4;1;5;0
Unconscious;2006;Fresh;85;87;22;4;26;10
Home;2005;Rotten;38;40;3;5;8;4
The Breed;2006;Rotten;27;29;4;11;15;6
Stupidity;1900;Fresh;67;45;4;2;6;2
Voices of Iraq;2004;Fresh;60;84;9;6;15;12
Trade;2007;Rotten;33;74;24;48;72;30
Abominable;2006;Fresh;67;41;10;5;15;3
Rest Stop;2006;Rotten;0;29;0;6;6;0
Red Doors;2005;Fresh;61;71;14;9;23;11
Pizza;2005;Rotten;31;51;4;9;13;7
The Woods;2006;Fresh;67;37;10;5;15;0
The Magus;1968;Rotten;40;53;2;3;5;2
Driving Lessons;2006;Rotten;48;71;36;39;75;28
Ballets Russes;2005;Certified-Fresh;92;81;55;5;60;22
Angel Rodriguez;1900;Fresh;83;11;5;1;6;2
Karla;2006;Rotten;0;37;0;12;12;3
Death & Texas;2004;Fresh;75;;6;2;8;3
Cocaine Angel;2007;Fresh;60;53;3;2;5;3
The Invisible;2007;Rotten;20;57;12;48;60;15
The Bridge;2006;Fresh;68;72;40;19;59;21
Conversations With God;2006;Rotten;7;67;3;43;46;21
Perfect Stranger;2007;Rotten;10;51;14;128;142;41
Vitus;2007;Fresh;66;80;40;21;61;24
Definitely, Maybe;2008;Certified-Fresh;70;72;104;44;148;40
Wanted;2008;Certified-Fresh;71;69;147;59;206;44
Silk;2007;Rotten;7;29;4;51;55;24
License to Wed;2007;Rotten;7;53;9;116;125;37
Fred Claus;2007;Rotten;21;45;30;113;143;44
Antikorper (Antibodies);2007;Fresh;67;71;14;7;21;10
Funny Games;2008;Rotten;52;54;75;69;144;40
The Jane Austen Book Club;2007;Fresh;66;67;77;39;116;38
Fail Safe;2000;Fresh;100;79;5;0;5;0
Lars and the Real Girl;2007;Certified-Fresh;81;84;113;26;139;42
Ghosts of Abu Ghraib;2007;Fresh;100;91;10;0;10;3
Longford;1900;Fresh;100;86;7;0;7;3
A Simple Curve;2005;Fresh;63;57;5;3;8;3
Tortilla Heaven;2007;Rotten;25;34;3;9;12;2
Madeinusa;2006;Fresh;83;72;5;1;6;3
10 MPH;1900;Fresh;80;64;4;1;5;1
Hurricane on the Bayou;2006;Fresh;85;64;17;3;20;10
In Debt We Trust;2009;Fresh;80;66;4;1;5;1
The Contract;2006;Rotten;0;26;0;5;5;0
Descent;2007;Rotten;35;33;12;22;34;14
Kannathil Muthamittal (A Peck on the Cheek);2002;Fresh;83;93;5;1;6;1
Rally 'Round the Flag, Boys!;1958;Rotten;30;49;3;7;10;4
Hollywood Dreams;2007;Rotten;38;68;11;18;29;17
The Final Season;2007;Rotten;26;67;13;37;50;14
The Last Time;2007;Rotten;35;39;6;11;17;7
Take;2008;Rotten;45;42;13;16;29;13
You Kill Me;2007;Certified-Fresh;78;59;90;25;115;39
Amu;2006;Fresh;82;76;18;4;22;13
Splinter;2006;Rotten;43;28;3;4;7;2
11/08/2016;2017;Fresh;75;61;9;3;12;6
As You Like It;2006;Rotten;36;49;5;9;14;7
The Hunting Party;2007;Rotten;55;67;52;42;94;30
Michael Moore Hates America;2004;Fresh;75;59;6;2;8;4
Dirty Laundry;2006;Rotten;50;68;6;6;12;6
Evil Aliens;1900;Rotten;50;53;6;6;12;2
The Burning;1981;Fresh;80;61;8;2;10;0
Alvin and the Chipmunks;2007;Rotten;28;64;30;79;109;35
The Unknown Soldier;2007;Fresh;60;80;6;4;10;3
Dear Pillow;2004;Fresh;100;75;6;0;6;0
Coffee Date;2006;Rotten;50;61;9;9;18;8
The Express;2008;Fresh;62;75;74;46;120;39
The Rape of Europa;2007;Certified-Fresh;82;92;37;8;45;21
Broken;2007;Rotten;12;32;2;15;17;10
Itty Bitty Titty Committee;2007;Rotten;38;56;3;5;8;1
Strange Culture;2007;Fresh;91;60;20;2;22;10
Blindness;2008;Rotten;43;47;69;90;159;44
Mad Money;2008;Rotten;22;48;23;83;106;35
The Haunting in Connecticut;2009;Rotten;17;45;18;87;105;29
Billy the Kid;2020;Fresh;81;86;26;6;32;11
Tenderness;2008;Rotten;40;22;6;9;15;5
Angels & Demons;2009;Rotten;37;57;95;164;259;58
The Lovely Bones;2009;Rotten;32;52;78;168;246;58
Shelter;2007;Fresh;60;85;12;8;20;7
The Great Buck Howard;2009;Fresh;71;49;67;27;94;31
The Bank Job;2008;Certified-Fresh;79;74;116;30;146;41
Zack and Miri Make a Porno;2008;Fresh;66;66;131;69;200;51
Blood Creek;2009;Rotten;43;30;3;4;7;0
Over Her Dead Body;2008;Rotten;15;42;16;93;109;37
Imagine That;2009;Rotten;40;40;48;71;119;34
Ghost Town;2008;Certified-Fresh;85;60;157;28;185;49
College;2008;Rotten;5;27;2;41;43;14
Changeling;2008;Fresh;62;82;129;80;209;52
L.A. Twister;2004;Rotten;13;33;2;13;15;6
Life is a Bed of Roses;1983;Fresh;78;44;7;2;9;3
What Love Is;2008;Rotten;15;55;2;11;13;8
No Smoking;2007;Rotten;46;62;6;7;13;8
Mister Lonely;2007;Rotten;47;57;34;38;72;29
Hell Ride;2008;Rotten;10;30;6;53;59;21
Partition;2007;Rotten;38;73;8;13;21;9
Smart People;2008;Rotten;49;39;74;76;150;43
The Cottage;2008;Fresh;72;45;13;5;18;6
State of Play;2009;Certified-Fresh;84;73;179;34;213;56
All Hat;1900;Rotten;20;18;1;4;5;2
Trumbo;2007;Certified-Fresh;83;78;45;9;54;21
Deal;2008;Rotten;3;38;1;34;35;9
Chapter 27;2007;Rotten;18;37;9;40;49;20
Step Brothers;2008;Rotten;55;69;113;92;205;51
Botched;2008;Rotten;25;44;2;6;8;3
Noise;2007;Rotten;58;60;26;19;45;18
Burning the Future: Coal in America;1900;Fresh;88;75;7;1;8;4
Miss Conception;2008;Rotten;8;19;1;12;13;5
Elegy;2008;Certified-Fresh;75;61;91;31;122;41
The Take;2007;Fresh;85;48;11;2;13;6
All in This Tea;2007;Fresh;83;80;10;2;12;5
Ice Age: Dawn of the Dinosaurs (Ice Age 3);2009;Rotten;46;62;75;89;164;46
High School Musical 3: Senior Year;2008;Fresh;63;72;83;48;131;39
Heart of the Beholder;1900;Fresh;83;56;5;1;6;0
Fanaa;2006;Fresh;100;78;7;0;7;3
Encounters at the End of the World;2007;Certified-Fresh;94;83;104;7;111;37
Phoebe in Wonderland;2009;Fresh;61;70;33;21;54;21
Love and Other Disasters;2006;Rotten;20;57;1;4;5;2
Bunt. Delo Litvinenko (Poisoned by Polonium: The Litvinenko File) (Rebellion: The Litvinenko Case);2007;;;;7;4;;7
Salaam Namaste;2005;Fresh;83;75;5;1;6;2
The Wolfman;2010;Rotten;34;33;74;145;219;41
Happy-Go-Lucky;2008;Certified-Fresh;92;67;147;12;159;47
Viva;2007;Fresh;62;39;31;19;50;19
My Winnipeg;2007;Certified-Fresh;95;77;87;5;92;31
Space Chimps;2008;Rotten;33;33;30;62;92;29
Hounddog;2008;Rotten;15;48;8;45;53;24
Never Forever;2007;Fresh;80;71;16;4;20;10
The Princess and the Frog;2009;Certified-Fresh;85;74;168;30;198;50
Cloudy With a Chance of Meatballs;2009;Certified-Fresh;86;72;123;20;143;38
Lou Reed's Berlin;2008;Fresh;78;85;25;7;32;15
Patti Smith: Dream of Life;2008;Fresh;67;76;26;13;39;20
Lakeview Terrace;2008;Rotten;44;39;73;92;165;45
Quarantine;2008;Rotten;56;44;48;38;86;18
Reprise;2006;Certified-Fresh;88;84;71;10;81;35
Before the Rains;2008;Rotten;49;50;33;35;68;28
My Name Is Bruce;2007;Rotten;38;48;15;24;39;12
Mirrors;2008;Rotten;15;44;13;75;88;20
Trapped Ashes;1900;Rotten;33;14;4;8;12;6
OSS 117: Le Caire Nid d'Espions (OSS 117: Cairo, Nest of Spies);2008;Certified-Fresh;77;75;46;14;60;20
Hofshat Kaits (My Father My Lord);2008;Fresh;95;75;35;2;37;18
Ballast;2008;Certified-Fresh;92;71;73;6;79;27
Paris;2008;Fresh;66;66;47;24;71;26
Never Say Macbeth;2007;Fresh;100;59;8;0;8;0
Fantastic Mr. Fox;2009;Certified-Fresh;93;85;222;18;240;53
The Art Of Travel;2008;Fresh;63;51;5;3;8;1
Ballet Shoes;2008;Fresh;100;66;6;0;6;1
The Perfect Game;2010;Rotten;57;70;25;19;44;17
Shutter Island;2010;Fresh;68;76;175;83;258;57
Disfigured;2008;Fresh;71;61;5;2;7;1
Bustin' Down the Door;2008;Fresh;79;73;30;8;38;16
Ninja Assassin;2009;Rotten;26;54;30;86;116;33
Recount;2008;Certified-Fresh;78;81;25;7;32;21
I Love You Beth Cooper;2009;Rotten;13;32;16;103;119;40
Far North;2008;Fresh;83;47;5;1;6;1
11/11/2011;1900;Rotten;7;17;1;13;14;3
11 Minutes (11 Minut);2016;Fresh;74;38;14;5;19;5
The 11th Hour;2007;Fresh;67;69;62;31;93;33
The Informant!;2009;Certified-Fresh;79;44;183;48;231;50
RoboCop;2014;Rotten;48;49;105;114;219;48
The Wrecking Crew;2015;Certified-Fresh;94;84;67;4;71;20
Closing the Ring;2007;Rotten;33;58;6;12;18;6
Dorian Gray;2009;Rotten;44;39;17;22;39;9
Nobel Son;2008;Rotten;25;44;16;49;65;26
17 Again;2009;Rotten;56;67;83;65;148;43
The Good Life;2007;Rotten;20;53;1;4;5;1
The Tooth Fairy;2010;Rotten;17;41;20;95;115;34
The Greatest;2010;Rotten;53;53;31;27;58;26
Labor Pains;2009;Rotten;0;30;0;5;5;0
Dark Streets;2008;Rotten;19;14;7;29;36;10
The Book of Revelation;1900;Fresh;69;42;9;4;13;5
Open Window;2006;Rotten;20;33;1;4;5;2
Green Zone;2010;Rotten;53;57;100;88;188;51
Easy Virtue;2009;Rotten;52;47;66;60;126;43
Dear Zachary: A Letter to a Son About His Father;2008;Certified-Fresh;94;96;48;3;51;10
Under the Sea 3D;2009;Certified-Fresh;94;75;46;3;49;22
Dance of the Dead;2008;Fresh;80;51;4;1;5;1
Fetching Cody;2005;Rotten;0;69;0;5;5;3
Me and Orson Welles;2009;Certified-Fresh;85;61;134;23;157;40
Center Stage: Turn It Up;2008;Fresh;60;58;3;2;5;1
The Children;2008;Fresh;76;50;13;4;17;5
War Child;2008;Rotten;50;79;3;3;6;2
Garbage Warrior;2007;Fresh;83;85;5;1;6;2
The Last House on the Left;2009;Rotten;42;52;70;96;166;40
The Crazies;2010;Fresh;70;56;109;46;155;41
9;2009;Rotten;57;56;105;79;184;44
The Three Stooges;2012;Rotten;52;47;77;72;149;34
The Lodger;2009;Rotten;24;29;6;19;25;8
Paper Man;2010;Rotten;32;48;10;21;31;14
Creation;2010;Rotten;46;49;52;61;113;32
Our Man in Havana;1959;Fresh;94;77;16;1;17;5
Crips and Bloods: Made in America;2008;Fresh;76;73;16;5;21;10
Tennessee;2009;Rotten;33;52;7;14;21;13
Free Style;2009;Rotten;33;54;6;12;18;13
Helen;2010;Rotten;44;49;4;5;9;4
Four Flies on Grey Velvet (4 mosche di velluto grigio);1971;Fresh;67;60;6;3;9;2
Weapons;1900;Rotten;0;55;0;9;9;1
Islander;2007;Fresh;88;83;7;1;8;4
The Taking of Pelham 1 2 3;2009;Rotten;51;52;118;112;230;56
Obsessed;2009;Rotten;19;46;17;73;90;28
Katyn;2009;Certified-Fresh;91;75;62;6;68;30
Sugarhouse;2007;Rotten;29;52;5;12;17;9
Weather Girl;2009;Rotten;33;36;3;6;9;2
Unmade Beds;2009;Fresh;76;68;22;7;29;13
Adam;2009;Fresh;66;72;88;46;134;38
Tyson;2009;Certified-Fresh;85;79;125;22;147;50
The Boys Are Back;2009;Fresh;73;61;90;34;124;44
Splice;2010;Certified-Fresh;75;37;146;48;194;38
Crossing Arizona;2006;Fresh;100;79;6;0;6;4
It's Complicated;2009;Rotten;58;60;106;76;182;48
The Cove;2009;Certified-Fresh;95;94;126;7;133;42
Vinyan;2008;Rotten;53;32;10;9;19;3
12:08 East of Bucharest (A fost sau n-a fost?);2007;Certified-Fresh;96;75;45;2;47;24
Black Sun;2005;Fresh;75;85;6;2;8;1
Mary and Max;2009;Certified-Fresh;95;92;61;3;64;13
New York;2009;Rotten;57;66;4;3;7;4
Puss in Boots;2011;Certified-Fresh;86;67;132;22;154;31
Mystery Team;2009;Rotten;58;64;11;8;19;6
Reunion;2009;Rotten;19;33;3;13;16;8
The Last Word;2009;Rotten;40;48;2;3;5;1
El Bano del Papa (The Pope's Toilet);2007;Fresh;88;79;23;3;26;12
The Twilight Saga: Eclipse;2010;Rotten;48;60;118;127;245;52
Antichrist;2009;Rotten;53;55;94;82;176;48
Splinterheads;2009;Rotten;27;50;3;8;11;6
Baby on Board;2008;Rotten;20;19;1;4;5;1
Extract;2009;Fresh;62;38;117;71;188;44
The Debt;2011;Certified-Fresh;77;66;142;43;185;45
Everybody's Fine;2009;Rotten;48;53;68;75;143;41
Last Night;2011;Rotten;53;46;36;32;68;23
Howl;2010;Fresh;63;58;69;40;109;35
Life During Wartime;2010;Fresh;68;48;71;33;104;40
The Friends of Eddie Coyle;1973;Fresh;100;88;27;0;27;5
The Skeptic;2009;Rotten;8;27;1;11;12;5
Remember Me;2010;Rotten;27;69;37;102;139;42
Uncle Nino;2003;Rotten;21;69;7;26;33;14
What Goes Up;2009;Rotten;16;31;5;26;31;15
C'est Pas Moi, Je le Jure! (It's Not Me, I Swear!);2008;Fresh;100;85;5;0;5;2
Home;2009;Fresh;94;73;33;2;35;14
Triangle;2009;Certified-Fresh;80;66;32;8;40;8
BLAST!;2009;Fresh;67;;8;4;12;7
Get Him to the Greek;2010;Certified-Fresh;72;62;144;56;200;47
Home;2011;Rotten;0;86;0;5;5;2
The End of the Line;2009;Certified-Fresh;78;82;36;10;46;20
The Eclipse;2010;Certified-Fresh;75;48;63;21;84;25
The Blind Side;2009;Fresh;66;85;134;70;204;39
Stone of Destiny;2008;Rotten;53;58;9;8;17;5
The Sunchaser;1996;Rotten;17;40;1;5;6;2
Furry Vengeance;2010;Rotten;7;32;7;88;95;24
Warrior;2011;Certified-Fresh;83;92;159;32;191;46
Beyond a Reasonable Doubt;2009;Rotten;7;36;2;26;28;14
A Prophet (Un prophete);2010;Certified-Fresh;97;89;155;5;160;48
Homecoming;2009;Rotten;0;33;0;24;24;9
American Son;1900;Fresh;100;51;13;0;13;2
The Narrows;2008;Rotten;25;47;3;9;12;6
Big Fan;2009;Certified-Fresh;86;62;76;12;88;28
Salt;2010;Fresh;62;59;151;94;245;55
Did You Hear About the Morgans?;2009;Rotten;11;27;14;108;122;39
World's Greatest Dad;2009;Certified-Fresh;88;67;104;14;118;38
No Impact Man: The Documentary;2009;Certified-Fresh;83;63;40;8;48;18
Ghosted;2009;Rotten;7;17;1;13;14;6
Death in Love;2009;Rotten;45;33;9;11;20;11
X Games 3D: The Movie;2009;Rotten;38;66;11;18;29;13
Nollywood Babylon;2008;Fresh;83;76;5;1;6;3
The Way We Get By;2009;Fresh;92;87;23;2;25;9
Five Minutes of Heaven;2009;Certified-Fresh;75;60;33;11;44;17
Brothers;2009;Fresh;64;62;100;57;157;50
The Collector;2009;Rotten;29;48;21;52;73;14
One Week;1900;Rotten;50;73;4;4;8;3
The Hills Run Red;2009;Rotten;57;33;4;3;7;0
Despicable Me;2010;Certified-Fresh;81;82;163;38;201;42
The Disappeared;2008;Fresh;64;43;9;5;14;5
Apres lui;2007;Fresh;83;53;5;1;6;1
The Poker House;2008;Fresh;63;64;5;3;8;3
Deadgirl;2008;Rotten;29;40;5;12;17;3
The Meerkats;2008;Fresh;73;80;8;3;11;4
Run Robot Run!;1900;Fresh;100;62;5;0;5;2
Anita O'Day: The Life of a Jazz Singer;2007;Fresh;100;76;30;0;30;14
Carriers;2009;Fresh;66;39;25;13;38;7
Earth Days;2009;Fresh;82;59;27;6;33;15
Amreeka;2009;Certified-Fresh;87;76;62;9;71;28
I Sell the Dead;2008;Certified-Fresh;72;46;33;13;46;12
My One and Only;2009;Fresh;68;51;49;23;72;26
The Horse Boy;2009;Fresh;76;75;25;8;33;13
Fifty Dead Men Walking;2008;Certified-Fresh;83;68;43;9;52;17
Nurse.Fighter.Boy;2009;Fresh;80;79;4;1;5;3
Art & Copy;2009;Rotten;57;65;16;12;28;12
Triangle (Tie saam gok);2007;Rotten;53;43;8;7;15;8
Franklyn;2008;Rotten;57;43;17;13;30;9
Ink;2009;Fresh;100;81;6;0;6;2
Passing Strange;2009;Fresh;100;89;25;0;25;10
We Live in Public;2009;Certified-Fresh;82;79;42;9;51;19
Staten Island (Little New York);2009;Rotten;25;28;2;6;8;6
Kick-Ass;2010;Certified-Fresh;76;81;200;63;263;53
Motherland;2009;Fresh;92;67;11;1;12;1
Know Your Mushrooms;2008;Fresh;100;54;8;0;8;4
Loren Cass;2006;Fresh;69;26;9;4;13;5
White on Rice;2009;Rotten;45;52;5;6;11;4
Blind Date;2009;Rotten;33;34;7;14;21;10
A Single Man;2009;Certified-Fresh;85;81;164;28;192;50
Not Forgotten;2009;Rotten;15;17;2;11;13;6
Passchendaele;1900;Rotten;40;57;6;9;15;8
The Mighty Celt;2005;Fresh;67;65;4;2;6;0
Paheli;2005;Rotten;57;66;4;3;7;4
Ice People;2008;Fresh;89;100;8;1;9;5
Eid milad Laila (Laila's Birthday);2008;Fresh;80;65;8;2;10;4
Shank;2009;Fresh;60;57;3;2;5;2
Children of the Corn;2009;Rotten;0;16;0;5;5;0
The Bounty Hunter;2010;Rotten;12;51;18;130;148;44
Chevolution;2008;Fresh;76;74;13;4;17;7
Breaking Point;2009;Rotten;0;20;0;8;8;8
Che: Part One (The Argentine);2009;Fresh;68;75;96;46;142;41
Alice in Wonderland;2010;Rotten;51;55;141;135;276;55
An Englishman in New York;2009;Fresh;70;72;7;3;10;2
Fix;2009;Rotten;56;57;5;4;9;3
Alice in Wonderland;1933;Fresh;75;59;6;2;8;0
Waveriders;1900;Rotten;56;59;9;7;16;6
Tony;2009;Fresh;76;58;13;4;17;7
The Losers;2010;Rotten;48;54;80;86;166;38
127 Hours;2010;Certified-Fresh;93;85;219;16;235;47
Twelve Monkeys (12 Monkeys);1995;Certified-Fresh;89;88;62;8;70;22
12 O'clock Boys;2014;Certified-Fresh;92;64;44;4;48;20
12 Rounds;2009;Rotten;30;45;21;50;71;20
12 Strong;2018;Rotten;50;62;86;85;171;39
12 Years a Slave;2013;Certified-Fresh;95;90;348;17;365;64
13;2011;Rotten;8;34;1;12;13;7
13 Assassins;2011;Certified-Fresh;95;88;124;6;130;34
13 Cameras;2016;Fresh;77;35;10;3;13;4
13 Ghosts;1960;Rotten;36;41;5;9;14;1
13 Going on 30;2004;Fresh;65;70;116;63;179;42
13 Hours: The Secret Soldiers Of Benghazi;2016;Rotten;51;82;113;109;222;45
13 Rue Madeleine;1947;Fresh;83;54;5;1;6;0
13 Sins;2014;Fresh;65;45;28;15;43;7
13 Tzameti;2005;Certified-Fresh;84;85;56;11;67;26
The 13th Warrior;1999;Rotten;33;65;29;59;88;21
1408;2007;Certified-Fresh;80;61;140;36;176;44
1492: Conquest of Paradise;1992;Rotten;32;50;7;15;22;6
14 Blades;2014;Fresh;69;52;9;4;13;5
14 Cameras;2018;Rotten;22;23;2;7;9;4
14 Hours;1951;Fresh;100;74;5;0;5;1
01:54;2018;Rotten;57;57;4;3;7;3
15 Minutes;2001;Rotten;32;37;40;85;125;33
15 Minutes of War (L'intervention);2019;Rotten;43;82;3;4;7;2
15 Years;1900;Fresh;67;;4;2;6;1
16 Acres;2012;Fresh;100;73;8;0;8;6
16 Blocks;2006;Rotten;56;57;90;72;162;42
16 Years of Alcohol;2003;Fresh;80;68;12;3;15;8
1776;1972;Fresh;69;84;11;5;16;2
17 Girls;2012;Fresh;67;39;14;7;21;12
180 South;2010;Fresh;80;85;4;1;5;1
18 Again!;1988;Rotten;29;46;2;5;7;1
18 Presents (18 Regali);1900;Fresh;60;62;3;2;5;1
1900 (Novecento);1977;Rotten;58;85;11;8;19;4
1911;2011;Rotten;8;30;2;22;24;11
1917;2020;Certified-Fresh;89;88;394;51;444;48
1922;2017;Certified-Fresh;91;57;39;4;43;8
1941;1979;Rotten;42;48;10;14;24;1
1982;1900;Fresh;78;61;7;2;9;2
1984;1984;Fresh;74;71;20;7;27;2
1985;2018;Certified-Fresh;96;80;47;2;49;12
1;2013;Fresh;82;39;9;2;11;3
1 Night (One Night);2017;Rotten;33;61;2;4;6;4
1BR;2020;Certified-Fresh;86;55;61;10;71;7
20,000 Days on Earth;2014;Certified-Fresh;95;78;83;4;87;32
2001: A Space Odyssey;1968;Certified-Fresh;92;89;103;9;112;28
2010;1984;Fresh;66;61;23;12;35;7
What Women Want;2011;Rotten;0;29;0;5;5;3
2012;2009;Rotten;39;47;96;148;244;51
2016: Obama's America;2012;Rotten;26;73;9;25;34;13
2050;2019;;;;1;4;;1
20 Centimeters (20 Centimetres) (20 centimetros);2005;Rotten;44;82;7;9;16;7
20 Feet From Stardom;2013;Certified-Fresh;99;82;125;1;126;37
20 Million Miles to Earth;1957;Fresh;73;55;8;3;11;0
20 Weeks;2018;Fresh;60;20;3;2;5;3
20th Century Women;2017;Certified-Fresh;88;74;196;27;222;43
211;2018;Rotten;4;9;1;23;24;7
02-ene;2020;Rotten;56;29;5;4;9;4
21 And Over;2013;Rotten;27;46;29;80;108;27
21 Grams;2003;Certified-Fresh;80;86;147;36;183;39
21 Jump Street;2012;Certified-Fresh;84;82;189;35;224;45
21 Years: Richard Linklater;2014;Rotten;40;55;6;9;15;7
02:22;2017;Rotten;22;38;2;7;9;1
22 Bullets;2013;Rotten;46;55;6;7;13;3
22 July;2018;Certified-Fresh;80;70;101;25;126;28
22 Jump Street;2014;Certified-Fresh;85;77;187;34;221;55
24 City (Er shi si cheng ji);2008;Certified-Fresh;91;71;39;4;43;21
24 Days;2015;Fresh;79;60;15;4;19;8
24 Exposures;2014;Rotten;35;5;7;13;20;10
24 Hour Party People;2002;Certified-Fresh;86;87;86;14;100;30
24 Hours on Craigslist;2004;Rotten;50;40;5;5;10;5
24 Hours to Live;2017;Rotten;52;29;11;10;21;5
24: Redemption;2008;Fresh;80;67;16;4;20;8
My Soul to Take;2010;Rotten;10;26;6;57;63;11
25th Hour;2003;Certified-Fresh;78;85;138;38;176;42
27 Dresses;2008;Rotten;41;57;62;90;152;42
28 Days;2000;Rotten;33;50;28;57;85;25
28 Days Later;2003;Certified-Fresh;87;85;201;31;232;51
28 Hotel Rooms;2012;Rotten;47;38;7;8;15;8
28 Weeks Later...;2007;Fresh;71;66;140;56;195;54
29 Palms;2003;Rotten;0;37;0;5;5;0
2 Autumns, 3 Winters;2014;Fresh;78;48;7;2;9;3
2 Brothers & a Bride;2003;Rotten;46;37;6;7;13;6
2 Days in New York;2012;Fresh;66;42;72;37;109;34
2 Days in Paris;2007;Certified-Fresh;87;72;104;15;119;45
2 Days in the Valley;1996;Rotten;59;54;32;22;54;13
2 Fast 2 Furious;2003;Rotten;36;50;58;102;160;38
2 Guns;2013;Fresh;64;66;121;67;188;50
2 in the Bush: A Love Story;1900;Fresh;100;80;5;0;5;0
2 Jacks;2013;Rotten;38;19;6;10;16;9
2nd Date Sex;2019;Rotten;44;43;4;5;9;1
3 Backyards;2011;Fresh;76;29;13;4;17;6
30 Days Of Night: Dark Days;1900;Rotten;17;14;1;5;6;0
300;2007;Fresh;61;89;143;92;235;50
3000 Miles to Graceland;2001;Rotten;14;46;13;83;96;23
300: Rise of an Empire;2014;Rotten;45;51;87;108;195;39
30 Beats;2012;Rotten;5;15;1;21;22;12
30 Days of Night;2007;Rotten;51;56;80;78;158;41
30 Miles from Nowhere;1900;Fresh;80;36;8;2;10;0
30 Minutes or Less;2011;Rotten;45;40;73;91;164;47
30 Years to Life;2002;Fresh;67;67;6;3;9;3
31;2016;Rotten;47;35;21;24;45;8
31 North 62 East (Too Close to the Truth);2009;Rotten;8;29;1;12;13;5
3:10 to Yuma;2007;Certified-Fresh;89;86;197;25;222;56
33 Postcards;2013;Rotten;27;43;4;11;15;7
360;2012;Rotten;20;32;15;60;75;30
37 Seconds;1900;Fresh;88;86;14;2;16;5
388 Arletta Avenue;1900;Rotten;56;23;5;4;9;6
3 (Drei);2011;Rotten;47;55;15;17;32;14
3, 2, 1... Frankie Go Boom;2012;Rotten;45;41;10;12;22;12
3-4x juugatsu (Boiling Point);;Fresh;94;63;16;1;17;6
3 Days To Kill;2014;Rotten;27;43;33;88;121;33
3 from Hell;2019;Rotten;56;59;20;16;36;3
3 Generations;2017;Rotten;32;44;14;30;44;17
3 Hearts (3 coeurs);2015;Certified-Fresh;80;44;32;8;40;15
3 Holes and a Smoking Gun;2015;Rotten;40;70;2;3;5;3
Three Idiots;2009;Fresh;100;93;13;0;13;4
3-Iron;2004;Certified-Fresh;87;94;80;12;92;27
3 Nights In The Desert;2015;Rotten;40;65;2;3;5;2
3 Ninjas;1992;Rotten;32;53;7;15;22;8
3 Ninjas: High Noon at Mega Mountain;1998;Rotten;0;29;0;6;6;3
3 Ninjas Kick Back;1994;Rotten;15;40;2;11;13;7
3 Women;1977;Fresh;94;86;29;2;31;7
The 400 Blows (Les Quatre cents coups);1959;Certified-Fresh;100;94;62;0;62;17
400 Days;2016;Rotten;22;41;2;7;9;2
40 Days and 40 Nights;2002;Rotten;39;43;53;84;137;35
The 40 Year Old Virgin;2005;Certified-Fresh;85;80;162;28;190;41
4/20 Massacre;1900;Rotten;50;46;4;4;8;3
42;2013;Certified-Fresh;80;85;156;38;194;51
42nd Street;1933;Fresh;96;74;24;1;25;4
4.3.2.1;1900;Rotten;37;42;11;19;30;9
4:44 Last Day on Earth;2012;Rotten;45;19;14;17;31;12
44 Inch Chest;2010;Rotten;41;36;33;48;81;25
45 Years;2015;Certified-Fresh;97;67;199;6;204;44
47 Meters Down;2017;Rotten;53;36;82;74;156;25
47 Meters Down: Uncaged;2019;Rotten;45;68;40;49;89;13
47 Ronin;2013;Rotten;16;48;14;74;88;20
48 HRS;1982;Certified-Fresh;93;69;38;3;41;6
49th Parallel (The Invaders);1941;Fresh;92;75;11;1;12;0
4 (Chetyre);2006;Fresh;75;63;21;7;28;14
4 Days in France (Jours de France);2017;Fresh;90;48;19;2;21;9
4 Little Girls;1997;Fresh;100;89;27;0;27;9
4 Minute Mile;2014;Rotten;29;44;4;10;14;8
4 Months, 3 Weeks and 2 Days;2007;Certified-Fresh;96;86;136;6;142;42
500 Days of Summer;2009;Certified-Fresh;85;84;196;35;231;54
50/50;2011;Certified-Fresh;93;88;185;14;199;52
50 First Dates;2004;Rotten;45;65;79;97;176;41
50 to 1;2014;Rotten;29;70;2;5;7;2
51 Birch Street;2006;Fresh;97;87;35;1;36;17
52 Tuesdays;2015;Fresh;89;65;34;4;38;11
54;1998;Rotten;17;43;12;57;69;15
55 Steps;2018;Rotten;50;85;4;4;8;4
56 Up;2013;Certified-Fresh;99;76;68;1;69;27
5 Broken Cameras;2012;Certified-Fresh;96;88;46;2;48;20
5 Children and It;2004;Fresh;63;42;5;3;8;2
5 Days Of War;2011;Rotten;34;36;12;23;35;13
5 Flights Up;2015;Rotten;46;43;29;34;63;20
5 to 7;2015;Fresh;70;71;39;17;56;22
5B;2019;Fresh;100;97;19;0;19;7
600 Miles;1900;Fresh;94;40;29;2;31;3
61*;2001;Fresh;85;90;23;4;27;11
68 Kill;2017;Fresh;70;54;16;7;23;7
6 Balloons;1900;Fresh;86;56;25;4;29;7
6 Below: Miracle On The Mountain;2017;Rotten;22;54;4;14;18;6
6 Month Rule;2012;Rotten;22;38;2;7;9;5
6 Souls;2013;Rotten;4;45;1;27;28;11
6 Underground;2019;Rotten;36;60;33;59;92;16
6 Ways To Die;2015;Rotten;40;25;2;3;5;2
6 Years;2015;Fresh;69;35;9;4;13;3
6ixtynin9;2000;Fresh;94;80;16;1;17;4
'71;2015;Certified-Fresh;96;81;132;6;138;42
71 Fragmente einer Chronologie des Zufalls (71 Fragments of a Chronology of Chance);1994;Fresh;60;74;3;2;5;2
78/52: Hitchcock's Shower Scene;2017;Certified-Fresh;88;80;74;10;84;19
7 Boxes;2014;Fresh;97;82;30;1;31;13
7 Chinese Brothers;2015;Fresh;77;44;28;8;35;16
7 Days in Entebbe;2018;Rotten;24;37;28;88;116;30
7 Guardians of the Tomb;2018;Rotten;7;23;1;14;15;1
8 1/2;1963;Certified-Fresh;98;92;49;1;50;17
8: The Mormon Proposition;2010;Fresh;64;72;23;13;36;18
808;1900;Fresh;100;60;6;0;6;1
84 Charing Cross Road;1987;Fresh;87;81;13;2;15;3
88 Minutes;2008;Rotten;5;44;6;117;123;34
8 Heads in a Duffel Bag;1997;Rotten;11;34;2;17;19;4
8 Mile;2002;Certified-Fresh;75;54;160;53;213;52
8 Seconds;1994;Rotten;31;94;4;9;13;3
8MM;1999;Rotten;21;52;18;66;84;23
90 Minutes In Heaven;2015;Rotten;26;50;6;17;23;7
09-nov;2017;Rotten;11;43;1;8;9;5
95 Miles to Go;2004;Rotten;36;60;8;14;22;7
9500 Liberty;2010;Fresh;92;82;11;1;12;6
96 Souls;2017;Rotten;0;95;0;6;6;3
976-EVIL;1989;Rotten;15;28;2;11;13;0
$9.99;2008;Certified-Fresh;73;55;40;15;55;24
99 Homes;2015;Certified-Fresh;93;78;144;11;155;42
9 1/2 Weeks;1986;Fresh;61;56;14;9;23;1
9 Dead Gay Guys;2002;Rotten;22;61;5;18;23;10
9 Full Moons;2014;Fresh;83;71;5;1;6;1
9 to 5;1980;Fresh;82;74;32;7;39;6
The Rum Diary;2011;Rotten;52;36;87;81;168;46
A Bittersweet Life (Dalkomhan insaeng);2005;Fresh;100;90;11;0;11;0
A Crude Awakening: The Oil Crash;2007;Fresh;79;84;11;3;14;6
A Film with Me in It;2008;Fresh;62;60;8;5;13;2
Jackie Chan's Project A2 ('A' gai wak juk jap) (Project A, Part II);1987;Fresh;71;66;5;2;7;0
A Galaxy Far, Far Away;2001;Rotten;57;24;4;3;7;0
A Good Old Fashioned Orgy;2011;Rotten;35;41;23;42;65;26
A Little Help;2011;Rotten;41;30;18;26;44;21
A Mother's Courage: Talking Back To Autism (Solskinsdrengurinn);2010;Fresh;60;77;6;4;10;3
A Necessary Death;1900;Fresh;83;73;10;2;12;0
A Rumor of Angels;2000;Rotten;34;76;10;19;29;9
A Small Act;2010;Fresh;88;77;15;2;17;8
A Troll in Central Park;1994;Rotten;14;46;1;6;7;0
A Wedding for Bella;2003;Rotten;53;75;27;24;51;20
A Wink and a Smile;2008;Rotten;40;45;6;9;15;7
A Bad Moms Christmas;2017;Rotten;32;44;41;88;129;31
A Bag of Hammers;2012;Fresh;62;66;13;8;21;9
A Band Called Death;2013;Certified-Fresh;94;85;49;3;52;20
A Beginner's Guide To Endings;1900;Rotten;33;48;2;4;6;2
A Better Life;2011;Certified-Fresh;85;79;91;16;107;41
A Bigger Splash;2016;Certified-Fresh;90;58;162;19;181;45
A Bird of the Air;2011;Rotten;30;58;3;7;10;5
A Birder's Guide To Everything;2014;Fresh;86;68;19;3;22;11
A Bottle in the Gaza Sea;2013;Fresh;69;73;9;4;13;7
A Boy Called Po;2017;Rotten;31;80;4;9;13;3
A Boy Called Sailboat;1900;Fresh;80;77;12;3;15;0
A Bread Factory, Part One: For the Sake of Gold;2018;Fresh;100;62;30;0;30;9
A Bread Factory, Part Two: Walk with Me a While;2018;Fresh;100;56;22;0;22;9
A Breath Away (Dans la brume);2019;Rotten;45;44;5;6;11;3
A Brighter Summer Day;2011;Fresh;100;94;20;0;20;8
A Brilliant Young Mind;2015;Certified-Fresh;87;77;66;10;76;24
A Brony Tale;2014;Fresh;80;71;8;2;10;0
A Brother's Kiss;1996;Fresh;100;66;5;0;5;3
A Burning Hot Summer;2012;Rotten;55;22;6;5;11;8
A Canterbury Tale;1949;Fresh;92;81;12;1;13;4
A Case of You;2013;Rotten;47;26;9;10;19;6
A Cat in Paris;2012;Certified-Fresh;83;72;53;11;64;25
A Christmas Prince;2017;Fresh;73;47;8;3;11;1
A Christmas Prince: The Royal Baby;1900;Rotten;33;31;3;6;9;1
A Christmas Prince: The Royal Wedding;2018;Rotten;50;32;8;8;16;1
A Ciambra;2018;Certified-Fresh;89;76;50;6;56;19
A Clear Shot;1900;Rotten;0;;0;7;7;0
A Coffee in Berlin;2014;Certified-Fresh;77;74;40;12;52;21
A Conspiracy of Faith (Flaskepost fra P);2016;Fresh;100;65;6;0;6;4
A Cop (Un Flic);2013;Fresh;81;69;17;4;21;6
A Country Called Home;2016;Rotten;17;48;2;10;12;5
A Crooked Somebody;2018;Fresh;80;64;8;2;10;5
A Cure For Wellness;2017;Rotten;42;41;88;120;208;44
A Dangerous Method;2011;Certified-Fresh;78;50;148;41;189;51
A Dark Song;2017;Fresh;92;60;36;3;39;5
The Truth (A Dark Truth);2013;Rotten;8;36;1;12;13;7
A Date with Judy;1948;Rotten;57;51;4;3;7;3
Adrift;2009;Fresh;71;62;10;4;14;4
A Distant Trumpet;1900;Rotten;50;44;4;4;8;3
A Dog's Journey;2019;Rotten;50;91;42;42;84;17
A Dog's Purpose;2017;Rotten;35;73;51;96;147;36
A Dog's Way Home;2019;Rotten;59;71;47;32;79;15
A Fantastic Fear of Everything;2014;Rotten;34;35;11;21;32;9
A Fantastic Woman (Una mujer fantastica);2018;Certified-Fresh;94;78;207;14;221;45
A Farewell to Fools;2014;Rotten;40;23;2;3;5;1
A Few Best Men;1900;Rotten;15;36;6;33;39;6
A Field in England;2014;Certified-Fresh;86;58;62;10;72;20
A Fierce Green Fire;2013;Fresh;70;62;14;6;20;6
A Five Star Life;2014;Fresh;64;48;21;12;33;14
A Fond Kiss;2004;Fresh;89;76;24;3;27;5
A Fortunate Man (Lykke-Per);1900;Fresh;83;75;5;1;6;1
A Four Letter Word;2008;Rotten;53;40;9;8;17;9
A Futile and Stupid Gesture;1900;Fresh;67;71;29;14;43;13
A Ghost Story;2017;Certified-Fresh;91;66;249;25;274;49
A Girl And A Gun;2013;Rotten;25;44;2;6;8;4
A Girl Walks Home Alone at Night;2014;Certified-Fresh;96;75;128;5;133;31
A Glimpse Inside the Mind of Charles Swan III;2013;Rotten;16;26;9;47;56;23
A Good Day To Die Hard;2013;Rotten;14;40;33;196;229;49
A Good Woman Is Hard to Find;2020;Certified-Fresh;92;70;46;4;50;5
A Gray State;2017;Fresh;100;59;18;0;18;8
A Great Wall;1986;Rotten;56;60;5;4;9;4
A Guide to Recognizing Your Saints;2006;Certified-Fresh;76;73;71;23;94;34
A Guy Thing;2003;Rotten;24;35;24;78;102;29
A Hard Day;2015;Fresh;83;77;29;6;35;10
A Haunted House;2013;Rotten;9;51;5;48;53;13
A Haunted House 2;2014;Rotten;8;43;3;37;40;16
A Hijacking;2013;Certified-Fresh;96;76;107;5;112;35
A Hologram for the King;2016;Fresh;71;55;105;43;148;41
A Horrible Way to Die;2011;Fresh;60;35;6;4;10;3
A Jihad for Love;2008;Fresh;78;70;25;7;32;16
A Kid Like Jake;2018;Rotten;49;44;24;25;49;20
A Kind of Murder;2016;Rotten;35;14;6;11;17;3
A La Mala;2015;Rotten;43;75;3;4;7;0
A Late Quartet;2012;Certified-Fresh;76;71;86;27;113;43
A League of Ordinary Gentlemen;2005;Fresh;91;77;31;3;34;15
A Letter to Momo;2014;Fresh;81;76;25;6;31;16
A Liar's Autobiography - The Untrue Story of Monty Python's Graham Chapman;2012;Rotten;44;46;22;28;50;22
A Little Bit Of Heaven;2012;Rotten;4;52;2;53;55;22
A Little Chaos;2015;Rotten;48;49;44;48;92;27
A Little Trip to Heaven;2007;Rotten;33;42;2;4;6;1
A Lonely Place to Die;2011;Fresh;75;50;24;8;32;7
A Long Way Down;2014;Rotten;22;40;12;42;54;20
A Long Way From Home;2013;Rotten;33;33;3;6;9;4
A Man and a Woman;1966;Fresh;75;87;12;4;16;5
A Man Called Ove (En man som heter Ove);2016;Certified-Fresh;91;87;107;11;118;25
A Man Escaped (Un condamne a mort s'est echappe ou Le vent souffle ou il veut);1957;Fresh;100;93;36;0;36;8
A Man Named Pearl;2008;Fresh;75;89;24;8;32;13
A Man's Story;2012;Rotten;33;41;6;12;18;9
A Marine Story;2010;Fresh;60;61;3;2;5;4
A Master Builder;2014;Fresh;82;57;27;6;33;14
A Merry Friggin' Christmas;2014;Rotten;14;20;3;18;21;11
A Midsummer Night's Dream;2015;Fresh;100;67;6;0;6;3
A Million Little Pieces;2019;Rotten;27;48;13;35;48;17
A Million Ways to Die in the West;2014;Rotten;33;41;68;139;207;49
A Monster Calls;2017;Certified-Fresh;86;81;225;37;262;50
A Monster in Paris;1900;Fresh;87;65;20;3;23;4
A Month Of Sundays;1900;Fresh;63;60;12;7;19;5
A Most Violent Year;2015;Certified-Fresh;89;69;201;24;224;54
A Most Wanted Man;2014;Certified-Fresh;87;65;167;26;193;54
A Murder In The Park;2015;Fresh;76;67;13;4;17;6
The Notebook;2014;Fresh;67;67;24;12;36;17
A Nice Girl Like You;1900;Rotten;11;51;1;8;9;4
A Night In Old Mexico;2014;Rotten;43;33;9;12;21;9
A Nightmare on Elm Street 2: Freddy's Revenge;1985;Rotten;41;33;12;17;29;3
A Nightmare on Elm Street 3: Dream Warriors;1987;Fresh;72;68;26;10;36;5
A Nightmare on Elm Street 4: The Dream Master;1988;Rotten;53;43;16;14;30;6
A Nightmare on Elm Street 5: The Dream Child;1989;Rotten;31;32;10;22;32;5
A Novel Romance;2011;Rotten;0;24;0;6;6;5
A Patch of Blue;1965;Fresh;89;91;8;1;9;0
A Patient Man;1900;Rotten;50;;3;3;6;0
A Perfect Day;2016;Fresh;72;56;41;16;57;18
A Perfect Getaway;2009;Fresh;62;52;85;52;137;43
A Perfect Man;2013;Rotten;20;23;1;4;5;1
A Place at the Table;2013;Certified-Fresh;90;73;55;6;61;23
A Plumm Summer;2008;Rotten;20;49;2;8;10;3
A Poem Is A Naked Person;2015;Fresh;87;55;34;5;39;15
A Prayer Before Dawn;2018;Certified-Fresh;92;75;57;5;62;21
A Prayer for the Dying;1987;Rotten;55;53;6;5;11;1
A Private Function;1985;Fresh;88;63;7;1;8;1
A Private War;2018;Certified-Fresh;88;64;124;17;141;34
A Promise;2014;Rotten;13;24;3;21;24;8
A Question of Faith;2017;Rotten;40;77;2;3;5;3
A Quiet Passion;2017;Certified-Fresh;91;48;161;15;176;38
A Quiet Place;2018;Certified-Fresh;96;83;357;16;373;49
A Reindeer's Journey;2019;Fresh;83;;5;1;6;1
A Room With a View;1985;Fresh;100;85;32;0;32;5
A Royal Night Out;2015;Certified-Fresh;74;56;54;19;73;20
A Score to Settle;2019;Rotten;15;21;3;17;20;5
A Screaming Man;2011;Certified-Fresh;88;60;36;5;41;16
A Secret Love;1900;Certified-Fresh;100;94;42;0;42;13
A Separation;2011;Certified-Fresh;99;92;175;1;176;51
A Serious Man;2009;Certified-Fresh;90;68;200;23;223;55
A Shaun the Sheep Movie: Farmageddon;2020;Certified-Fresh;96;80;71;3;74;14
A Short History Of Decay;2014;Fresh;67;59;8;4;12;7
A Simple Favor;2018;Certified-Fresh;84;73;208;39;247;38
A Simple Life;2012;Fresh;94;86;29;2;31;11
A Simple Wedding;2020;Fresh;80;73;12;3;15;1
A Single Girl;2000;Fresh;75;64;12;4;16;5
A Single Shot;2013;Rotten;49;31;24;25;49;18
A Sinner in Mecca;2015;Fresh;86;36;12;2;14;7
A Skin So Soft (Ta peau si lisse);2018;Fresh;94;50;16;1;17;5
A Slipping-Down Life;1999;Rotten;26;45;17;48;65;26
A Smile Like Yours;1997;Rotten;6;19;2;33;35;12
A Song for Martin;2002;Fresh;85;84;23;4;27;13
A Space Program;2016;Fresh;87;80;13;2;15;8
A Star Is Born;2018;Certified-Fresh;90;79;466;52;517;62
A Street Cat Named Bob;2016;Certified-Fresh;77;76;50;15;65;15
A Suitable Girl;1900;Fresh;88;80;14;2;16;2
A Summer In Genoa;2009;Certified-Fresh;77;41;34;10;44;13
A Sun;1900;Fresh;89;90;8;1;9;2
A Tale of Love and Darkness;2016;Fresh;71;50;47;19;66;25
A Tale of Two Sisters;2003;Certified-Fresh;85;83;51;9;60;21
A Teacher;2013;Rotten;34;23;11;21;32;15
The A-Team;2010;Rotten;48;66;104;111;215;45
A Thousand Kisses Deep;1900;Rotten;8;33;1;12;13;4
A Thousand Words;2012;Rotten;0;47;0;58;58;21
A Thousand Years of Good Prayers;2008;Fresh;79;54;30;8;38;16
A Thread of Deceit: The Hart Family Tragedy;2020;Fresh;83;;5;1;6;0
A Touch of Sin;2013;Certified-Fresh;94;74;79;5;84;28
A Town Called Panic (Panique au village);2009;Certified-Fresh;81;86;61;14;75;23
A Tuba to Cuba;2019;Fresh;100;82;11;0;11;3
A Turtle's Tale: Sammy's Adventures;1900;Rotten;44;47;8;10;18;5
A United Kingdom;2017;Certified-Fresh;84;76;137;26;163;40
A Very British Gangster;2008;Fresh;71;64;17;7;24;13
A Very Long Engagement;2004;Certified-Fresh;78;85;116;32;148;36
A Very Sordid Wedding;2017;Fresh;86;95;6;1;7;4
A Vigilante;2019;Fresh;92;49;34;3;37;9
A Violent Man;2019;Rotten;44;72;4;5;9;1
A Violent Separation;2019;Rotten;8;84;1;11;12;2
A Wake In Providence (Almost Married);2005;Fresh;70;25;7;3;10;3
A Walk Among the Tombstones;2014;Fresh;68;53;109;52;161;40
A Walk In The Woods;2015;Rotten;47;48;77;88;165;42
A Walk Into the Sea: Danny Williams and the Warhol Factory;2007;Fresh;79;59;19;5;24;15
A War (Krigen);2016;Certified-Fresh;91;79;85;8;93;31
A Warrior's Heart;2011;Rotten;17;54;2;10;12;8
A Whale of a Tale;2018;Fresh;88;;15;2;17;6
A Whisper To A Roar;2012;Fresh;100;82;5;0;5;3
A White, White Day (Hvitur, hvitur dagur);2020;Certified-Fresh;96;62;64;3;67;11
A Will For The Woods;2014;Fresh;77;81;10;3;13;4
A Wizard's Tale (Here Comes the Grump);2018;Rotten;20;75;1;4;5;1
A Wolf at the Door (O Lobo atras da Porta);2015;Fresh;84;84;21;4;25;9
A Woman, A Gun and a Noodle Shop (San qiang pai an jing qi) (A Simple Noodle Story) (The First Gun);2010;Rotten;34;40;20;39;59;22
A Woman Is a Woman (Une femme est une femme);1964;Fresh;82;86;28;6;34;11
A Woman of Paris: A Drama of Fate;1923;Fresh;92;74;12;1;13;6
A Wrinkle in Time;2018;Rotten;42;26;141;193;334;54
Aarakshan;2011;Rotten;57;50;4;3;7;3
Aardvark;2018;Rotten;12;33;3;23;26;10
Ab-normal Beauty;2004;Fresh;67;58;4;2;6;0
Abandon;2002;Rotten;16;31;18;95;113;29
The Abandoned;2007;Rotten;38;42;13;21;34;6
Abattoir;2016;Rotten;38;29;8;13;21;5
Abbott and Costello Meet Frankenstein;1948;Fresh;89;85;24;3;27;2
Abbott and Costello Meet Dr. Jekyll and Mr. Hyde;1953;Fresh;63;63;5;3;8;0
Abbott and Costello Meet the Mummy;1955;Rotten;25;49;3;9;12;1
ABCs of Death 2;2014;Fresh;73;39;24;9;33;5
Abduction;2011;Rotten;5;42;5;103;108;26
Abe;2020;Fresh;70;70;23;10;33;11
Abe & Phil's Last Poker Game;2018;Fresh;73;92;8;3;11;3
Abe Lincoln in Illinois;1940;Fresh;83;71;5;1;6;0
Abel;2013;Fresh;93;77;14;1;15;5
Aberdeen;2001;Fresh;87;80;34;5;39;13
Abominable;2019;Certified-Fresh;81;95;133;31;164;24
About a Boy;2002;Certified-Fresh;93;55;174;13;187;46
About Adam;2000;Fresh;68;47;39;18;57;18
About Alex;2014;Rotten;45;43;18;22;40;17
About Cherry;2012;Rotten;14;16;3;18;21;10
About Elly;2015;Certified-Fresh;99;84;69;1;70;30
About Last Night;1986;Fresh;61;59;17;11;28;9
About Last Night;2014;Fresh;69;65;68;30;98;33
About Schmidt;2002;Certified-Fresh;85;74;173;30;203;43
About Scout;2016;Fresh;60;41;3;2;5;2
About Time;2013;Fresh;68;81;108;50;158;43
Above the Law;1988;Rotten;53;48;9;8;17;2
Above the Rim;1994;Rotten;53;83;10;9;19;8
Above the Shadows;2019;Rotten;57;76;4;3;7;3
Abraham Lincoln: Vampire Hunter;2012;Rotten;34;50;64;127;191;43
Absence;2013;Rotten;22;29;2;7;9;4
Absence Of Malice;1981;Fresh;81;63;21;5;26;7
Absentia;1900;Fresh;87;49;13;2;15;1
The Absent-Minded Professor;1961;Fresh;83;62;19;4;23;2
Absolute Power;1997;Rotten;57;52;32;24;56;18
Absolute Wilson;2006;Fresh;76;74;22;7;29;14
Absolutely Anything;2017;Rotten;18;31;8;36;44;8
Absolutely Fabulous: The Movie;2016;Rotten;58;41;89;63;151;41
Absurdistan;2008;Fresh;83;74;19;4;23;8
Abuse of Weakness;2014;Fresh;85;54;29;5;34;12
Accattone (The Procurer) (The Scrounger);1961;Fresh;100;89;15;0;15;4
Acceleration;1900;Rotten;0;20;0;6;6;2
Accepted;2006;Rotten;37;72;43;72;115;31
Accident Man;1900;Fresh;83;63;5;1;6;0
The Accidental Husband;2009;Rotten;6;36;1;16;17;6
Accidental Love;2015;Rotten;9;15;3;32;35;14
The Accidental Spy (Te wu mi cheng);2001;Rotten;29;36;2;5;7;0
The Accidental Tourist;1988;Fresh;81;60;26;6;32;2
Accidents Happen;2010;Fresh;60;43;6;4;10;2
According To Greta;2010;Fresh;60;56;3;2;5;0
Ace the Case: Manhattan Mystery;2016;Rotten;20;49;1;4;5;2
Ace Ventura: Pet Detective;1993;Rotten;49;57;30;31;61;12
Ace Ventura - When Nature Calls;1995;Rotten;30;72;8;19;27;3
Aces: Iron Eagle III;1992;Rotten;14;25;1;6;7;1
A.C.O.D.;2013;Rotten;52;28;30;28;58;24
Acolytes;2011;Fresh;75;42;6;2;8;1
Across 110th Street;1972;Fresh;81;79;13;3;16;4
Across the Universe;2007;Rotten;53;82;94;85;179;45
Act of God;2009;Fresh;65;20;11;6;17;8
Act of Valor;2012;Rotten;27;72;39;103;142;38
Action Jackson;1988;Rotten;13;32;2;13;15;2
Action Point;2018;Rotten;15;26;7;41;48;16
Action Replayy;2010;Rotten;0;27;0;5;5;0
Active Measures;2018;Fresh;81;85;13;3;16;8
Acts of Vengeance;1900;Rotten;55;24;6;5;11;3
Acts of Violence;2018;Rotten;0;30;0;13;13;7
Acts of Worship;2003;Fresh;63;74;12;7;19;5
Ad Astra;2019;Certified-Fresh;83;40;313;62;375;51
Adam;2019;Fresh;74;8;17;6;23;6
Adam Resurrected;2008;Rotten;35;44;13;24;37;9
Adam Sandler: 100% Fresh;1900;Certified-Fresh;90;91;18;2;20;8
Adam Sandler's Eight Crazy Nights;2002;Rotten;12;49;13;96;109;35
Adam's Apples;2007;Fresh;70;90;26;11;37;10
The Addams Family;1991;Fresh;64;66;30;17;47;8
Addams Family Values;1993;Certified-Fresh;77;63;40;12;52;15
Addicted;2014;Rotten;7;51;1;13;14;8
Addicted To Fame;2012;Rotten;27;57;3;8;11;7
Addicted to Love;1997;Rotten;55;50;18;15;33;6
Addiction Incorporated;2011;Fresh;72;64;18;7;25;13
Adieu au langage (Goodbye to Language);2014;Certified-Fresh;88;47;69;9;78;31
The Adjustment Bureau;2011;Fresh;71;67;186;75;261;55
Admiral (Michiel de Ruyter);2016;Fresh;67;81;4;2;6;1
Admission;2013;Rotten;38;32;61;97;157;46
Adopt a Highway;2019;Fresh;69;73;22;10;32;9
Adoration;2008;Fresh;63;48;65;38;103;36
Adore;2013;Rotten;33;41;25;50;75;30
Adrift;2018;Fresh;69;66;136;61;197;37
Adrift in Manhattan;2007;Rotten;44;33;4;5;9;6
Adult Beginners;2015;Rotten;48;30;38;41;79;29
Adult World;2014;Rotten;54;38;20;16;35;17
Advanced Style;2014;Fresh;89;75;33;4;37;14
Adventureland;2009;Certified-Fresh;88;61;192;25;217;52
Adventures in Babysitting;1987;Fresh;72;70;21;8;29;3
Adventures in Babysitting;1900;Fresh;86;64;6;1;7;4
Adventures in Public School (Public Schooled);2018;Fresh;71;62;5;2;7;3
Adventures of a Teenage Dragonslayer;1900;;;16;2;2;;2
The Adventures of Baron Munchausen;1900;Certified-Fresh;92;82;48;4;52;14
The Adventures of Elmo in Grouchland;1999;Certified-Fresh;77;63;34;10;44;14
The Adventures of Huck Finn;1993;Fresh;73;50;11;4;15;4
The Adventures of Ichabod and Mr. Toad;1949;Fresh;94;71;15;1;16;4
The Adventures of Pluto Nash;2002;Rotten;4;19;4;86;90;22
Adventures of Power;2009;Rotten;32;49;6;13;19;9
The Adventures of Priscilla, Queen of the Desert;1994;Certified-Fresh;96;88;43;2;45;15
The Adventures of Rocky & Bullwinkle;2000;Rotten;43;20;43;58;101;29
Adventures of Sebastian Cole;1900;Rotten;43;70;10;13;23;6
Advise and Consent;1962;Fresh;75;89;9;3;12;3
Aelita - Queen of Mars;1929;Fresh;100;58;6;0;6;1
Aeon Flux;2005;Rotten;9;39;10;97;107;23
The Affair of the Necklace;2001;Rotten;15;42;9;53;62;22
An Affair to Remember;1957;Fresh;65;87;20;11;31;2
Afflicted;2014;Fresh;83;57;25;5;30;8
Affliction;1997;Certified-Fresh;88;71;44;6;50;9
Affluenza;2014;Rotten;20;22;3;12;15;9
Afghan Cycles;1900;Fresh;100;;6;0;6;0
Afghan Star;2009;Certified-Fresh;100;77;62;0;62;24
Africa Screams;1949;Fresh;60;37;3;2;5;0
African Cats;2011;Fresh;73;77;57;21;78;23
After;2014;Rotten;8;65;1;11;12;5
After;2019;Rotten;19;69;7;30;37;7
After Class (Safe Spaces);2019;Fresh;83;46;10;2;12;3
After Dark, My Sweet;;Fresh;82;61;14;3;17;6
After Earth;2013;Rotten;11;36;23;187;210;47
After Everything (Shotgun);2018;Fresh;83;75;15;3;18;6
After Fall, Winter;2012;Rotten;11;69;1;8;9;5
After Image;2001;Rotten;0;16;0;5;5;0
After Innocence;2005;Certified-Fresh;92;82;44;4;48;18
After.Life;2010;Rotten;25;33;14;42;56;23
After Louie;2018;Fresh;75;67;9;3;12;4
After Love (L'economie du couple);2017;Certified-Fresh;90;73;45;5;50;16
After Lucia;1900;Fresh;86;76;6;1;7;2
After Midnight (Something Else);2020;Fresh;88;49;28;4;32;5
After Stonewall;1999;Fresh;100;77;5;0;5;0
After the Ball;2015;Rotten;27;43;4;11;15;4
After the Dark;2014;Fresh;71;44;10;4;14;4
After The Fall;2014;Rotten;33;15;5;10;15;7
After the Storm (Umi yori mo mada fukaku);2017;Certified-Fresh;96;80;133;5;137;31
After the Sunset;2004;Rotten;18;52;25;115;140;37
After the Thin Man;1936;Fresh;100;90;20;0;20;4
Efter brylluppet (After the Wedding);2006;Certified-Fresh;88;87;92;13;105;36
After the Wedding;2019;Rotten;45;76;69;85;154;33
After Tiller;2013;Certified-Fresh;92;85;57;5;62;19
After We Leave;2020;Fresh;83;38;5;1;6;1
After Words;2015;Rotten;38;55;3;5;8;5
Afterglow;1997;Fresh;76;43;25;8;33;10
Aftermath (Poklosie);2013;Fresh;83;79;29;6;35;16
Aftermath;2014;Rotten;47;17;8;9;17;8
Aftermath;2017;Rotten;42;25;23;32;55;11
Afternoon Delight;2013;Fresh;66;41;54;28;82;28
Afternoon of a Faun: Tanaquil Le Clercq;2014;Fresh;90;72;27;3;30;17
Afterschool;2008;Certified-Fresh;80;48;35;9;44;18
Aftershock;2013;Rotten;38;24;21;34;55;19
Aftershocks (Tangshan dadizhen);2010;Fresh;91;88;10;1;11;4
Afterward;2020;Fresh;88;;7;1;8;4
Against All Odds;1984;Fresh;70;45;7;3;10;1
Against the Ropes;2004;Rotten;12;29;16;119;135;37
Against The Sun;2015;Fresh;70;50;7;3;10;3
Quality of Life (Against The Wall);2006;Fresh;67;86;10;5;15;7
Age of Consent;1969;Fresh;100;52;7;0;7;3
Age of Heroes;1900;Rotten;40;23;2;3;5;0
The Age of Innocence;1993;Certified-Fresh;84;75;47;9;56;13
Age Of Kill;1900;Rotten;0;32;0;6;6;3
Age of Summer;2018;Rotten;50;68;3;3;6;1
Age of the Dragons;2011;Rotten;9;8;1;10;11;3
Agent Cody Banks;2003;Rotten;38;32;40;64;104;26
Agent Cody Banks 2: Destination London;2004;Rotten;14;31;13;82;95;27
Agent Vinod;2012;Rotten;38;25;5;8;13;2
Agnes Browne;1999;Rotten;41;71;11;16;27;7
Agnes of God;1985;Rotten;43;55;13;17;30;11
The Agony and the Ecstasy;1965;Fresh;86;78;6;1;7;0
Agora;2010;Rotten;53;65;49;43;92;32
Aguirre, the Wrath of God (Aguirre, der Zorn Gottes);1972;Certified-Fresh;96;91;47;2;49;10
A.I. Artificial Intelligence;2001;Certified-Fresh;74;64;143;51;194;46
Ai Weiwei: Never Sorry;2012;Certified-Fresh;98;87;80;2;82;34
Ai Weiwei: The Fake Case;2014;Fresh;93;69;25;2;27;13
Aida's Secrets;2017;Fresh;100;79;15;0;15;5
Aileen: Life and Death of a Serial Killer;2004;Certified-Fresh;86;74;51;8;59;22
Aileen Wuornos - The Selling of a Serial Killer;1993;Fresh;100;66;7;0;7;1
Ain't In It For My Health: A Film About Levon Helm;2013;Fresh;87;76;13;2;15;11
Ain't Them Bodies Saints;2013;Certified-Fresh;77;61;102;30;132;42
Air Bud 2 - Golden Receiver;1998;Rotten;21;38;6;23;29;9
Air;2015;Rotten;17;24;2;10;12;6
Air America;;Rotten;13;35;2;13;15;2
Air Bud;1997;Rotten;45;38;10;12;22;4
Air Force;1943;Fresh;80;70;8;2;10;2
Air Force One;1997;Certified-Fresh;78;66;45;13;58;19
Air Guitar Nation;2006;Certified-Fresh;85;79;56;10;66;25
Air Strike;2018;Rotten;0;12;0;5;5;1
Airplane!;1980;Certified-Fresh;97;89;65;2;67;12
Airplane 2 - The Sequel;1982;Rotten;42;50;8;11;19;2
Airport;1970;Fresh;73;53;11;4;15;1
Airport 1975;1974;Rotten;25;37;4;12;16;1
Airport '77;1977;Rotten;33;33;3;6;9;1
Ajami;2010;Certified-Fresh;97;81;66;2;68;27
AKA Jane Roe;1900;Fresh;88;70;14;2;16;6
a/k/a Tommy Chong;2006;Fresh;74;80;17;6;23;9
Akeelah and the Bee;2006;Certified-Fresh;85;81;120;21;141;35
Akira;2020;Certified-Fresh;90;90;45;5;49;12
I Saw the Devil;2011;Certified-Fresh;81;87;69;16;85;18
Akron;1900;Fresh;67;73;4;2;6;0
Aladdin;2019;Rotten;57;94;210;161;370;47
Aladdin and the King of Thieves;1995;Rotten;33;50;4;8;12;0
Alamar (To the Sea);2010;Certified-Fresh;91;84;43;4;47;14
The Alamo;2004;Rotten;29;45;46;113;159;38
Alan Partridge;2014;Certified-Fresh;86;73;93;15;108;34
Albatross;2012;Rotten;52;39;13;12;25;9
Albert Nobbs;2012;Rotten;56;47;88;70;158;46
Albino Alligator;1996;Rotten;50;42;10;10;20;8
Aleksandr Nevskiy (Alexander Nevsky);1938;Fresh;95;84;19;1;20;4
Alex & Emma;2003;Rotten;11;41;15;125;140;39
Alex Cross;2012;Rotten;11;47;14;112;126;35
Alex of Venice;2015;Fresh;74;43;23;8;31;9
Alex Rider: Operation Stormbreaker;2006;Rotten;35;53;24;45;69;26
Alex Strangelove;1900;Fresh;80;70;20;5;25;11
Alexander;2004;Rotten;16;35;33;172;205;45
Alexander and the Terrible, Horrible, No Good, Very Bad Day;2014;Fresh;61;58;71;45;116;36
Alexander the Last;2009;Fresh;67;27;8;4;12;3
Alexander's Ragtime Band;1938;Fresh;80;46;4;1;5;1
Alexandra's Project;2003;Rotten;53;55;10;9;19;6
Alfie;2004;Rotten;48;51;75;80;155;44
Algorithms;2014;Fresh;77;57;10;3;13;7
Ali;2001;Fresh;68;65;105;50;155;37
Ali G Indahouse;2004;Rotten;53;54;9;8;17;2
Ali Wong: Baby Cobra;1900;Fresh;100;79;9;0;9;3
Ali Wong: Hard Knock Wife;1900;Certified-Fresh;100;69;20;0;20;7
Alice;2008;Rotten;22;80;2;7;9;7
Alice Adams;1935;Fresh;94;71;16;1;17;4
Alice Doesn't Live Here Anymore;1900;Fresh;88;82;29;4;33;5
Alice Through the Looking Glass;2016;Rotten;29;48;74;180;254;46
Alice Neel;2007;Fresh;75;93;12;4;16;9
Alice, Sweet Alice (Communion);1976;Fresh;83;61;10;2;12;0
Alien;1979;Certified-Fresh;98;94;122;3;125;29
Alien Autopsy;2006;Fresh;75;50;6;2;8;0
Alien3;1992;Rotten;43;47;24;32;56;10
Alien Abduction;2014;Rotten;28;22;5;13;18;6
Alien: Covenant;2017;Fresh;65;55;263;139;402;58
Alien Nation;1988;Rotten;53;44;16;14;30;2
Alien Outpost;2015;Rotten;20;32;3;12;15;5
Alien Raiders;1900;Fresh;100;34;6;0;6;0
Alien Resurrection;1997;Rotten;54;39;44;37;81;19
Alien Trespass;2009;Rotten;36;31;24;43;67;22
AVP - Alien Vs. Predator;2004;Rotten;21;39;31;118;149;29
Aliens in the Attic;2009;Rotten;33;43;25;50;75;21
Aliens of the Deep;2005;Certified-Fresh;84;49;52;10;62;23
Alila;2004;Rotten;41;44;7;10;17;6
Ali's Wedding;1900;Fresh;92;78;23;2;25;4
Alita: Battle Angel;2019;Fresh;61;92;198;126;324;42
Alive Inside;2014;Certified-Fresh;75;91;33;11;44;18
Aliyah;2013;Fresh;83;54;5;1;6;5
All In: The Poker Movie;2012;Rotten;45;41;5;6;11;7
All About Lily Chou-Chou;2002;Fresh;69;89;27;12;39;14
All About My Mother (Todo sobre mi madre);1999;Certified-Fresh;98;93;88;2;90;24
All About Steve;2009;Rotten;6;30;9;131;140;43
All About the Benjamins;2002;Rotten;30;77;23;53;76;23
All Cheerleaders Die;2014;Rotten;49;34;20;21;41;12
All Day and a Night;1900;Rotten;57;63;20;15;35;11
All Dogs Go To Heaven;1989;Rotten;44;63;8;10;18;6
All Dogs Go To Heaven 2;1996;Rotten;20;38;1;4;5;1
All Eyez on Me;2017;Rotten;18;53;16;75;91;22
All Fall Down;1962;Rotten;40;50;2;3;5;0
All Good Things;2010;Rotten;35;37;34;64;98;30
All I Can Say;2020;Fresh;80;100;12;3;15;4
All I See Is You;2017;Rotten;29;31;16;40;56;19
Strike!;1998;Fresh;67;73;8;4;12;3
All I Want (Try Seventeen);2002;Rotten;0;36;0;7;7;0
All I Wish (A Little Something for Your Birthday);2018;Rotten;18;45;4;18;22;6
All Is Bright;2013;Rotten;49;22;20;21;41;14
All Is Lost;2013;Certified-Fresh;94;63;222;14;236;56
All Is True;2019;Fresh;72;67;99;39;138;31
All Is Well (Alles ist gut);1900;Fresh;100;69;12;0;12;4
All Mistakes Buried;2016;Fresh;67;63;6;3;9;5
All Nighter;2017;Rotten;14;35;2;12;14;2
All Over the Guy;2001;Rotten;43;67;20;27;47;17
All Relative;2014;Rotten;10;90;1;9;10;6
All Roads Lead Home;2008;Rotten;14;54;1;6;7;2
All Roads Lead to Rome;2008;Rotten;0;16;0;7;7;2
All Saints;2017;Fresh;95;72;18;1;19;5
All Square;2018;Fresh;91;79;10;1;11;4
All Stars;1900;Rotten;43;63;10;13;23;7
All Summers End;2018;Rotten;20;41;1;4;5;2
All That Heaven Allows;1955;Fresh;90;81;27;3;30;4
All the Bright Places;1900;Fresh;66;61;25;13;38;7
All the Devil's Men;2018;Rotten;23;19;3;10;13;2
All The King's Men;2006;Rotten;11;40;18;139;157;50
All the Little Animals;1999;Fresh;65;77;15;8;23;8
All the Money in the World;2017;Certified-Fresh;79;65;200;52;252;49
All the President's Men;1976;Certified-Fresh;94;92;59;4;63;9
All the Pretty Horses;2000;Rotten;32;42;32;68;100;33
All the Queen's Men;2001;Rotten;7;51;2;27;29;12
All the Real Girls;2003;Fresh;71;77;82;33;115;31
All the Right Moves;1983;Fresh;61;39;14;9;23;5
All the Way;2016;Certified-Fresh;87;83;40;6;46;25
All These Small Moments;2019;Fresh;82;64;14;3;17;4
All Things Must Pass: The Rise and Fall of Tower Records;2015;Fresh;94;81;33;2;35;15
All Things To All Men;1900;Rotten;24;10;4;13;17;4
All This, and Heaven Too;1940;Fresh;83;85;5;1;6;3
All Through the Night;1941;Fresh;100;70;10;0;10;4
All We Had;2016;Rotten;40;47;10;15;25;10
Allan Quatermain and the Lost City of Gold;1986;Rotten;40;20;2;3;5;0
Alle Anderen (Everyone Else);2010;Certified-Fresh;88;62;36;5;41;15
Allied;2016;Fresh;60;63;153;100;253;52
All's Faire in Love;2011;Rotten;7;42;1;14;15;7
Allure;2018;Rotten;47;43;14;16;30;8
Almayer's Folly;2012;Fresh;86;43;12;2;14;4
Almost an Angel;1900;Rotten;25;48;2;6;8;1
Almost Christmas;2016;Rotten;49;64;34;35;69;25
Almost Famous;2000;Certified-Fresh;89;92;150;19;169;36
Almost Friends;2017;Rotten;29;47;2;5;7;1
Almost Heroes;1998;Rotten;8;64;3;37;40;13
Almost Human;2014;Rotten;45;22;10;12;22;4
Almost Love;2020;Fresh;67;71;20;10;30;7
Almost Perfect;2012;Fresh;67;;4;2;6;3
Aloft;2015;Rotten;17;25;11;54;65;21
Aloha;2015;Rotten;20;28;33;132;165;44
Alone (Solo);1900;Fresh;75;50;6;2;8;2
Alone;2020;Certified-Fresh;94;57;46;3;49;6
Alone in Berlin;2017;Rotten;57;50;31;23;54;20
Alone in the Dark;2005;Rotten;1;11;1;122;123;28
Alone with Her;2007;Fresh;69;46;20;9;29;12
Along Came a Spider;2001;Rotten;32;53;40;86;126;31
Along Came Polly;2004;Rotten;27;47;43;119;162;39
Along Came the Devil;2018;Rotten;38;41;3;5;8;2
Alpha;2018;Certified-Fresh;80;70;106;26;132;25
Alpha and Omega;2010;Rotten;18;41;10;47;57;20
Alpha Dog;2007;Rotten;54;67;78;66;144;46
The Alphabet Killer;2008;Rotten;13;23;1;7;8;3
Alphaville;1965;Certified-Fresh;91;81;42;4;46;12
Alps (Alpeis);2012;Certified-Fresh;74;50;35;12;47;22
Alright Now;2018;Fresh;67;33;4;2;6;2
Altered Carbon: Resleeved;1900;Fresh;60;47;3;2;5;0
Altered Minds (The Red Robin);2015;Rotten;50;56;4;4;8;4
Altered States;1980;Certified-Fresh;84;71;38;7;45;6
Altina;2014;Fresh;86;;6;1;7;4
Alvin and the Chipmunks: Chipwrecked;2011;Rotten;12;51;10;72;82;25
Alvin and the Chipmunks: The Road Chip;2015;Rotten;15;51;10;57;67;20
Always;1989;Fresh;67;60;16;8;24;3
Always Be My Maybe;2019;Certified-Fresh;89;80;84;10;94;17
Always Shine;2016;Certified-Fresh;92;52;45;4;49;11
Always Woodstock;2014;Rotten;7;12;1;13;14;6
Am I Black Enough for You?;1900;Rotten;56;;9;7;16;8
Amadeus;1984;Certified-Fresh;93;95;92;7;99;26
Amal;2008;Fresh;100;90;7;0;7;3
Amanda and Jack Go Glamping;2017;Rotten;40;73;2;3;5;3
Amanda Knox;1900;Certified-Fresh;82;71;40;9;49;21
Amandla! A Revolution in Four-Part Harmony;2003;Certified-Fresh;83;88;52;11;63;21
Amarcord;1974;Certified-Fresh;87;90;40;6;46;13
Amateur;2018;Fresh;60;67;3;2;5;0
Amateur Night;2016;Rotten;0;26;0;6;6;2
Amazing Grace;2019;Certified-Fresh;99;81;156;1;157;34
Amazing Grace and Chuck;1900;Rotten;38;70;3;5;8;3
Amazing Journey: The Story of The Who;2007;Fresh;80;92;4;1;5;2
The Amazing Panda Adventure;1995;Rotten;20;41;2;8;10;3
The Amazing Transparent Man;1960;Rotten;40;16;2;3;5;0
Amelia;2009;Rotten;20;31;33;132;165;48
Amelie;2001;Certified-Fresh;89;95;163;21;184;46
Amen;2003;Fresh;67;82;33;16;49;17
Amer;2010;Fresh;79;54;23;6;29;9
America America;1963;Fresh;67;85;6;3;9;2
America: Imagine the World Without Her;2014;Rotten;8;84;2;22;24;10
America the Beautiful;2008;Fresh;72;66;23;9;32;14
American Pastime;2007;Rotten;33;68;3;6;9;1
American Pie 5: The Naked Mile;2006;Rotten;0;61;0;5;5;0
American: The Bill Hicks Story;2011;Certified-Fresh;83;85;50;10;60;15
American Animal;2012;Rotten;59;53;10;7;17;9
American Animals;2018;Certified-Fresh;88;81;186;26;212;40
American Assassin;2017;Rotten;34;60;60;115;175;31
The American Astronaut;2001;Fresh;63;89;20;12;32;9
American Beauty;1999;Certified-Fresh;87;93;165;25;190;48
American Buffalo;1996;Fresh;74;46;20;7;27;7
American Circumcision;2018;Fresh;60;77;3;2;5;0
An American Crime;2007;Rotten;38;74;5;8;13;4
American Dreamer;2019;Rotten;53;77;8;7;15;4
American Dreamz;2006;Rotten;38;31;70;113;183;49
American Dresser;2018;Rotten;0;65;0;7;7;2
American Fable;2017;Fresh;75;40;12;4;16;7
American Factory;2019;Certified-Fresh;96;80;85;4;89;21
American Flyers;1985;;;;13;7;;4
American Folk;2018;Fresh;77;64;17;5;22;6
Der Amerikanische Freund (The American Friend);1977;Fresh;91;80;21;2;23;5
American Gangster;2007;Certified-Fresh;80;87;173;42;215;57
American Gigolo;1980;Fresh;68;51;17;8;25;5
American Graffiti;1973;Certified-Fresh;96;84;50;2;52;7
American Grindhouse;2010;Fresh;86;71;6;1;7;2
American Gun;2006;Rotten;39;43;12;19;31;12
American Hangman;2019;Rotten;44;60;4;5;9;3
American Hardcore;2006;Certified-Fresh;72;78;44;17;61;23
An American Haunting;2006;Rotten;14;36;10;61;71;19
American Heart;1992;Fresh;80;68;12;3;15;6
American Heist;2015;Rotten;13;18;2;14;16;6
American History X;1998;Certified-Fresh;83;96;71;15;86;23
American Honey;2016;Certified-Fresh;79;63;167;44;211;44
American Hustle;2013;Certified-Fresh;92;74;267;22;289;55
An American in Paris;1951;Certified-Fresh;96;79;65;3;68;14
American Jesus;2014;Fresh;63;33;5;3;8;4
American Made;2017;Certified-Fresh;86;78;229;38;267;51
American Mary;2013;Fresh;60;52;30;20;50;15
American Me;1992;Fresh;78;90;7;2;9;2
American Meat;2013;Fresh;60;80;6;4;10;5
American Movie;1999;Certified-Fresh;94;90;46;3;49;9
American Outlaws;2001;Rotten;14;68;14;89;103;32
American Pastoral;2016;Rotten;23;30;27;92;119;38
American Pie;1999;Fresh;61;61;79;50;129;29
American Pie 2;2001;Rotten;52;68;66;61;127;34
American Pie Presents: Band Camp;2005;Rotten;17;50;1;5;6;0
American Pop;1981;Fresh;61;80;11;7;18;0
The American President;1995;Certified-Fresh;91;77;51;5;56;19
American Promise;2013;Fresh;72;73;18;7;25;13
American Psycho;2000;Fresh;69;85;104;46;150;37
American Psycho II: All American Girl;2002;Rotten;11;18;1;8;9;1
American Radical: The Trials of Norman Finkelstein;2010;Fresh;100;87;11;0;11;5
American Relapse;1900;Fresh;100;84;8;0;8;3
American Renegades;2018;Rotten;11;41;2;16;18;6
American Reunion;2012;Rotten;45;63;83;101;184;40
An American Rhapsody;2001;Rotten;56;66;34;27;61;24
American Satan;2017;Fresh;75;79;6;2;8;0
American Sniper;2015;Certified-Fresh;72;84;212;82;294;55
American Son;1900;Rotten;48;50;12;13;25;7
American Splendor;2003;Certified-Fresh;94;86;174;12;186;47
American Street Kid;1900;Fresh;83;95;5;1;6;1
American Swing;2009;Rotten;50;49;12;12;24;9
An American Tail;1986;Fresh;71;71;20;8;28;7
An American Tail - Fievel Goes West;1991;Rotten;54;62;7;6;13;2
American Teacher;2011;Fresh;69;70;11;5;16;6
American Teen;2008;Fresh;70;59;107;46;153;48
American Ultra;2015;Rotten;43;45;76;100;175;43
American Violet;2009;Certified-Fresh;75;79;44;15;59;22
American Wedding;2003;Rotten;54;63;83;72;155;35
An American Werewolf in London;1981;Certified-Fresh;87;85;47;7;54;11
American Zombie;2007;Fresh;72;40;13;5;18;4
The Americanization of Emily;1964;Fresh;93;82;13;1;14;0
Americano;2012;Rotten;53;27;8;7;15;9
America's Heart and Soul;2004;Rotten;50;60;33;33;66;30
America's Sweethearts;2001;Rotten;32;40;47;99;146;41
Amira & Sam;2015;Fresh;77;69;23;7;30;10
Amistad;1997;Certified-Fresh;77;79;50;15;65;14
Amityville 1992: It's About Time;1992;Rotten;13;22;1;7;8;0
Amityville II: The Possession;1982;Rotten;11;35;2;17;19;2
The Amityville Horror;2005;Rotten;23;52;38;125;163;35
Amityville: The Awakening;2017;Rotten;30;32;6;14;20;1
Amityville: The Demon;1983;Rotten;5;18;1;19;20;3
Amnesiac;2015;Rotten;27;14;4;11;15;3
Among Giants;1999;Fresh;60;38;12;8;20;5
Among Wolves;2019;Fresh;100;92;12;0;12;1
Amores Perros;2001;Certified-Fresh;92;94;109;9;118;35
Amos & Andrew;1993;Rotten;17;31;4;20;24;9
Amour;2012;Certified-Fresh;93;82;207;16;223;59
Amour Fou;2015;Certified-Fresh;88;49;45;6;51;16
Amulet;2020;Fresh;69;41;50;22;72;10
Amy;2015;Certified-Fresh;95;87;208;11;219;48
Amy Schumer Growing;1900;Fresh;79;9;11;3;14;6
Amy Schumer: The Leather Special;1900;Rotten;50;5;4;4;8;4
An Evening with Kevin Smith;2001;Fresh;100;92;6;0;6;0
An Acceptable Loss;2019;Rotten;12;71;4;29;33;11
An Actor Prepares;2018;Rotten;33;78;3;6;9;3
An Affair of the Heart;2012;Fresh;78;78;7;2;9;5
An Alan Smithee Film: Burn, Hollywood, Burn;1998;Rotten;8;14;3;37;40;10
An American Carol;2008;Rotten;12;47;6;43;49;15
An Autumn Afternoon;1964;Fresh;95;91;21;1;22;9
An Education;2009;Certified-Fresh;94;80;183;12;195;46
An Encounter with Simone Weil;2012;Rotten;50;;3;3;6;2
An Evening with Beverly Luff Linn;2018;Rotten;52;48;26;24;50;12
An Inconvenient Sequel: Truth To Power;2017;Certified-Fresh;79;50;124;32;156;46
An Interview With God;2018;Fresh;60;65;3;2;5;0
An Invisible Sign;2011;Rotten;0;33;0;15;15;7
An Ordinary Man;2018;Rotten;41;35;9;13;22;6
An Oversimplification Of Her Beauty;2013;Fresh;82;59;31;7;38;16
Anaconda;1997;Rotten;38;24;20;32;52;12
Anacondas: The Hunt for the Blood Orchid;2004;Rotten;26;27;31;90;121;30
Analyze That;2002;Rotten;27;39;41;110;151;35
Analyze This;1999;Fresh;69;62;74;33;107;25
Anamorph;2008;Rotten;27;24;7;19;26;9
The Anarchist Cookbook;2002;Rotten;37;54;7;12;19;6
Cymbeline;2015;Rotten;31;14;9;20;29;12
Anatomie;2000;Rotten;58;47;7;5;12;0
Anatomy of a Murder;1959;Certified-Fresh;100;90;47;0;47;8
Anatomy 2 (Anatomie 2);2003;Rotten;29;42;2;5;7;2
Anchor and Hope;2018;Fresh;75;69;21;7;28;3
Anchorman - The Legend Of Ron Burgundy;2004;Fresh;67;86;135;68;203;39
Anchorman 2: The Legend Continues;2013;Certified-Fresh;74;52;150;52;202;49
Anchors Aweigh;1945;Fresh;62;79;8;5;13;4
And Everything Is Going Fine;2010;Fresh;91;71;30;3;33;12
...And God Spoke (The Making of '...And God Spoke');1994;Fresh;100;73;8;0;8;0
...And Justice for All;1979;Fresh;83;80;24;5;29;7
And Now A Word From Our Sponsor;2013;Rotten;10;25;1;9;10;8
Monty Python's And Now for Something Completely Different;1972;Fresh;88;87;22;3;25;6
And Now Ladies & Gentlemen;2003;Rotten;47;56;35;39;74;26
And So It Goes;2014;Rotten;18;40;16;73;89;33
And Soon the Darkness;2010;Rotten;14;16;1;6;7;0
And the Band Played On;1993;Fresh;100;88;11;0;11;3
And Then Came Love;2007;Rotten;17;32;2;10;12;4
And Then There Were None;1945;Fresh;100;77;13;0;13;0
And Then We Danced;2020;Certified-Fresh;93;95;75;6;81;16
And While We Were Here;2013;Rotten;43;37;9;12;21;11
The Anderson Tapes;1971;Fresh;70;54;14;6;20;6
Andre Gregory: Before and After Dinner;2013;;;;18;6;;16
Dice Rules;1991;Rotten;9;48;1;10;11;3
The Andromeda Strain;1971;Fresh;67;72;26;13;39;10
Andron (Andron - The Black Labyrinth);2016;Rotten;0;13;0;6;6;3
Andy Warhol's Frankenstein;1974;Fresh;86;56;12;2;14;1
Anesthesia;2016;Rotten;25;50;11;33;44;14
An Angel at My Table;;Fresh;94;90;16;1;17;3
Angel Has Fallen;2019;Rotten;39;93;71;112;183;27
Angel of Evil;2011;Rotten;52;49;13;12;25;12
Angel of Mine;2019;Fresh;73;88;16;6;22;8
Angel-A;2005;Rotten;45;74;40;48;88;35
Angela's Ashes;1999;Rotten;51;81;44;42;86;26
Angelfish;2019;Fresh;86;;12;2;14;3
Angels Crest;2011;Rotten;22;38;5;18;23;11
Angels in Stardust;2014;Rotten;22;39;2;7;9;4
Angels in the Dust;2007;Fresh;83;86;10;2;12;5
Angels Wear White;2018;Fresh;94;71;31;2;33;11
Angels with Dirty Faces;1938;Fresh;100;92;22;0;22;0
Angie;1994;Rotten;44;32;7;9;16;4
The Angry Red Planet;1959;Rotten;0;29;0;8;8;0
Anguish;2015;Fresh;62;25;8;5;13;4
Angus;1995;Fresh;67;68;12;6;18;9
Angus, Thongs and Perfect Snogging;2008;Fresh;72;71;18;7;25;8
ANIARA;2019;Fresh;69;59;34;15;49;8
Anima;2019;Certified-Fresh;100;83;22;0;22;5
Animal;2014;Rotten;43;33;3;4;7;0
Animal Factory;2000;Fresh;83;58;29;6;35;7
Animal Farm;1954;Fresh;69;66;9;4;13;1
Animal Kingdom;2010;Certified-Fresh;94;83;154;9;163;36
Animals;2015;Fresh;85;70;23;4;27;13
Animals United (Konferenz der Tiere);1900;Rotten;25;27;2;6;8;2
Animation Outlaws;1900;Fresh;100;;6;0;6;2
The Animatrix;2003;Fresh;89;78;16;2;18;1
Anna;2019;Rotten;33;81;23;46;69;12
Anna and the Apocalypse;2018;Certified-Fresh;77;61;93;28;121;23
Anna and the King of Siam;1946;Fresh;88;68;7;1;8;0
Anna Karenina;2012;Fresh;63;50;120;71;191;50
Annabelle;2014;Rotten;29;36;38;94;132;30
Annabelle Comes Home;2019;Fresh;64;70;130;73;203;29
Annabelle: Creation;2017;Fresh;71;67;132;55;187;30
Annapolis;2006;Rotten;10;60;11;103;114;34
Anne Frank Remembered;1995;Fresh;97;83;29;1;30;16
Anne of the Thousand Days;1969;Rotten;38;83;5;8;13;5
Annie;1982;Rotten;57;69;16;12;28;7
Annie;2014;Rotten;28;59;45;116;160;49
Annie Hall;1977;Certified-Fresh;98;92;80;2;82;18
Annihilation;2018;Certified-Fresh;88;66;274;39;313;49
The Anniversary Party;2001;Fresh;61;58;68;44;112;32
Anomalisa;2015;Certified-Fresh;92;71;247;22;268;52
Anon;2018;Rotten;37;35;18;31;49;9
Anonymous;2011;Rotten;45;53;79;96;175;54
Mark of the Witch (Another);2016;Rotten;38;39;3;5;8;0
Another 48 Hrs.;;Rotten;21;35;6;23;29;7
Another Country;1984;Fresh;80;74;4;1;5;0
Another Day in Paradise;1997;Rotten;58;62;29;21;50;14
Another Earth;2011;Fresh;66;66;88;46;134;40
Another Gay Movie;2006;Rotten;40;62;2;3;5;2
Another Gay Sequel: Gays Gone Wild!;2008;Rotten;22;34;5;18;23;9
Another Happy Day;2011;Rotten;46;44;16;19;35;18
Another Stakeout;1993;Rotten;16;28;4;21;25;4
Another Thin Man;1939;Fresh;82;85;14;3;17;3
Another WolfCop;2017;Fresh;69;65;11;5;16;4
Another Woman;1988;Fresh;64;75;16;9;25;7
Another Year;2010;Certified-Fresh;93;74;161;13;174;42
Another You;1991;Rotten;11;34;1;8;9;0
The Answer Man (Arlen Faber);2009;Rotten;30;42;14;32;46;22
Answers to Nothing;2011;Rotten;9;36;2;21;23;13
The Ant Bully;2006;Fresh;62;42;72;45;117;36
Ant-Man and the Wasp;2018;Certified-Fresh;87;75;373;54;426;54
Antarctica: A Year on Ice;2014;Fresh;87;81;26;4;30;10
Antarctica: Ice & Sky (La glace et le ciel);2017;Fresh;89;50;25;3;28;13
Antboy;2014;Rotten;43;36;3;4;7;2
Antebellum;2020;Rotten;28;56;45;116;161;27
Anthony Jeselnik: Fire in the Maternity Ward;1900;Fresh;80;;4;1;5;2
Anthony Jeselnik: Thoughts and Prayers;1900;Fresh;100;100;5;0;5;0
Anthropoid;2016;Fresh;66;71;70;36;106;32
Anti Matter;2017;Fresh;88;78;21;3;24;3
Antibirth;2016;Fresh;70;33;23;10;33;11
Antiquities;2019;Fresh;100;89;5;0;5;0
Antisocial;1900;Rotten;25;18;2;6;8;1
Antitrust;2001;Rotten;24;50;25;81;106;32
Antiviral;2013;Fresh;66;40;61;32;93;24
Ant-Man;2015;Certified-Fresh;83;86;272;57;328;57
Anton Chekhov's The Duel;2010;Fresh;81;66;30;7;37;17
Antonia (Antonia's Line);1995;Fresh;67;91;33;16;49;21
Antonio Gaudi;1986;Fresh;100;75;17;0;17;4
Antrum: The Deadliest Film Ever Made;1900;Fresh;79;46;11;3;14;1
Ants on a Shrimp;2016;Fresh;78;52;7;2;9;3
Antwone Fisher;2002;Certified-Fresh;79;86;119;32;151;36
Antz;1998;Certified-Fresh;92;52;86;7;93;26
Anvil! The Story of Anvil;2009;Certified-Fresh;98;91;136;3;139;46
Any Day;2015;Rotten;0;20;0;7;7;2
Any Day Now;2012;Certified-Fresh;79;76;52;14;66;24
Any Given Sunday;1999;Rotten;52;73;65;59;124;31
Any Number Can Play;1900;Rotten;14;58;1;6;7;3
Any Which Way You Can;1980;Rotten;20;45;2;8;10;1
Anya;1900;Fresh;93;88;13;1;14;0
Standard Time (Anything But Love);2002;Rotten;36;69;13;23;36;18
Anything Else;2003;Rotten;40;44;55;82;137;39
Anywhere but Here;2000;Fresh;64;55;57;32;89;26
Anzio (Lo sbarco di Anzio);1968;Fresh;67;43;4;2;6;1
Apache;1954;Fresh;78;45;7;2;9;0
Aparajito;1956;Fresh;95;93;18;1;19;7
Apocalypse Now;1979;Certified-Fresh;98;94;93;2;95;25
Apocalypse Now: Final Cut;2019;Fresh;100;90;21;0;21;3
Apocalypse Now Redux;2001;Certified-Fresh;93;91;77;6;83;23
Apocalypto;2006;Fresh;66;79;131;68;199;52
Apollo 11;2019;Certified-Fresh;99;90;180;2;182;35
Apollo 13;1995;Certified-Fresh;96;87;88;4;92;31
Apollo 18;2011;Rotten;23;23;17;57;74;13
The Apostle;1998;Certified-Fresh;90;78;44;5;49;11
Apostle;2018;Certified-Fresh;78;54;53;15;68;13
Appiness;1900;Rotten;40;;2;3;5;0
The Apple Dumpling Gang;1975;Rotten;56;60;5;4;9;3
Applesauce;1900;Fresh;63;61;5;3;8;3
The Apprenticeship of Duddy Kravitz;1974;Fresh;93;71;13;1;14;4
Approaching the Unknown;2016;Rotten;43;14;9;12;21;8
Appropriate Behavior;2015;Certified-Fresh;97;64;56;3;58;20
Apres vous (After You);2003;Rotten;58;66;38;28;66;23
April and the Extraordinary World (Avril et le monde truque);2016;Certified-Fresh;96;77;55;2;56;16
April's Shower;2004;Rotten;20;34;3;12;15;9
Apt Pupil;1998;Rotten;53;56;29;26;55;15
Aqua Teen Hunger Force Colon Movie Film for Theaters;2007;Rotten;48;68;40;44;84;31
Aquamarine;2006;Rotten;51;61;45;44;89;31
Aquaslash;2020;Rotten;29;27;2;5;7;0
Aquellos que me Aman Tomaran el Tren;1999;Rotten;59;72;10;7;17;3
Arabian Nights;1900;Fresh;82;78;9;2;11;1
Arachnophobia;;Fresh;92;54;35;3;38;9
Arbitrage;2012;Certified-Fresh;88;62;148;21;169;43
Arcadia;1900;Fresh;60;43;3;2;5;3
Archipelago;2014;Fresh;96;58;23;1;24;11
The Architect;2006;Rotten;11;27;4;34;38;17
Archive;2020;Fresh;71;70;17;7;24;4
Arctic;2019;Certified-Fresh;90;78;133;15;148;30
Arctic Tale;2007;Fresh;61;61;60;38;98;32
Are We Done Yet?;2007;Rotten;8;31;7;85;92;31
Are You Here;2014;Rotten;8;22;4;46;49;18
Argo;2012;Certified-Fresh;96;90;341;15;356;63
Aria;1988;Rotten;50;47;6;6;12;2
Aristide and the Endless Revolution;2005;Fresh;92;84;11;1;12;7
The Aristocats;1970;Fresh;64;70;21;12;33;6
The Aristocrats;2005;Certified-Fresh;79;61;119;31;150;44
Arizona;2018;Rotten;43;43;16;21;37;9
Arizona Dream;1993;Fresh;87;86;13;2;15;6
Arkansas;2020;Rotten;47;54;30;34;64;15
Arlington Road;1999;Fresh;63;74;57;34;91;22
Armadillo;2011;Certified-Fresh;91;81;48;5;53;18
Armageddon;1998;Rotten;38;73;46;76;122;36
Jackpot;2014;Rotten;59;55;22;15;37;10
Armed Response;2017;Rotten;0;18;0;12;12;6
Armored;2009;Rotten;40;31;22;33;55;18
Armstrong;2019;Fresh;75;77;15;5;20;5
Army of Crime (L'Armee du Crime);2010;Fresh;88;68;28;4;32;12
Army of Darkness;1993;Fresh;73;87;36;13;49;6
Army of One;2016;Rotten;25;25;3;9;12;2
Army of Shadows (L'Armee des ombres);1969;Certified-Fresh;97;94;73;2;75;26
Around the Bend;2004;Rotten;29;61;28;70;98;31
Around The Block;2014;Fresh;67;39;6;3;9;3
Around the Sun;1900;Fresh;93;80;14;1;15;1
Around the World in 80 Days;2004;Rotten;32;34;41;87;128;35
Aroused;2013;Rotten;31;34;4;9;13;5
ARQ;1900;Rotten;43;46;3;4;7;1
Arranged;2007;Fresh;64;89;9;5;14;4
Arrival;2016;Certified-Fresh;94;82;402;24;426;59
Arsenal;2017;Rotten;3;17;1;29;30;9
Arsenic and Old Lace;1944;Fresh;81;92;22;5;27;4
Art and Craft;2014;Certified-Fresh;91;74;42;4;46;15
Art Is...The Permanent Revolution;2012;Fresh;100;71;6;0;6;3
The Art of Being Straight;2008;Rotten;38;31;3;5;8;5
The Art Of The Steal;2010;Certified-Fresh;85;87;51;9;60;22
Art School Confidential;2006;Rotten;36;48;50;88;138;37
Arthur;2011;Rotten;27;44;51;141;192;48
Arthur 2: On the Rocks;1988;Rotten;13;31;3;20;23;7
Arthur Christmas;2011;Certified-Fresh;92;76;155;13;168;41
Arthur Miller: Writer;2018;Fresh;91;60;10;1;11;3
Arthur Newman;2013;Rotten;20;25;10;41;51;19
Article 99;1992;Rotten;43;54;6;8;14;3
Artik;2019;Fresh;100;26;6;0;6;0
Artists and Models;1955;Fresh;78;76;7;2;9;2
As Above, So Below;2014;Rotten;26;40;20;57;77;15
As Cool As I Am;2013;Rotten;14;25;1;6;7;5
As Good as It Gets;1997;Certified-Fresh;85;86;67;12;79;22
As I Lay Dying;2013;Rotten;38;36;11;18;29;11
As If I Am Not There;2010;Fresh;85;78;11;2;13;6
Ash Is Purest White;2019;Certified-Fresh;99;69;151;1;152;33
Ash Wednesday;1973;Rotten;9;17;1;10;11;4
Ashby;2015;Rotten;52;48;11;10;21;6
Asher;2018;Rotten;46;37;6;7;13;4
Popiol i diament (Ashes and Diamonds);1958;Fresh;95;88;21;1;22;8
Ashes in the Snow;2019;Rotten;50;84;7;7;14;6
Ashes of Time Redux;2008;Certified-Fresh;78;75;68;19;87;32
Ashik Kerib;1989;Fresh;100;78;7;0;7;4
Ask No Questions;1900;Fresh;100;86;7;0;7;0
Ask the Dust;2006;Rotten;35;41;36;67;103;38
Asoka;2001;Fresh;100;69;10;0;10;1
Aspen Extreme;1993;Rotten;22;67;2;7;9;1
The Asphalt Jungle;1950;Fresh;97;87;34;1;35;4
The Asphyx;1973;Fresh;67;44;4;2;6;1
Ass Backwards;2013;Rotten;27;17;6;16;22;11
The Assassination Bureau;1969;Fresh;75;73;6;2;8;3
Assassination Nation;2018;Fresh;74;54;99;35;134;20
Assassination of a High School President;2008;Rotten;50;46;5;5;10;3
The Assassination of Jesse James by the Coward Robert Ford;2007;Certified-Fresh;77;75;134;41;175;53
Assassination Tango;2003;Rotten;47;32;42;47;89;31
Assassins;1995;Rotten;16;45;8;42;50;8
Assassin's Bullet;2012;Rotten;7;12;1;14;15;10
Assassin's Creed;2016;Rotten;18;43;39;182;221;38
Assault of the Killer Bimbos;1900;Rotten;17;47;1;5;6;1
Assault on Precinct 13;2005;Rotten;59;48;98;67;165;39
Assault On Wall Street;2013;Rotten;25;42;2;6;8;3
Assaulted: CIVIL Rights Under Fire;2013;Fresh;60;93;3;2;5;4
Assisted Living;2005;Certified-Fresh;76;81;35;11;46;18
Astro Boy (AstroBoy);2009;Rotten;50;50;69;69;138;39
Astronaut;2019;Fresh;67;68;35;17;52;8
The Astronaut Farmer;2006;Rotten;58;49;80;58;138;35
The Astronaut's Wife;1999;Rotten;15;33;9;50;59;20
Asylum;2005;Rotten;36;42;32;58;90;26
At Any Price;2013;Rotten;51;31;53;51;104;34
At Close Range;1986;Fresh;87;79;20;3;23;4
At Eternity's Gate;2018;Certified-Fresh;79;64;143;39;182;35
At First Light;2018;Rotten;54;49;7;6;13;5
At Middleton;2014;Fresh;61;45;23;15;38;20
At The Devil's Door;2014;Rotten;43;21;10;13;23;6
At the Earth's Core;1976;Rotten;33;34;3;6;9;1
Atanarjuat: The Fast Runner (Atanarjuat);2002;Certified-Fresh;91;82;89;9;98;31
ATL;2006;Fresh;62;86;53;33;86;31
Atlantic City;1980;Fresh;100;77;33;0;33;7
Atlantics;2019;Certified-Fresh;96;71;146;6;152;28
Atlantis - The Lost Empire;2001;Rotten;49;53;70;73;143;36
Atlas Shrugged: Part I;2011;Rotten;12;69;6;46;52;18
Atlas Shrugged: Part II;2012;Rotten;4;60;1;22;23;11
Atlas Shrugged: Who Is John Galt?;2014;Rotten;0;40;0;10;10;6
ATM;2012;Rotten;12;23;3;23;26;8
Atomic Blonde;2017;Certified-Fresh;78;64;280;77;356;49
The Atomic Cafe;1982;Fresh;93;85;27;2;29;5
Atonement;2007;Certified-Fresh;83;80;181;36;217;54
Atrocious;2011;Rotten;56;29;10;8;18;3
Attack of the Killer Tomatoes!;1978;Rotten;27;42;3;8;11;0
Attack of the Lederhosen Zombies;2017;Rotten;55;38;6;5;11;2
Attack On Titan: Part 2 (Shingeki no kyojin endo obu za warudo);2015;Rotten;50;36;4;4;8;2
Attack the Block;2011;Certified-Fresh;90;75;161;18;179;39
Attenberg;2012;Certified-Fresh;78;53;35;10;45;19
Attraction;2001;Rotten;0;10;0;7;7;3
Attraction (Prityazhenie);1900;Rotten;36;52;4;7;11;4
Audience of One;2007;Fresh;82;78;9;2;11;5
Audition (Odishon);1999;Certified-Fresh;82;80;63;14;77;15
Audrey Rose;1977;Rotten;50;43;8;8;16;1
Audrie & Daisy;1900;Fresh;81;73;13;3;16;7
Auggie;2019;Fresh;80;73;12;3;15;3
August: Osage County;2013;Fresh;67;65;135;68;203;51
August Rush;2007;Rotten;37;82;46;77;123;33
Augustine;2013;Fresh;73;52;27;10;37;21
Auntie Mame;1958;Fresh;93;93;14;1;15;0
Aurora;2011;Fresh;77;57;23;7;30;14
Austenland;2013;Rotten;31;54;35;77;112;34
Austin Powers in Goldmember;2002;Rotten;53;44;100;87;187;39
Austin Powers: International Man of Mystery;1997;Fresh;71;77;45;18;63;17
Austin Powers: The Spy Who Shagged Me;1999;Rotten;52;71;47;43;90;20
Australia;2008;Rotten;55;65;122;100;222;58
Australia: Land Beyond Time;2002;Fresh;86;43;6;1;7;2
Lasseter's Bones;2016;Fresh;88;66;7;1;8;2
Author: The JT LeRoy Story;2016;Certified-Fresh;77;62;70;21;91;24
Authors Anonymous;2014;Rotten;7;15;1;13;14;7
Auto Focus;2002;Fresh;71;61;117;47;164;43
Automata;2014;Rotten;29;30;10;24;34;11
Autumn Blood;2014;Rotten;20;37;1;4;5;2
Autumn in New York;2000;Rotten;19;54;14;58;72;21
Autumn Lights;2016;Rotten;14;83;1;6;7;2
Hostsonaten (Autumn Sonata);1978;Fresh;84;92;21;4;25;4
Autumn Spring;2003;Fresh;97;84;37;1;38;15
Avanti!;1972;Fresh;81;76;17;4;21;4
Ava's Possessions;2016;Fresh;69;41;11;5;16;4
Avatar;2009;Certified-Fresh;82;82;259;58;317;63
Avenged;2015;Fresh;88;37;7;1;8;1
Avengement;2019;Fresh;84;65;16;3;19;3
Avengers: Age of Ultron;2015;Certified-Fresh;76;83;279;89;367;61
Avengers: Endgame;2019;Certified-Fresh;94;90;495;34;528;57
Avengers: Infinity War;2018;Certified-Fresh;85;91;400;72;472;57
The Aviator;2004;Certified-Fresh;86;79;193;31;224;50
Aliens vs. Predator: Requiem (AVP 2);2007;Rotten;12;30;9;68;77;14
Await Further Instructions;2018;Fresh;80;28;16;4;20;4
Awake;2007;Rotten;24;54;15;48;63;16
Awake;1900;Rotten;14;37;1;6;7;1
Awake: The Life Of Yogananda;2014;Fresh;64;70;7;4;11;9
Awakening the Zodiac;2017;Rotten;42;33;5;7;12;3
Away From Her;2007;Certified-Fresh;94;81;137;8;145;47
Away We Go;2009;Fresh;68;74;127;61;188;46
Awful Nice;2014;Rotten;22;38;2;7;9;3
The Awful Truth;1937;Fresh;93;87;27;2;29;4
An Awfully Big Adventure;1995;Rotten;36;56;5;9;14;4
AWOL;2017;Fresh;93;57;14;1;15;3
A.X.L.;2018;Rotten;27;60;6;16;22;6
Axolotl Overkill;1900;Fresh;64;14;7;4;11;3
Ayn Rand: A Sense of Life;1998;Rotten;50;67;6;6;12;4
Ayurveda: the Art of Being;2002;Rotten;57;79;8;6;14;5
Aziz Ansari: Buried Alive;2013;Fresh;100;50;6;0;6;5
Aziz Ansari: Live At Madison Square Garden;2015;;;;7;0;;3
Aziz Ansari: Right Now;1900;Certified-Fresh;84;74;26;5;31;14
Baadasssss!;2003;Certified-Fresh;91;84;99;10;109;33
Der Baader Meinhof Komplex (The Baader Meinhof Complex);2008;Certified-Fresh;85;80;85;15;100;35
Baaria;2009;Rotten;55;50;6;5;11;3
Babe: Pig in the City;1998;Fresh;65;41;42;23;65;14
Babel;2006;Fresh;69;77;138;62;200;50
Babes in Arms;1939;Fresh;83;70;5;1;6;0
Babette's Feast (Babettes Gastebud);1987;Fresh;97;91;31;1;32;5
Baby Boom;1987;Fresh;76;62;25;8;33;7
Baby Boy;2001;Fresh;71;87;65;27;92;33
Baby Doll;1956;Fresh;94;82;15;1;16;4
Baby Driver;2017;Certified-Fresh;92;86;355;29;384;52
Baby Face;1933;Fresh;100;81;14;0;14;3
Baby Geniuses;1999;Rotten;2;24;1;44;45;11
Baby It's You;1983;Fresh;94;71;16;1;17;4
Baby Mama;2008;Fresh;64;55;105;60;165;48
Baby: Secret of the Lost Legend;1985;Rotten;13;38;2;14;16;5
Baby, the Rain Must Fall;1965;Fresh;60;41;3;2;5;1
Babyfever;1994;Rotten;36;;4;7;11;4
Babylon;2019;Fresh;100;41;30;0;30;9
Babylon A.D.;2008;Rotten;6;26;6;98;104;23
Baby's Day Out;1994;Rotten;20;52;3;12;15;4
The Babysitters;2008;Rotten;33;30;9;18;27;14
The Baby-Sitters Club;1995;Fresh;67;47;10;5;15;7
Babysplitters;1900;Fresh;69;89;11;5;16;1
Babyteeth;2020;Certified-Fresh;94;84;122;8;130;28
Bachelorette;2012;Rotten;56;34;57;44;101;35
Bachna Ae Haseeno;2008;Fresh;63;56;5;3;8;2
Back to School;1986;Fresh;86;68;30;5;35;8
Black Girl (La noire de...);1966;Fresh;96;77;26;1;27;8
Back in the Day;2014;Rotten;11;47;1;8;9;5
Back Roads;2018;Rotten;55;99;16;13;29;10
Back to 1942;2012;Rotten;36;62;4;7;11;6
Back to Burgundy (Ce qui nous lie);2018;Fresh;73;64;33;12;45;13
Back to the Beach;1987;Fresh;71;63;10;4;14;1
Back to the Future;1985;Certified-Fresh;96;94;81;3;84;23
Back to the Future Part II;1989;Fresh;66;85;40;21;61;16
Back to the Future Part III;;Certified-Fresh;80;78;36;9;45;10
The Back-up Plan;2010;Rotten;18;46;26;121;147;41
Backcountry;2015;Certified-Fresh;92;53;46;4;50;12
Backdraft 2;1900;Rotten;40;16;2;3;5;1
Backgammon;2016;Rotten;0;60;0;6;6;4
Backstabbing for Beginners;2018;Rotten;38;49;9;15;24;8
Backtrace;2018;Rotten;11;23;1;8;9;1
Backtrack;1900;Rotten;30;22;12;28;40;10
Backwards;2012;Rotten;28;52;5;13;18;11
The Bad and the Beautiful;1953;Certified-Fresh;79;86;38;10;48;12
Bad Ass;2012;Rotten;20;39;1;4;5;1
Bad Blood: The Movie;2017;Fresh;100;79;5;0;5;1
Bad Boy Bubby;2005;Fresh;100;88;9;0;9;2
Bad Boys;1982;Fresh;89;81;17;2;19;4
Bad Boys for Life;2020;Certified-Fresh;77;96;197;60;257;38
Bad Boys II;2003;Rotten;23;78;42;142;184;48
Bad Company;2002;Rotten;10;35;14;122;136;34
Bad Day at Black Rock;1955;Fresh;97;88;30;1;31;6
Bad Day for the Cut;2017;Fresh;92;70;12;1;13;2
Bad Education;2004;Certified-Fresh;88;86;128;18;146;43
Bad Education;1900;Certified-Fresh;94;83;132;9;141;21
Bad Hurt;2016;Fresh;80;70;12;3;15;6
Bad Influence;;Fresh;67;51;12;6;18;3
Bad Johnson;2014;Rotten;28;21;5;13;18;8
Bad Kids Go to Hell;2012;Rotten;44;36;4;5;9;3
Bad Lieutenant;1992;Certified-Fresh;77;73;37;11;48;14
Bad Lieutenant: Port of Call New Orleans;2009;Certified-Fresh;85;57;128;22;150;43
Bad Milo!;2013;Fresh;62;41;21;14;34;9
Bad Moms;2016;Rotten;58;63;98;71;169;38
Bad Moon;1996;Rotten;33;45;3;6;9;1
Bad News Bears;2005;Rotten;48;46;79;84;163;45
The Bad News Bears Go To Japan;1978;Rotten;6;29;1;15;16;4
The Bad News Bears in Breaking Training;1977;Rotten;50;41;5;5;10;0
Bad Rap;1900;Fresh;70;77;7;3;10;2
Bad Reputation;2018;Fresh;79;84;30;8;38;9
Bad Samaritan;2018;Rotten;53;66;40;36;76;20
Bad Santa;2003;Certified-Fresh;79;75;173;47;220;50
Bad Santa 2;2016;Rotten;24;33;32;102;134;28
Bad Taste;1989;Fresh;68;75;15;7;22;2
Bad Teacher;2011;Rotten;44;36;84;105;189;47
Bad Therapy;1900;;;;1;11;;4
Bad Times at the El Royale;2018;Certified-Fresh;74;73;186;64;250;38
Bad Turn Worse;2014;Certified-Fresh;80;51;33;8;41;12
Bad Words;2014;Fresh;65;61;89;47;136;37
Badlands;1974;Certified-Fresh;98;90;57;1;58;10
Bag It;2011;Fresh;100;82;5;0;5;0
Bagdad Cafe;1988;Fresh;85;88;17;3;20;2
Baggage Claim;2013;Rotten;15;48;13;71;84;29
Baghead;2008;Certified-Fresh;78;49;76;21;97;32
Bai ri yan huo (Black Coal, Thin Ice);1900;Fresh;96;59;23;1;24;7
Bai she chuan shuo (The Sorcerer and the White Snake);2013;Rotten;27;49;4;11;15;4
Bait;2012;Rotten;47;27;16;18;34;8
Bakery in Brooklyn (My Bakery in Brooklyn);2017;Rotten;43;15;3;4;7;5
The Last Circus;2011;Fresh;77;64;27;8;35;11
Ball of Fire;1941;Fresh;100;90;27;0;27;6
Ballad of Bering Strait;2003;Fresh;67;;8;4;12;7
The Ballad of Cable Hogue;1970;Fresh;93;82;14;1;15;3
The Ballad of Jack and Rose;2005;Rotten;47;61;54;61;115;38
The Ballad of Little Jo;1993;Fresh;69;65;11;5;16;9
The Ballad of Ramblin' Jack;2000;Fresh;94;77;17;1;18;3
Ballet 422;2015;Certified-Fresh;87;62;39;6;45;18
Ballistic: Ecks vs. Sever;2002;Rotten;0;19;0;118;118;32
Ballplayer: Pelotero;2012;Fresh;86;88;24;4;28;16
Balls of Fury;2007;Rotten;21;33;28;104;132;33
Au Hasard Balthazar;1966;Certified-Fresh;100;86;42;0;42;12
Balto;1995;Rotten;54;70;13;11;24;11
Balzac and the Little Chinese Seamstress;2005;Certified-Fresh;77;83;48;14;62;26
Bambi;1942;Certified-Fresh;90;73;46;5;51;6
Bambi II;2006;Rotten;50;60;5;5;10;1
Banana Split;2020;Certified-Fresh;89;60;47;6;53;12
Bananas;1971;Fresh;82;74;27;6;33;7
Band Aid;2017;Certified-Fresh;87;73;62;9;71;20
Band of Angels;1957;Rotten;40;64;2;3;5;0
Band Of Robbers;2016;Fresh;78;61;21;6;27;9
Band of the Hand;1986;Rotten;11;60;1;8;9;2
The Band Wagon;1953;Fresh;100;82;18;0;18;2
B&B;2018;Fresh;90;36;9;1;10;3
Bandidas;2006;Rotten;53;43;8;7;15;2
Bandits;2001;Fresh;64;58;90;50;140;36
Bandolero;1968;Rotten;20;50;1;4;5;1
Bandslam;2009;Certified-Fresh;82;64;84;19;103;38
The Bang Bang Club;2011;Rotten;49;60;23;24;47;19
The Banger Sisters;2002;Rotten;48;42;68;75;143;37
Bangkok Dangerous;2008;Rotten;8;26;8;88;96;26
Bangkok Dangerous;1999;Rotten;51;61;19;18;37;15
Banksy Does New York;2014;Fresh;100;75;12;0;12;3
B.A.P.S.;1997;Rotten;16;67;5;27;32;11
Barabbas;1962;Fresh;89;66;8;1;9;1
Baraka;1993;Fresh;81;96;21;5;26;8
Baran;2002;Certified-Fresh;89;89;55;7;62;22
Barb Wire;1996;Rotten;27;14;10;27;37;13
Barbara;2012;Certified-Fresh;94;76;74;5;79;28
Barbara Rubin & the Exploding NY Underground;2019;Fresh;100;;15;0;15;5
Barbarella;1968;Fresh;72;56;33;13;46;6
The Barbarian Invasions (Les Invasions barbares);2003;Certified-Fresh;82;89;110;24;134;41
Barbarosa;1982;Fresh;100;72;5;0;5;0
Barbershop;2002;Certified-Fresh;83;62;104;22;126;36
Barbershop 2: Back in Business;2004;Fresh;68;48;86;40;126;37
Barbershop: The Next Cut;2016;Certified-Fresh;90;66;84;9;93;32
Barbie in The Nutcracker;2001;Rotten;20;58;1;4;5;0
Barefoot;2014;Rotten;17;45;4;19;23;12
The Barefoot Contessa;1954;Fresh;100;72;10;0;10;1
The Barefoot Executive;1971;Fresh;83;48;5;1;6;1
Barefoot in the Park;1967;Fresh;84;79;21;4;25;7
Barfi!;2012;Fresh;86;86;12;2;14;5
Barfly;1987;Fresh;77;82;17;5;22;3
Bark!;2002;Rotten;14;58;1;6;7;1
Barking Dogs Never Bite (Flandersui gae);2000;Fresh;87;77;13;2;15;5
Barking Water;2009;Fresh;60;65;3;2;5;3
The Barkleys of Broadway;1949;Rotten;55;71;6;5;11;2
Barney's Version;2011;Certified-Fresh;78;78;106;30;136;39
Barney's Great Adventure;1998;Rotten;32;44;8;17;25;13
Barnyard;2006;Rotten;21;52;21;77;98;31
The Barretts of Wimpole Street;1934;Fresh;78;69;7;2;9;3
Barry;2016;Certified-Fresh;80;52;37;9;46;21
Barry Lyndon;1975;Certified-Fresh;91;92;67;7;74;16
Barry Munday;2010;Rotten;47;36;7;8;15;2
Barrymore;2012;Fresh;70;67;16;7;23;16
Bart Got a Room;2009;Fresh;70;56;26;11;37;14
Bartleby;2002;Rotten;35;68;19;36;55;20
Barton Fink;1991;Certified-Fresh;90;89;54;6;60;13
BASEketball;1998;Rotten;42;74;22;30;52;14
Basic;2003;Rotten;21;63;30;113;143;37
Basic Instinct;1992;Rotten;53;63;34;30;64;17
Basic Instinct 2;2006;Rotten;6;26;10;145;155;42
Basil;1997;Rotten;0;47;0;5;5;0
The Basket;1999;Rotten;44;23;8;10;18;4
Basket Case;1982;Fresh;77;54;20;6;26;0
Baskin;2016;Certified-Fresh;79;46;34;9;43;12
Basmati Blues;2018;Rotten;10;49;3;26;29;8
Basquiat;1996;Fresh;68;77;19;9;28;7
Bat 21;1988;Fresh;81;58;13;3;16;6
The Bat Whispers;1930;Fresh;64;53;7;4;11;5
Bathtubs Over Broadway;2018;Fresh;100;91;35;0;35;11
Batkid Begins;2015;Certified-Fresh;82;83;49;11;60;20
Batman and Harley Quinn;2017;Rotten;45;38;5;6;11;0
Batman & Mr. Freeze: Subzero;1998;Fresh;92;67;12;1;13;0
Batman: Assault on Arkham;1900;Fresh;75;85;6;2;8;0
Batman: Bad Blood;1900;Fresh;100;64;5;0;5;0
Batman Begins;2005;Certified-Fresh;84;94;241;45;286;54
Batman Beyond: Return of the Joker;2000;Fresh;91;86;10;1;11;0
Batman Forever;1995;Rotten;39;32;27;42;69;18
Batman: Gotham by Gaslight;1900;Fresh;73;66;8;3;11;0
Batman Gotham Knight;2008;Fresh;86;69;6;1;7;0
Batman: Hush;1900;Fresh;88;70;15;2;17;0
Batman: Mask of the Phantasm;1993;Fresh;84;88;27;5;32;5
Batman Ninja;1900;Fresh;82;39;14;3;17;0
Batman: Return Of The Caped Crusaders;1900;Fresh;94;67;17;1;18;0
Batman Returns;1992;Certified-Fresh;80;73;67;17;84;20
The Batman Superman Movie: World's Finest;1900;Fresh;83;77;5;1;6;0
Batman: The Dark Knight Returns, Part 1;2012;Fresh;100;93;5;0;5;0
Batman: The Killing Joke;2016;Rotten;40;46;16;24;40;1
Batman: The Movie;1966;Fresh;78;62;25;7;32;2
Batman: Under the Red Hood;1900;Fresh;100;92;7;0;7;0
Batman v Superman: Dawn of Justice;2016;Rotten;28;62;120;303;423;63
Batman Vs. Robin;1900;Fresh;100;78;5;0;5;0
Batman vs Teenage Mutant Ninja Turtles;1900;Fresh;100;85;13;0;13;0
Batman vs. Two-Face;1900;Fresh;100;60;8;0;8;0
Batman: Year One;1900;Fresh;88;79;7;1;8;0
Bats;1999;Rotten;17;14;7;35;42;12
*batteries not included;1987;Fresh;63;64;10;6;16;3
Battle: Los Angeles;2011;Rotten;36;48;75;134;209;41
Battle of the Brave;1900;Rotten;17;35;1;5;6;3
Battle Beyond the Stars;1980;Rotten;45;42;5;6;11;0
Battle for Brooklyn;2011;Fresh;79;74;15;4;19;11
Battle for Haditha;2007;Fresh;68;72;21;10;31;15
Battle For Terra;2009;Rotten;49;41;47;48;95;27
Battle For The Planet Of The Apes;1973;Rotten;36;30;10;18;28;4
Battle in Seattle;2008;Rotten;56;65;35;27;62;24
Battle of Britain;1969;Fresh;67;79;6;3;9;1
The Battle of Shaker Heights;2003;Rotten;39;48;23;36;59;23
Battle of the Bulge;1965;Rotten;57;68;4;3;7;1
Battle of the Sexes;2017;Certified-Fresh;85;71;263;48;310;55
Battle of the Year;2013;Rotten;6;49;3;51;54;22
Battle Royale;2000;Certified-Fresh;88;89;42;6;48;10
Battle Royale II;1900;Rotten;30;29;3;7;10;1
Battlefield America;2012;Rotten;8;53;1;12;13;7
Battlefield Earth;2000;Rotten;3;12;4;148;152;41
Battleship;2012;Rotten;34;54;76;147;223;45
Battleship Potemkin;1925;Certified-Fresh;100;86;49;0;48;17
Battlestar Galactica;1978;Rotten;32;61;6;13;19;2
Battling Butler;1926;Fresh;80;75;8;2;10;1
Bayou Maharajah;1900;Fresh;86;84;6;1;7;3
Baywatch;2017;Rotten;17;55;41;201;241;53
BB King: The Life of Riley;2014;Fresh;86;85;6;1;7;3
Be Afraid;2017;Rotten;17;30;2;10;12;0
Be Cool;2005;Rotten;30;42;52;120;172;39
Be Here to Love Me: A Film About Townes Van Zandt;2005;Fresh;94;91;33;2;35;13
Be Kind Rewind;2008;Fresh;65;56;83;45;128;39
Be My Cat: A Film for Anne;1900;Fresh;83;50;5;1;6;1
Be Natural: The Untold Story of Alice Guy-Blache;2019;Certified-Fresh;95;97;82;4;86;19
Be With Me;2006;Fresh;90;81;9;1;10;8
The Beach;2000;Rotten;20;57;24;94;118;33
Beach Blanket Bingo;1965;Fresh;73;52;8;3;11;0
Beach Party;1963;Rotten;43;42;3;4;7;0
Beach Rats;2017;Certified-Fresh;86;57;89;15;104;36
Beaches;1988;Rotten;40;88;17;25;42;9
Bean;1997;Rotten;44;53;15;19;34;11
Beanpole (Dylda);2020;Certified-Fresh;91;82;84;8;92;21
Bearcity;2010;Rotten;50;54;5;5;10;4
The Beast From 20,000 Fathoms;1953;Fresh;95;68;19;1;20;2
Beast of Burden;2018;Rotten;25;9;2;6;8;1
Ching yan (The Beast Stalker);2008;Fresh;100;69;5;0;5;1
The Beast Within;1982;Rotten;9;33;1;10;11;1
Beastly;2011;Rotten;21;48;20;76;96;29
The Beastmaster;1982;Rotten;50;54;7;7;14;0
Beasts of the Southern Wild;2012;Certified-Fresh;87;76;177;27;204;53
Beat Street;1984;Rotten;57;84;4;3;7;0
De Battre mon Coeur s'est Arrete (The Beat That My Heart Skipped);2005;Certified-Fresh;86;84;84;14;98;32
A Hard Day's Night;1964;Certified-Fresh;98;89;106;2;108;38
Help!;1965;Fresh;88;86;23;3;26;3
Yellow Submarine;1968;Certified-Fresh;95;84;57;3;60;13
Beats;1900;Fresh;90;57;9;1;10;1
Beats Rhymes & Life: The Travels of a Tribe Called Quest;2011;Certified-Fresh;90;90;54;6;60;25
Beau Geste;1939;Fresh;100;85;11;0;11;0
The Beautician and the Beast;1997;Rotten;18;44;4;18;22;7
Beautiful Darling;2011;Fresh;77;75;10;3;13;9
Beautiful Boxer;2005;Fresh;83;88;29;6;35;13
Beautiful Boy;2011;Fresh;70;56;47;20;67;27
The Beautiful Country;2005;Certified-Fresh;78;79;59;17;76;24
Beautiful Creatures;2001;Rotten;38;32;23;37;60;21
Beautiful Creatures;2013;Rotten;47;54;86;97;183;48
Beautiful Girls;1996;Certified-Fresh;79;81;37;10;47;15
Beautiful Kate;2009;Fresh;84;64;26;5;31;5
Beautiful Losers;2008;Fresh;62;68;18;11;29;14
A Beautiful Mind;2001;Certified-Fresh;74;93;158;55;213;47
Beautiful People;2000;Fresh;80;86;20;5;25;7
Beautiful Something;2016;Rotten;57;48;4;3;7;3
Beautiful Thing;1996;Fresh;91;93;20;2;22;9
The Beautiful Truth;2008;Rotten;47;75;7;8;15;7
Beautifully Broken;2018;Fresh;67;92;4;2;6;1
Beauty and the Beast - The Enchanted Christmas;1997;Rotten;13;55;1;7;8;0
Beauty and the Beast;1991;Certified-Fresh;94;92;110;7;117;32
Beauty And The Beast (La belle et la bete);2016;Rotten;41;53;11;16;27;5
Beauty and the Beast;2017;Fresh;71;80;266;109;374;57
Beauty Is Embarrassing;2012;Fresh;91;89;29;3;32;12
Beavis and Butt-head Do America;1996;Fresh;72;69;38;15;53;15
Bebe's Kids;1992;Rotten;30;74;3;7;10;1
Because I Said So;2007;Rotten;4;65;6;152;158;47
Because of Winn-Dixie;2005;Rotten;55;63;67;55;122;32
Becket;1964;Fresh;76;87;19;6;25;9
Becks;2018;Fresh;95;88;19;1;20;6
Becky;1900;Fresh;71;57;82;33;115;16
Becoming;1900;Certified-Fresh;93;58;68;5;73;31
Becoming Astrid (Unga Astrid);2018;Fresh;96;82;27;1;28;9
Becoming Jane;2007;Rotten;58;74;80;59;139;44
Becoming Santa;2011;Fresh;80;76;4;1;5;0
Becoming Traviata;2013;Fresh;81;68;13;3;16;10
Bedazzled;1967;Fresh;82;74;14;3;17;2
The Bedford Incident;1965;Fresh;86;75;12;2;14;4
Bedknobs and Broomsticks;1971;Fresh;66;74;23;12;35;7
Bedlam;1946;Fresh;89;52;16;2;18;3
The Bedroom Window;1987;Fresh;72;49;13;5;18;0
Bedrooms and Hallways;1999;Fresh;69;66;9;4;13;1
Bedtime for Bonzo;1951;Fresh;67;38;8;4;12;2
Bedtime Stories;2008;Rotten;27;55;30;81;111;35
Bee Movie;2007;Rotten;50;53;87;87;174;53
Bee Season;2005;Rotten;43;35;47;62;109;35
Been Rich All My Life;2006;Fresh;80;100;24;6;30;14
Been So Long;2018;Fresh;92;70;11;1;12;5
Beer for My Horses;2008;Rotten;0;62;0;8;8;4
Beer League;2006;Rotten;27;58;4;11;15;8
Beer Wars;2009;Fresh;67;70;4;2;6;1
Beerfest;2006;Rotten;40;75;43;64;107;31
Beeswax;2009;Fresh;74;43;35;12;47;21
Beethoven's 2nd;1994;Rotten;23;30;3;10;13;2
Beethoven's 3rd;2000;Rotten;0;24;0;7;7;0
Beethoven's 4th;2001;Rotten;0;28;0;8;8;0
Beetle Queen Conquers Tokyo;2009;Fresh;91;58;31;3;34;17
Beetlejuice;1988;Certified-Fresh;85;82;50;9;59;17
Before I Disappear;2014;Rotten;37;67;11;19;30;11
Before I Fall;2017;Fresh;65;56;79;43;122;29
Before I Go to Sleep;2014;Rotten;37;40;44;75;119;35
Before Midnight;2013;Certified-Fresh;98;82;198;5;203;45
Before Night Falls;2001;Certified-Fresh;73;84;72;26;98;30
Before Stonewall;2019;Fresh;94;78;16;1;17;5
Before Sunrise;1995;Certified-Fresh;100;93;46;0;46;6
Before Sunset;2004;Certified-Fresh;95;91;167;9;176;48
Before the Devil Knows You're Dead;2007;Certified-Fresh;88;71;155;21;176;45
Before the Flood;2016;Fresh;75;77;24;8;32;9
Before We Go;2015;Rotten;27;56;8;22;30;12
Before You Know It;2014;Fresh;79;61;11;3;14;6
Begin Again;2014;Certified-Fresh;83;81;137;29;166;50
Beginners;2011;Certified-Fresh;85;77;136;24;160;47
The Beguiled;1971;Fresh;89;71;16;2;18;1
Behaving Badly;2014;Rotten;0;29;0;17;17;5
Behind Enemy Lines II: Axis of Evil;2006;Rotten;0;37;0;5;5;1
Behind The Burly Q;2010;Fresh;78;64;21;6;27;12
Behind the Candelabra;2013;Certified-Fresh;95;71;100;5;105;25
Behind the Mask: The Rise of Leslie Vernon;2006;Certified-Fresh;76;75;32;10;42;13
Behind You;2020;Rotten;6;30;1;15;16;2
Behold a Pale Horse;1964;Fresh;90;72;9;1;10;2
Beijing Taxi;2010;Fresh;80;;4;1;5;3
Being 17 (Quand on a 17 ans);2016;Certified-Fresh;95;75;39;2;41;15
Being at home with Claude;1993;Fresh;60;54;3;2;5;1
Being Elmo: A Puppeteer's Journey;2011;Certified-Fresh;95;87;74;4;78;26
Being Evel;2015;Fresh;97;83;38;1;39;13
Being Flynn;2012;Rotten;51;41;42;40;82;30
Being Frank;2019;Rotten;33;63;13;27;40;12
Being Human;1994;Rotten;54;42;7;6;13;2
Being John Malkovich;1999;Certified-Fresh;93;87;126;9;135;28
Being Julia;2004;Certified-Fresh;76;74;94;29;123;37
Being There;1979;Certified-Fresh;95;92;53;3;56;9
Beirut;2018;Certified-Fresh;82;56;107;24;131;34
Bel Ami;2012;Rotten;27;29;26;69;95;31
Bela Lugosi Meets a Brooklyn Gorilla;1952;Rotten;29;16;2;5;7;0
Believe in Me;2007;Fresh;60;74;6;4;10;1
Believe;2016;Rotten;33;68;2;4;6;1
Believe Me;2014;Rotten;40;61;8;12;20;2
Bella (Beauty);2006;Rotten;44;81;29;37;66;29
The Bellboy;1960;Fresh;70;68;7;3;10;0
Belle;2014;Certified-Fresh;84;82;128;24;152;47
Belle de Jour;1968;Certified-Fresh;95;86;54;3;57;14
Belle's Magical World;1998;Rotten;17;72;1;5;6;0
Bellflower;2011;Certified-Fresh;73;63;69;25;94;28
Bells Are Ringing;1960;Fresh;82;75;9;2;11;1
Belly;1998;Rotten;16;87;3;16;19;3
Beloved;2012;Rotten;56;45;25;20;45;21
Beloved Sisters;2015;Fresh;72;40;31;12;43;15
Below;2002;Fresh;64;44;45;25;70;23
Belzebuth;1900;Fresh;79;70;11;3;14;0
Ben;1972;Fresh;67;39;6;3;9;1
Ben-Hur;2016;Rotten;25;53;47;143;190;36
Ben is Back;2018;Certified-Fresh;81;70;176;40;215;44
The Benchwarmers;2006;Rotten;13;64;9;63;72;15
Bend It Like Beckham;2003;Certified-Fresh;85;73;132;23;155;36
Benda Bilili!;2011;Fresh;93;82;26;2;28;15
Beneath;2013;Rotten;33;14;5;10;15;5
Beneath Hill 60;2010;Fresh;86;77;12;2;14;4
Beneath The Darkness;2012;Rotten;4;15;1;23;24;10
Beneath The Harvest Sky;2014;Fresh;62;66;13;8;21;10
Beneath the Leaves;2019;Rotten;20;9;1;4;5;2
Beneath The Planet Of The Apes;1970;Rotten;38;38;12;20;32;4
Ben-Hur;1959;Certified-Fresh;86;89;43;7;50;11
Benjamin;2020;Fresh;89;74;34;4;38;4
Benji;1974;Fresh;86;55;6;1;7;0
Benji;2018;Fresh;60;70;6;4;10;5
Benji: Off the Leash!;2004;Rotten;33;52;14;29;43;16
Benji the Hunted;1987;Rotten;55;62;6;5;11;0
Benny & Joon;1993;Certified-Fresh;76;85;31;10;41;12
Benny's Video;1992;Fresh;64;75;7;4;11;3
Beowulf;2007;Certified-Fresh;71;50;140;57;197;51
Berberian Sound Studio;2013;Certified-Fresh;85;53;83;15;98;30
Bereavement;2011;Rotten;44;29;8;10;18;5
Berlin: Symphony of a Great City;1927;Fresh;86;82;6;1;7;2
Berlin, I Love You;2019;Rotten;11;29;2;16;18;10
Berlin Syndrome;2017;Certified-Fresh;75;53;66;22;88;17
Bernard and Huey;2018;Fresh;74;79;14;5;19;8
Bernie;2012;Certified-Fresh;88;73;144;19;163;44
Bert Rigby, You're a Fool;1989;Rotten;40;55;2;3;5;1
Beside Bowie: The Mick Ronson Story;2017;Fresh;80;60;4;1;5;1
Beside Still Waters;2014;Fresh;62;72;8;5;13;3
Bessie;1900;Certified-Fresh;90;68;26;3;29;20
Best Friends;1982;Fresh;62;28;8;5;13;5
Best in Show;2000;Certified-Fresh;94;89;107;7;114;31
Best Laid Plans;1999;Rotten;43;38;9;12;21;5
Best Laid Plans;1900;Rotten;50;38;3;3;6;4
The Best Little Whorehouse in Texas;1982;Rotten;50;68;5;5;10;1
Best Men;1998;Rotten;13;40;1;7;8;0
Best Night Ever;2014;Rotten;0;37;0;15;15;5
Best Of Enemies;2015;Certified-Fresh;93;85;112;8;120;38
The Best of Everything;1959;Fresh;67;59;4;2;6;0
Best Seller;1987;Fresh;73;55;11;4;15;1
Best Worst Movie;2010;Certified-Fresh;94;84;65;4;69;16
The Best Years of Our Lives;1946;Certified-Fresh;97;93;58;2;60;14
Bestiaire;2012;Fresh;86;44;18;3;21;9
Bethany;2017;Rotten;29;43;2;5;7;1
Bethlehem;2014;Certified-Fresh;79;72;38;10;48;23
Betsy's Wedding;;Rotten;50;40;5;5;10;4
Better Days;2019;Fresh;100;97;15;0;15;3
Better Living Through Chemistry;2014;Rotten;22;38;8;28;36;14
Better Luck Tomorrow;2002;Certified-Fresh;81;79;86;20;106;40
Better Start Running;2018;Rotten;33;37;2;4;6;1
Better than Chocolate;1999;Rotten;39;78;9;14;23;4
Better This World;2011;Fresh;100;78;10;0;10;5
A Better Tomorrow;2010;Fresh;93;90;13;1;14;0
Better Watch Out;2017;Certified-Fresh;89;65;57;7;64;15
Bettie Page Reveals All;2013;Fresh;74;61;29;10;39;16
Betting on Zero;2017;Fresh;100;79;16;0;16;6
372 le Matin (Betty Blue) (37.2 Degrees in the Morning);1986;Fresh;77;91;20;6;26;9
Betty: They Say I'm Different;1900;Fresh;83;;5;1;6;2
Between Love & Goodbye;2008;Rotten;33;45;2;4;6;4
Between Strangers;2002;Rotten;25;46;2;6;8;2
Between the Lines;1977;Fresh;93;57;14;1;15;1
Between Two Ferns: The Movie;1900;Certified-Fresh;74;43;43;15;58;13
Between Us;2013;Rotten;50;76;5;5;10;2
Between Us;2017;Rotten;50;34;4;4;8;4
Between Worlds;1900;Rotten;32;84;7;15;22;4
Beverly Hills Cop;1984;Certified-Fresh;82;82;42;9;51;8
Beverly Hills Cop II;1987;Rotten;47;57;15;17;32;3
Beverly Hills Cop III;1994;Rotten;9;35;5;48;53;17
Beverly Hills Ninja;1997;Rotten;14;53;4;24;28;8
Beware Of Mr. Baker;2012;Certified-Fresh;98;87;52;1;53;23
Beware the Gonzo;2011;Rotten;44;47;4;5;9;5
Bewitched;2005;Rotten;25;28;46;141;187;47
The Beyond (...E tu vivrai nel terrore! L'aldila);1981;Fresh;67;76;14;7;21;2
Beyond a Reasonable Doubt;1956;Fresh;72;56;13;5;18;5
Beyond Belief;2008;Fresh;83;89;10;2;12;6
Beyond Borders;2003;Rotten;14;72;14;89;103;34
Beyond Clueless;2014;Fresh;79;42;19;5;24;6
Beyond Hatred (Au-dela de la haine);2007;Fresh;89;55;17;2;19;9
Beyond Outrage;2014;Rotten;50;58;9;9;18;8
Beyond Rangoon;1995;Rotten;39;71;13;20;33;11
Beyond Re-Animator;2003;Rotten;50;39;6;6;12;1
Beyond Skyline;2017;Fresh;65;38;13;7;20;5
Beyond The Black Rainbow;2012;Rotten;58;52;19;14;33;9
Beyond the Edge;2014;Fresh;69;61;18;8;26;9
Beyond the Gates;2005;Certified-Fresh;84;85;54;10;64;27
Beyond the Gates;2016;Fresh;83;28;19;4;23;5
Beyond The Hills;2013;Certified-Fresh;91;81;96;10;106;38
Beyond the Lights;2014;Certified-Fresh;84;75;77;15;92;33
Beyond The Mask;2015;Rotten;29;70;4;10;14;2
Beyond the Mat;1999;Certified-Fresh;82;83;55;12;67;20
Beyond the Ocean;2000;Rotten;33;;3;6;9;4
Beyond the Poseidon Adventure;1979;Rotten;0;22;0;7;7;3
Beyond The Reach;2015;Rotten;37;20;25;43;68;22
Beyond the Sea;2004;Rotten;42;64;66;91;157;36
Beyond the Valley of the Dolls;1970;Fresh;75;72;21;7;28;4
Beyond the Visible - Hilma af Klint;2020;Fresh;96;;23;1;24;7
Beyond Therapy;1987;Rotten;20;32;2;8;10;3
Bhaag Milkha Bhaag;2013;Fresh;72;83;13;5;18;6
Bhool Bhulaiyaa;2007;Rotten;20;72;1;4;5;2
Bhoot (Ghost House);2003;Fresh;67;48;4;2;6;3
Bhoothnath;2008;Fresh;60;53;3;2;5;1
Bhutto;2010;Fresh;87;87;20;3;23;9
Bicentennial Man;1999;Rotten;36;58;35;62;97;25
Bickford Shmeckler's Cool Ideas;1900;Rotten;50;54;3;3;6;0
Bicycle Thieves (Ladri di biciclette) (The Bicycle Thief);1949;Certified-Fresh;98;94;62;1;63;17
Bidder 70;2013;Fresh;80;55;8;2;10;5
Big;1988;Certified-Fresh;97;82;72;2;74;16
Big Stan;2009;Rotten;11;44;1;8;9;2
Big Ass Spider!;2013;Fresh;78;44;21;6;27;8
Big Bad Love;2001;Rotten;41;70;24;34;58;20
Big Bad Mama;1974;Fresh;71;41;10;4;14;0
Big Bad Wolves;2014;Certified-Fresh;76;69;53;17;70;21
The Big Bounce;2004;Rotten;16;24;21;114;135;37
Big Boys Gone Bananas!*;2012;Fresh;78;80;18;5;23;13
The Big Brass Ring;1999;Rotten;57;17;4;3;7;1
Big Bully;1996;Rotten;0;19;0;8;8;3
The Big Bus;1976;Fresh;64;57;7;4;11;0
The Big Chill;1983;Fresh;68;77;26;12;38;8
The Big Clock;1948;Fresh;100;83;8;0;8;0
The Big Combo;1955;Fresh;92;81;12;1;13;4
The Big Country;1958;Fresh;100;90;12;0;12;0
Big Daddy;1999;Rotten;39;74;37;57;94;27
Big Driver;1900;Rotten;50;29;5;5;10;7
The Big Easy;1987;Fresh;89;61;33;4;37;13
Big Eden;2001;Fresh;65;79;34;18;52;20
Big Eyes;2014;Fresh;72;68;136;54;190;43
Big Fat Liar;2002;Rotten;44;44;41;53;94;23
Big Foot: The Lost Coast Tapes;2012;Rotten;57;29;4;3;7;4
Big Fur;1900;Fresh;100;;13;0;13;0
Big Game;2015;Certified-Fresh;78;34;69;20;89;24
The Big Gay Musical;2009;Fresh;100;67;7;0;7;1
The Big Green;1995;Rotten;0;46;0;5;5;1
Big Hero 6;2014;Certified-Fresh;89;91;201;24;225;49
The Big Hit;1998;Rotten;43;57;17;23;40;10
The Big House;1930;Fresh;75;69;6;2;8;0
Big Jake;1900;Fresh;83;85;5;1;6;2
Big Kill;2018;Rotten;22;60;2;7;9;3
Big Liar on Campus;2007;Rotten;6;45;1;17;18;9
Big Miracle;2012;Certified-Fresh;75;64;78;26;104;28
Big Momma's House;2000;Rotten;30;57;24;57;81;26
Big Mommas: Like Father, Like Son;2011;Rotten;5;58;3;58;61;15
Big Muddy;2015;Rotten;57;17;4;3;7;2
Big Night;1996;Certified-Fresh;96;84;54;2;56;13
Big Nothing;2007;Rotten;46;61;6;7;13;4
The Big One;1998;Fresh;92;67;36;3;39;8
The Big Picture;1989;Fresh;87;45;20;3;23;5
The Big Red One;1980;Certified-Fresh;90;78;44;5;49;16
The Big Shot-Caller;2009;Rotten;23;57;3;10;13;6
Big Shots;1900;Fresh;60;60;3;2;5;1
Big Sky;2015;Rotten;18;10;2;9;11;4
Big Star: Nothing Can Hurt Me;2013;Fresh;92;83;35;3;38;20
The Big Steal;1949;Fresh;80;64;4;1;5;0
Big Stone Gap;2015;Rotten;38;53;8;13;21;10
Big Sur;2013;Rotten;44;38;11;14;25;11
The Big Tease;2000;Rotten;56;55;22;17;39;15
Big Top Pee-wee;1988;Rotten;35;30;7;13;20;1
The Big Trail;1930;Fresh;100;70;8;0;8;1
Big Trouble;1986;Rotten;17;27;1;5;6;0
Big Trouble in Little China;1986;Fresh;78;82;35;10;45;2
Big Wednesday;1978;Fresh;67;87;8;4;12;1
The Bigamist;1953;Fresh;88;49;7;1;8;1
A Bigger Splash;1974;Fresh;100;42;9;0;9;4
Bigger, Stronger, Faster*;2008;Certified-Fresh;96;81;73;3;76;23
Bigger Than the Sky;2005;Rotten;12;53;2;15;17;9
Biggie and Tupac;2002;Certified-Fresh;79;73;38;10;48;16
Biker Boyz;2003;Rotten;23;54;21;72;93;29
Bikes vs Cars;2015;Fresh;60;56;9;6;15;5
Bikram: Yogi, Guru, Predator;1900;Certified-Fresh;96;73;22;1;23;12
Bill;2016;Fresh;89;60;17;2;19;4
Bill & Ted Face the Music;2020;Certified-Fresh;82;72;193;42;235;33
Bill & Ted's Bogus Journey;1991;Rotten;57;56;30;23;53;13
Bill and Ted's Excellent Adventure;1989;Certified-Fresh;81;75;42;10;52;6
Bill Burr: I'm Sorry You Feel That Way;2014;Fresh;100;94;5;0;5;2
Bill Burr: Paper Tiger;1900;Fresh;86;96;6;1;7;1
Bill Cunningham New York;2011;Certified-Fresh;99;92;73;1;74;26
Billion Dollar Brain;1967;Rotten;50;41;3;3;6;1
Billionaire Boys Club;2018;Rotten;7;36;1;14;15;6
Billionaire Ransom (Take Down);2016;Rotten;20;28;1;4;5;1
Billu;2009;Fresh;60;44;3;2;5;2
Billy Bathgate;1991;Rotten;38;28;9;15;24;7
Billy Elliot;2000;Certified-Fresh;85;89;100;18;118;38
Billy Jack;1971;Fresh;63;63;10;6;16;2
Billy Jack Goes to Washington;1977;Rotten;0;37;0;8;8;1
Billy Liar;1963;Fresh;94;84;16;1;17;1
Billy Lynn's Long Halftime Walk;2016;Rotten;44;41;69;89;158;47
Billy Madison;1995;Rotten;40;79;19;28;47;7
Billy's Hollywood Screen Kiss;1998;Fresh;78;64;18;5;23;6
Biloxi Blues;1988;Fresh;78;62;21;6;27;7
Iceman;2014;Rotten;20;27;1;4;5;3
Bio-Dome;1996;Rotten;4;51;1;24;25;8
Bird;1988;Fresh;83;79;19;4;23;8
Bird of Paradise;1932;Rotten;53;48;8;7;15;5
Bird Box;2018;Fresh;63;57;101;59;160;28
Bird on a Wire;;Rotten;32;41;7;15;22;3
Bird People;2014;Fresh;60;40;21;14;35;12
L'uccello dalle piume di cristallo (The Bird With the Crystal Plumage);1970;Fresh;93;80;26;2;28;5
The Birdcage;1996;Certified-Fresh;80;81;41;10;51;12
Birdemic: Shock And Terror;2008;Rotten;18;26;3;14;17;3
Birders: The Central Park Effect;2013;Fresh;100;77;11;0;11;11
Birdman;2014;Certified-Fresh;91;77;321;31;352;64
Birdman of Alcatraz;1962;Fresh;91;84;20;2;22;1
Birds of Prey (And the Fantabulous Emancipation of One Harley Quinn);2020;Certified-Fresh;78;78;319;91;410;46
Birdy;1984;Fresh;85;84;23;4;27;5
Birth;2004;Rotten;38;43;56;91;147;43
The Birth of a Nation;1915;Fresh;93;56;41;3;44;7
Birth of the Dragon;2017;Rotten;23;68;12;41;53;12
Birth Of The Living Dead;2013;Fresh;96;72;24;1;25;8
Birthday Girl;2002;Rotten;58;39;71;51;122;33
Bit;1900;Fresh;90;36;9;1;10;1
Bitch;2017;Fresh;67;30;26;13;39;10
Bite;2016;Rotten;58;18;11;8;19;3
Bite the Bullet;1975;Fresh;73;53;11;4;15;4
Bitter Moon;1992;Fresh;65;81;22;12;34;12
Bitter Feast;2010;Rotten;57;31;4;3;7;2
Bitter Harvest;2017;Rotten;15;67;9;51;60;20
Die Bitteren Tranen der Petra von Kant (The Bitter Tears of Petra Von Kant);1972;Fresh;88;85;22;3;25;3
Bitter Victory;1957;Fresh;75;69;12;4;16;6
Biutiful;2010;Fresh;66;74;102;53;155;42
Black;2005;Fresh;67;90;4;2;6;1
Black and White;2002;Rotten;39;30;31;49;80;26
Black '47;2018;Certified-Fresh;78;76;43;12;55;15
The Black Balloon;2008;Certified-Fresh;85;84;35;6;41;17
Black Book;2007;Certified-Fresh;75;87;117;38;155;43
Black Butterflies;2012;Fresh;69;62;9;4;13;8
Black Butterfly;2017;Rotten;40;41;8;12;20;5
Black Caesar;1973;Fresh;62;64;8;5;13;3
The Black Cauldron;1985;Rotten;53;48;17;15;32;7
Black Christmas;2006;Rotten;14;37;9;54;63;20
Black Christmas;2019;Rotten;39;31;41;65;106;17
Black Coffee;2014;Rotten;40;56;4;6;10;3
Black Cop;1900;Fresh;82;61;9;2;11;2
The Black Dahlia;2006;Rotten;32;27;63;131;194;44
Black Death;2011;Fresh;71;49;47;19;66;16
Black Dog;1998;Rotten;10;60;2;18;20;3
Black Dynamite;2009;Certified-Fresh;83;85;52;11;63;21
Black Friday;2005;Fresh;89;92;8;1;9;3
Black Hawk Down;2001;Certified-Fresh;76;88;132;41;173;42
Black Knight;2001;Rotten;14;34;14;84;98;29
Black Magic for White Boys;2020;Fresh;80;;8;2;10;2
Black Mask;1900;Rotten;48;50;14;15;29;1
Black Mass;2015;Certified-Fresh;73;68;210;78;288;54
Black Moon Rising;1986;Rotten;43;23;6;8;14;3
Black Narcissus;1947;Fresh;100;88;33;0;33;9
Black Nativity;2013;Rotten;50;51;45;45;90;37
Black November;2015;Rotten;23;38;3;10;13;6
Black Ops;2020;Fresh;67;;6;3;9;0
Black or White;2015;Rotten;38;65;40;64;104;29
The Black Orchid;1958;Rotten;20;59;1;4;5;2
Black Orpheus (Orfeu Negro);1959;Certified-Fresh;90;86;37;4;41;14
Black Out;2014;Rotten;45;48;5;6;11;4
Black Panther;2018;Certified-Fresh;96;79;495;18;512;60
Black Pond;1900;Fresh;100;66;7;0;7;4
Black Robe;1991;Fresh;92;75;12;1;13;1
Black Rock;2013;Rotten;53;24;31;28;59;22
Black Rose;2017;Rotten;22;15;2;7;9;3
Black Sabbath (I Tre volti della paura) (The Three Faces of Fear) (The Three Faces of Terror);1963;Fresh;88;75;15;2;17;1
Black Sea;2015;Certified-Fresh;80;59;109;28;136;37
Black Sheep;2006;Fresh;72;53;68;27;95;32
Black Site;1900;Fresh;67;11;6;3;9;0
Black Snake Moan;2007;Fresh;66;69;107;55;162;46
The Black Stallion;1979;Fresh;90;83;26;3;29;7
Black Sunday;1960;Fresh;86;77;18;3;21;2
The Black Swan;1942;Fresh;83;72;5;1;6;0
Black Swan;2010;Certified-Fresh;85;84;262;47;309;54
Black Water;2018;Rotten;0;26;0;9;9;5
The Black Waters of Echo's Pond;2010;Rotten;21;18;4;15;19;6
Black White + Gray: A Portrait of Sam Wagstaff and Robert Mapplethorpe;2007;Fresh;85;69;17;3;20;11
Blackballed: The Bobby Dukes Story;2006;Rotten;53;64;10;9;19;7
Blackbeard's Ghost;1968;Fresh;82;72;9;2;11;1
Blackbird;2013;Rotten;57;77;4;3;7;2
Blackbird;2015;Rotten;40;56;4;6;10;3
Blackboard Jungle;1955;Fresh;76;77;19;6;25;5
Blackfish;2013;Certified-Fresh;98;90;129;2;131;38
Blackhat;2015;Rotten;32;24;61;127;188;46
BlacKkKlansman;2018;Certified-Fresh;96;83;418;18;436;63
Blackthorn;2011;Certified-Fresh;74;61;55;19;74;25
Blackway;2016;Rotten;20;28;1;4;5;1
Blackwood;2013;Rotten;40;35;6;9;15;4
Blacula;1972;Rotten;50;43;13;13;26;3
Blade II;2002;Rotten;57;68;86;65;151;37
Blade of the Immortal (Mugen no junin);2017;Certified-Fresh;86;69;79;13;92;21
Blade Runner;1982;Certified-Fresh;90;91;107;12;119;27
Blade Runner (The Final Cut);1900;;;;11;1;;6
Blade Runner 2049;2017;Certified-Fresh;88;81;381;54;435;54
Blade: Trinity;2004;Rotten;26;59;43;125;168;38
Blades of Glory;2007;Fresh;70;68;131;56;187;51
Blair Witch;2016;Rotten;37;31;80;139;219;40
The Blair Witch Project;1999;Certified-Fresh;86;56;140;22;162;41
Blame;2018;Fresh;81;68;25;6;31;8
Blame It on Rio;1984;Rotten;8;39;2;22;24;5
Blame It on the Bellboy;1992;Rotten;19;40;3;13;16;5
Blancanieves;2013;Certified-Fresh;95;84;106;6;112;34
Blank City;2011;Certified-Fresh;82;73;36;8;44;21
Blank Check;1994;Rotten;9;34;1;10;11;1
Blankman;1994;Rotten;19;40;3;13;16;3
Blast From the Past;1999;Rotten;58;56;47;34;81;26
Blaze;1989;Fresh;73;47;8;3;11;1
Blaze;2018;Certified-Fresh;95;68;86;5;91;22
Blazing Saddles;1974;Certified-Fresh;88;91;52;7;59;7
Bleach;2018;Fresh;67;77;4;2;6;0
Bleak Street (La calle de la amargura);2016;Rotten;58;38;14;10;24;7
Bleed;2016;Rotten;43;32;3;4;7;2
Bleed For This;2016;Fresh;70;69;98;43;141;38
Bleeding Heart;2015;Rotten;43;32;6;8;14;3
Bleeding Steel;2018;Rotten;22;23;4;14;18;5
Blended;2014;Rotten;14;64;20;118;138;33
Bless Me, Ultima;2013;Fresh;68;73;25;12;37;15
Bless the Child;2000;Rotten;3;43;3;108;111;35
Blessed Child;1900;Fresh;90;;9;1;10;1
Blessed Is the Match: The Life and Death of Hannah Senesh;2009;Fresh;68;70;15;7;22;7
Blind Chance (Przypadek);1989;Fresh;70;86;8;3;10;2
Blind;2015;Fresh;92;74;34;3;37;16
Blind;2017;Rotten;19;42;4;17;21;8
Blind Dating;2007;Rotten;25;47;6;18;24;6
Blind Fury;;Rotten;54;51;7;6;13;2
Blind Spot: Hitler's Secretary;2002;Certified-Fresh;86;72;73;12;85;32
Blinded by the Light;2019;Certified-Fresh;89;91;225;28;253;41
Blindsight;2006;Certified-Fresh;98;83;49;1;50;21
Blindspotting;2018;Certified-Fresh;94;87;161;10;171;38
Bling;2016;Rotten;33;32;2;4;6;1
Blink;1994;Fresh;63;45;15;9;24;5
Blinky Bill The Movie;2016;Fresh;73;43;8;3;11;3
Bliss;2019;Fresh;88;58;38;5;43;4
Blithe Spirit;1945;Fresh;77;75;17;5;22;3
Blitz;1900;Rotten;48;36;12;13;25;7
Blizzard;2003;Fresh;67;53;4;2;6;2
Dave Chappelle's Block Party;2006;Certified-Fresh;92;74;117;10;127;37
Blockers;2018;Certified-Fresh;84;50;188;37;225;43
Blonde Ambition;2007;Rotten;14;22;1;6;7;1
Blood;2013;Rotten;55;33;24;20;44;13
Blood and Black Lace (Sei donne per l'assassino);1965;Fresh;80;76;12;3;15;2
Blood and Chocolate;2007;Rotten;11;52;8;66;74;19
Blood and Money;2020;Rotten;39;52;9;14;23;6
Blood and Sand;1922;Fresh;100;61;8;0;8;0
Blood and Wine;1997;Fresh;61;35;19;12;31;10
Blood Brother;2013;Fresh;73;88;19;7;26;7
Blood Brother;2018;Rotten;17;79;1;5;6;2
The Reunion;2011;Rotten;8;33;1;11;12;8
Blood Diamond;2006;Fresh;63;90;136;81;217;54
Blood Done Sign My Name;2010;Rotten;52;61;15;14;29;14
Blood Father;2016;Certified-Fresh;89;63;86;11;97;18
Blood Fest;2018;Rotten;50;43;10;10;20;2
Blood Glacier;2014;Rotten;43;28;9;12;21;6
Blood Honey;2018;Rotten;25;72;2;6;8;2
Blood in the Face;1991;Fresh;100;61;5;0;5;2
Blood Into Wine;2010;Fresh;71;78;5;2;7;1
Blood Money;2017;Rotten;50;15;4;4;8;5
The Blood of Heroes;;Rotten;13;76;1;7;8;5
Blood on Her Name;2020;Certified-Fresh;96;58;52;2;54;8
Blood On The Mountain;2016;Fresh;90;59;9;1;10;5
Blood Paradise;1900;Rotten;40;;2;3;5;1
Blood Punch;1900;Fresh;89;63;8;1;9;3
Blood Quantum;1900;Certified-Fresh;90;43;81;9;90;7
Blood Ransom;2014;Rotten;20;81;1;4;5;3
Blood Simple;1984;Certified-Fresh;94;88;97;6;103;22
La Novia Ensangrentada (The Blood Spattered Bride) (Blood Castle);1972;Fresh;100;41;6;0;6;0
Blood Tea and Red String;2006;Fresh;91;78;10;1;11;4
Blood Ties;2014;Rotten;52;39;29;27;56;21
Blood Vessel;1900;Fresh;78;21;7;2;9;0
Blood Work;2002;Rotten;53;40;80;72;152;40
Bloodline;2019;Rotten;53;56;10;9;19;4
BloodRayne;2006;Rotten;4;17;2;52;54;14
Bloodshot;2020;Rotten;30;78;47;112;159;23
Bloodsport;1988;Rotten;40;74;10;15;25;3
Bloodsucking Bastards;2015;Fresh;67;48;16;8;24;5
Bloodworth;2011;Rotten;50;39;4;4;8;2
Bloody Birthday;1981;Fresh;67;35;4;2;6;0
Bloody Marie;2019;Fresh;88;;7;1;8;2
Bloody Nose, Empty Pockets;1900;Certified-Fresh;91;80;62;6;68;15
Bloody Sunday;2002;Certified-Fresh;92;91;97;8;105;34
Blossoms in the Dust;1941;Rotten;33;72;3;6;9;3
Blow;2001;Rotten;55;87;77;64;141;36
Blow Out;1981;Certified-Fresh;83;82;40;8;48;9
Blow-Up;1966;Certified-Fresh;88;84;43;6;49;10
Blue Sky;1994;Fresh;79;58;19;5;24;5
Blue Water, White Death;1971;Fresh;100;83;7;0;7;5
Blue Caprice;2013;Certified-Fresh;83;51;70;14;84;30
Blue Car;2003;Certified-Fresh;80;65;71;18;89;35
Blue Chips;1994;Rotten;37;51;10;17;27;10
Blue Collar;1978;Fresh;100;89;12;0;12;1
Blue Collar Comedy Tour: The Movie;2003;Fresh;92;79;12;1;13;8
Blue Crush;2002;Fresh;61;58;87;55;142;34
Blue Crush 2;1900;Rotten;20;40;1;4;5;0
The Blue Gardenia;1953;Fresh;80;61;12;3;15;5
Blue Hawaii;1961;Rotten;29;67;2;5;7;0
The Blue Iguana;1988;Rotten;0;38;0;6;6;1
Blue Iguana;2018;Rotten;39;80;11;17;28;9
Blue in the Face;1995;Rotten;41;76;9;13;22;4
Blue Is The Warmest Color;2013;Certified-Fresh;89;85;172;21;193;45
Blue Jasmine;2013;Certified-Fresh;91;77;207;21;228;59
Blue Jay;2016;Fresh;91;77;29;3;32;11
The Blue Lagoon;1980;Rotten;8;54;2;22;24;8
Blue Like Jazz;2012;Rotten;39;63;16;25;41;14
Here and Now (Blue Night);2018;Rotten;23;12;5;17;22;7
Blue Note Records: Beyond the Notes;1900;Fresh;95;76;20;1;21;10
Blue Ruin;2014;Certified-Fresh;96;79;136;6;142;39
Blue State;2007;Rotten;40;34;2;3;5;0
Blue Story;2020;Fresh;91;66;32;3;35;14
Blue Streak;1999;Rotten;36;65;25;44;69;21
Blue Sunshine;1976;Fresh;80;46;4;1;5;0
Blue Thunder;1983;Fresh;77;52;17;5;22;0
Blue Valentine;2010;Certified-Fresh;87;77;182;27;209;51
Blue Velvet;1986;Certified-Fresh;94;88;72;5;77;21
The Blues Brothers;1980;Certified-Fresh;84;92;49;9;58;11
Blues Brothers 2000;1997;Rotten;46;37;21;25;46;13
Blume in Love;1973;Fresh;83;57;5;1;6;1
Blumenthal;2014;Rotten;56;48;5;4;9;7
Blumhouse's Truth or Dare;2018;Rotten;16;22;25;135;160;32
Blur: No Distance Left to Run;1900;Fresh;93;93;13;1;14;6
Blush (Hong fen);1996;Rotten;50;;3;3;6;3
BMX Bandits;1983;Fresh;67;55;4;2;6;2
Bo Burnham: Make Happy;1900;Fresh;100;88;6;0;6;1
Boarding Gate;2008;Rotten;32;20;15;32;47;17
Boarding School;2018;Rotten;33;59;3;6;9;5
Boat Trip;2003;Rotten;7;36;6;84;90;25
Bob & Carol & Ted & Alice;1969;Fresh;83;65;15;3;18;2
Bob Funk;2009;Rotten;17;23;2;10;12;4
Bob Lazar: Area 51 & Flying Saucers;1900;Rotten;20;40;1;4;5;0
Bob le Flambeur;1900;Fresh;97;90;31;1;32;8
Bobby G. Can't Swim;1999;Fresh;70;64;7;3;10;5
Bobby Deerfield;1977;Rotten;29;45;4;10;14;4
Bobby Fischer Against The World;2011;Certified-Fresh;88;86;43;6;49;16
Bobby Jones: Stroke of Genius;2004;Rotten;26;61;20;56;76;30
Boccaccio '70;1962;Rotten;50;78;6;6;12;2
Bodied;2018;Certified-Fresh;89;86;73;9;82;18
Body at Brighton Rock;2019;Fresh;66;18;27;14;41;7
Body Cam;1900;Rotten;44;44;11;14;25;5
Body Double;1984;Fresh;76;65;26;8;34;3
Body of Evidence;1992;Rotten;8;22;3;35;38;12
Body of War;2008;Certified-Fresh;80;82;33;8;41;17
Body Shots;1999;Rotten;11;27;3;25;28;6
Body Snatchers;1993;Fresh;69;38;20;9;29;4
Bodyguards and Assassins (Shi yue wei cheng);2010;Rotten;57;71;4;3;7;1
Bogus;1996;Rotten;44;45;7;9;16;4
Bohemian Rhapsody;2018;Fresh;60;85;243;160;403;45
Bokeh;2017;Rotten;43;24;9;12;21;7
Bol Bachchan;2012;Fresh;71;51;5;2;7;4
Bolero;1984;Rotten;0;17;0;23;23;7
Bolt;2008;Certified-Fresh;89;74;167;20;187;46
Bomb City;2018;Fresh;75;83;9;3;12;4
Bomb It;2008;Fresh;88;81;14;2;16;8
Bombay Beach;2011;Fresh;77;78;30;9;39;16
Bombs Over Burma;1943;Rotten;40;50;2;3;5;1
Bombshell;2019;Fresh;69;84;218;100;318;45
Bombshell: The Hedy Lamarr Story;2017;Certified-Fresh;96;85;88;4;92;22
Bonded By Blood;1900;Rotten;9;28;1;10;11;3
Bone;1972;Fresh;71;75;5;2;7;0
The Bone Collector;1999;Rotten;29;63;25;61;86;23
The Bone Snatcher;2003;Rotten;0;18;0;7;7;0
Bone Tomahawk;2015;Certified-Fresh;90;73;85;9;94;17
Bones;2001;Rotten;23;40;16;53;69;21
Bones Brigade: An Autobiography;2012;Fresh;77;92;10;3;13;9
The Bonfire of the Vanities;;Rotten;16;26;8;43;51;13
Bongwater;1998;Rotten;17;66;1;5;6;3
Bonhoeffer;2003;Fresh;71;79;22;9;31;11
Bonjour Tristesse;1958;Fresh;86;68;19;3;22;10
Bonneville;2006;Rotten;41;43;17;24;41;16
Bonnie and Clyde;1967;Certified-Fresh;88;88;56;8;64;12
Bonsai;2012;Fresh;84;59;21;4;25;13
Boogeyman;2005;Rotten;13;21;12;77;89;14
Boogie Man: The Lee Atwater Story;2008;Fresh;93;79;28;2;30;14
Boogie Nights;1997;Certified-Fresh;93;89;66;5;71;14
Boogie Woogie;2010;Rotten;33;22;8;16;24;9
Book Club;2018;Rotten;54;51;100;84;184;41
The Book of Life;1998;Fresh;89;71;8;1;9;0
Book of Monsters;1900;Fresh;75;42;6;2;8;0
Book of Shadows - Blair Witch 2;2000;Rotten;14;18;15;93;108;32
Booker's Place: A Mississippi Story;2012;Fresh;100;85;17;0;17;8
Bookies;2004;Fresh;67;50;4;2;6;2
Booksmart;2019;Certified-Fresh;96;77;346;13;359;50
BookWars;2000;Fresh;80;;4;1;5;1
The Boondock Saints;1999;Rotten;28;91;8;21;29;2
The Boondock Saints II: All Saints Day;2009;Rotten;23;58;10;33;43;17
The Boost;1988;Rotten;40;51;4;6;10;2
Bootmen;2000;Rotten;35;68;6;11;17;5
Booty Call;1997;Rotten;25;59;3;9;12;6
Bopha!;1993;Fresh;82;64;9;2;11;7
Borat: Cultural Learnings of America for Make Benefit Glorious Nation of Kazakhstan;2006;Certified-Fresh;91;79;202;20;222;49
Border (Grans);2018;Certified-Fresh;97;76;123;4;127;23
Border Incident;1949;Fresh;67;59;4;2;6;0
Borg Vs. McEnroe;2018;Certified-Fresh;84;74;121;23;144;35
Borgman;2014;Certified-Fresh;87;69;54;8;62;22
Boricua's Bond;2000;Rotten;11;48;1;8;9;4
Born Free;1966;Fresh;94;86;16;1;17;2
Born in Flames;1983;Fresh;80;58;13;3;15;6
Born Into Brothels;2004;Certified-Fresh;95;91;103;5;108;31
Born Losers;1967;Fresh;60;63;3;2;5;0
Born on the Fourth of July;1989;Certified-Fresh;85;76;41;7;48;8
Born Romantic;2001;Rotten;58;55;18;13;31;10
Born To Be Blue;2016;Certified-Fresh;88;73;103;14;117;40
Born To Be Wild;2011;Certified-Fresh;98;84;48;1;49;20
Born to Dance;1900;Fresh;83;52;5;1;6;0
Born To Fly;2014;Fresh;92;69;11;1;12;7
Born to Win;1971;Rotten;29;32;2;5;7;1
The Borrower;1900;Rotten;30;16;3;7;10;0
Boss;2013;Rotten;0;50;0;5;5;3
Boston;2017;Fresh;100;67;8;0;8;5
The Bostonians;1984;Fresh;83;35;10;2;12;5
Bottle Rocket;1996;Certified-Fresh;85;80;56;10;66;20
Bottle Shock;2008;Rotten;48;58;60;64;124;38
Bottled Up;2014;Rotten;33;40;2;4;6;5
Bottom of the 9th;2019;Fresh;69;69;9;4;13;5
Boulevard;2015;Rotten;52;30;38;35;73;28
Bounce;2000;Rotten;52;32;56;51;107;32
Bound;1996;Certified-Fresh;89;82;39;5;44;7
Bound By Flesh;2014;Fresh;94;54;15;1;16;10
Bound to Vengeance;2015;Rotten;20;33;3;12;15;6
Bounty Killer;2013;Rotten;59;45;16;11;27;9
The Bourne Identity;2002;Certified-Fresh;83;93;160;32;192;41
The Bourne Supremacy;2004;Certified-Fresh;82;90;161;36;197;43
The Bourne Ultimatum;2007;Certified-Fresh;92;91;246;20;266;56
Bowery at Midnight;1942;Rotten;40;17;2;3;5;0
Bowfinger;1999;Certified-Fresh;81;61;90;21;111;28
Bowling for Columbine;2002;Certified-Fresh;95;83;163;9;172;34
Box of Moonlight;1997;Fresh;61;81;11;7;18;5
Boxcar Bertha;1972;Rotten;52;33;12;11;23;4
Boy;2012;Certified-Fresh;87;86;62;9;71;25
Boy A;2007;Certified-Fresh;88;87;53;7;60;27
A Boy and His Dog;1975;Fresh;76;63;25;8;33;4
Boy and the World (O Menino e o Mundo);2015;Certified-Fresh;93;77;53;4;57;19
Boy Culture;2007;Fresh;70;70;21;9;30;13
Boy Erased;2018;Certified-Fresh;81;74;208;51;258;44
The Boy Friend;1971;Fresh;83;69;10;2;12;4
The Boy in the Striped Pajamas (The Boy in the Striped Pyjamas);2008;Fresh;64;85;89;51;140;40
Boy Meets Girl;2015;Fresh;88;80;15;2;17;5
A Boy Named Charlie Brown;1969;Fresh;95;86;20;1;21;4
The Boy Who Could Fly;1986;Fresh;63;69;19;11;30;9
Boy Wonder;2011;Rotten;57;62;4;3;7;5
Boyhood;2014;Certified-Fresh;97;81;311;10;321;69
Boynton Beach Club;2006;Fresh;60;42;32;21;53;28
Boys and Girls;2000;Rotten;11;50;7;55;62;19
Boys Don't Cry;1999;Certified-Fresh;88;87;69;9;78;22
Boys of Abu Ghraib;2014;Rotten;30;62;3;7;10;5
Boys on the Side;1995;Fresh;74;69;26;9;35;9
The Boys: The Sherman Brothers' Story;2009;Fresh;90;87;19;2;21;12
Boys Town;1938;Fresh;90;81;18;2;20;2
Boyz n the Hood;1991;Certified-Fresh;96;93;66;3;69;17
Bra Boys;2008;Rotten;59;71;17;12;29;13
Brad Paisley's Comedy Rodeo;1900;Fresh;60;;3;2;5;2
Brad's Status;2017;Certified-Fresh;79;55;137;36;173;38
Brahman Naman;1900;Fresh;75;45;6;2;8;5
Brahms: The Boy II;2020;Rotten;9;44;5;51;56;7
Braid;2019;Fresh;87;60;20;3;23;5
Brain Damage;1988;Fresh;67;63;10;5;15;1
Brain Dead;1989;Rotten;17;69;1;5;6;0
Brain Donors;1992;Rotten;45;85;5;6;11;0
Brain on Fire;2018;Rotten;13;67;2;14;16;3
Brainscan;1994;Rotten;19;60;3;13;16;2
Brake;2012;Rotten;44;40;12;15;27;11
Brampton's Own;2018;Rotten;40;59;2;3;5;2
Bran Nue Dae;2010;Rotten;56;52;35;27;62;21
Branded;2012;Rotten;9;24;1;10;11;3
Branded to Kill;1967;Fresh;100;84;23;0;23;7
The Brandon Teena Story;1998;Fresh;69;68;9;4;13;3
Brannigan;1975;Rotten;20;40;2;8;10;1
Bratz: The Movie;2007;Rotten;10;46;8;72;80;30
The Bravados;1958;Fresh;100;67;5;0;5;0
Brave;2012;Certified-Fresh;78;75;194;54;248;53
Brave Little Toaster to the Rescue;1999;Rotten;40;47;2;3;5;0
Brave New Jersey;2017;Rotten;47;37;9;10;19;6
The Brave One;2007;Rotten;43;64;80;105;185;45
Braven;2018;Fresh;77;76;24;7;31;8
Bravetown;2015;Rotten;25;47;4;12;16;6
Brawl in Cell Block 99;2017;Certified-Fresh;91;74;82;8;90;19
Breach;2007;Certified-Fresh;84;67;149;28;177;54
Bread & Tulips;2001;Fresh;71;86;44;18;62;23
Break Ke Baad;2010;Rotten;17;33;1;5;6;2
Break Point;2015;Fresh;71;52;15;6;21;9
The Break-Up;2006;Rotten;34;46;66;126;192;46
'Breaker' Morant;1980;Fresh;100;91;23;0;23;0
Breakfast at Tiffany's;1961;Certified-Fresh;88;91;46;6;52;9
The Breakfast Club;1985;Certified-Fresh;89;92;58;7;65;15
Breakfast with Scot;2007;Rotten;54;64;15;13;28;14
Breakheart Pass;1975;Fresh;60;59;9;6;15;0
Breakin' All the Rules;2004;Rotten;31;57;27;60;87;29
Breaking A Monster;2016;Fresh;100;58;24;0;24;9
Breaking and Entering;2007;Rotten;34;52;44;85;129;44
Breaking & Exiting;2018;Rotten;0;69;0;6;6;4
Breaking Away;1979;Fresh;95;88;35;2;37;6
Breaking In;2018;Rotten;27;32;29;78;107;20
Daai si gin (Breaking News);2006;Fresh;79;65;15;4;19;6
Breaking The Girls;2013;Rotten;11;29;1;8;9;4
Breaking the Waves;1996;Certified-Fresh;85;91;50;9;59;12
Breaking Upwards;2010;Fresh;60;57;12;8;20;10
Breakthrough;2019;Fresh;63;79;40;24;64;17
Breakup at a Wedding;2013;Fresh;67;65;4;2;6;4
Breath Of The Gods;1900;Rotten;50;91;5;5;10;2
Breathe;2017;Fresh;67;71;111;54;165;33
Breathe In;2014;Rotten;56;41;45;35;80;28
Breathless;1961;Certified-Fresh;97;90;65;2;67;22
Breezy;1973;Fresh;67;66;4;2;6;0
Brian Banks;2019;Fresh;62;97;44;27;71;17
Brick;2006;Certified-Fresh;80;86;113;29;142;38
Brick Lane;2008;Fresh;68;60;70;33;103;39
Brick Mansions;2014;Rotten;26;47;25;72;97;28
The Bride;1985;Rotten;25;33;3;9;12;0
Bride and Prejudice;2005;Fresh;64;70;86;48;134;37
Bride Flight;2011;Fresh;67;75;26;13;39;21
Bride of Chucky;1998;Rotten;46;46;17;20;37;6
The Bride of Frankenstein;1935;Certified-Fresh;98;87;46;1;46;7
Bride of Re-Animator;;Rotten;40;45;8;12;20;4
Bride of the Gorilla;1951;Rotten;40;25;2;3;5;0
Bride of the Monster;1955;Rotten;45;28;5;6;11;0
Bride of the Wind;2001;Rotten;11;38;7;57;64;28
Bride Wars;2009;Rotten;11;51;16;128;144;46
Bridegroom;2013;Fresh;85;87;11;2;13;5
The Brides of Dracula;1960;Fresh;75;61;12;4;16;2
Brideshead Revisited;2008;Fresh;62;52;86;52;138;46
Bridesmaids;2011;Certified-Fresh;90;76;258;29;287;56
Bridge of Spies;2015;Certified-Fresh;90;87;278;30;307;58
The Bridge on the River Kwai;1957;Certified-Fresh;95;93;56;3;59;12
Bridge to Terabithia;2007;Certified-Fresh;85;70;135;24;159;39
A Bridge Too Far;1977;Fresh;64;86;16;9;25;6
The Bridges at Toko-Ri;1954;Fresh;80;61;8;2;10;0
The Bridges of Madison County;1995;Certified-Fresh;90;87;53;6;59;19
Bridget Jones's Diary;2001;Certified-Fresh;80;81;129;32;161;42
Bridget Jones: The Edge of Reason;2004;Rotten;27;60;43;114;157;39
Bridget Jones's Baby;2016;Certified-Fresh;78;65;164;45;209;48
A Brief History of Time;1992;Fresh;94;81;17;1;18;5
Brief Interviews with Hideous Men;2009;Rotten;40;32;16;24;40;15
Brigadoon;1954;Fresh;85;72;11;2;13;0
Bright;2017;Rotten;28;83;30;79;109;22
Bright Eyes;1934;Fresh;83;75;10;2;12;0
Bright Leaves;2004;Certified-Fresh;86;72;48;8;56;24
Bright Lights: Starring Carrie Fisher and Debbie Reynolds;2017;Certified-Fresh;100;86;57;0;57;24
Bright Star;2009;Certified-Fresh;83;68;146;30;175;54
Bright Young Things;2004;Fresh;65;67;72;39;111;37
Brightburn;2019;Rotten;58;67;117;86;203;29
Brightest Star;2014;Rotten;13;24;2;13;15;8
Brighton Beach Memoirs;1986;Fresh;69;79;9;4;13;2
Brighton Rock;2011;Rotten;51;33;48;47;95;33
Brigsby Bear;2017;Certified-Fresh;82;86;133;30;163;35
Brilliant Lies;1996;Fresh;80;23;4;1;5;0
Brimstone;2017;Rotten;42;53;32;44;76;18
Bring It On;2000;Fresh;63;66;76;44;120;36
Bring It On: All or Nothing;2006;Rotten;20;70;1;4;5;1
Bring Me the Head of the Machine Gun Woman (Traiganme la cabeza de la mujer metralleta);1900;Rotten;50;43;3;3;6;1
Bringing Down the House;2003;Rotten;34;49;51;99;150;35
Bringing Out the Dead;1999;Certified-Fresh;72;70;78;31;109;28
Bringing Up Baby;1938;Certified-Fresh;93;89;43;3;46;8
Bringing Up Bobby;2012;Rotten;17;34;2;10;12;7
Britannia Hospital;2001;Rotten;50;55;3;3;6;0
Britt-Marie Was Here;2019;Fresh;70;40;14;6;20;5
Broadcast News;1987;Certified-Fresh;98;79;50;1;51;11
Broadway Damage;1997;Rotten;29;50;2;5;7;1
Broadway Danny Rose;1984;Fresh;100;84;29;0;29;5
Broadway Idiot;2013;Fresh;65;72;13;7;20;14
The Broadway Melody;1929;Rotten;33;21;8;16;24;7
Broadway: The Golden Age;2004;Certified-Fresh;83;92;38;8;46;21
Brokeback Mountain;2005;Certified-Fresh;87;82;215;31;246;52
Brokedown Palace;1999;Rotten;31;66;11;24;35;6
Broken;2013;Fresh;63;73;35;21;56;20
Broken City;2013;Rotten;28;40;43;110;153;46
Broken Embraces;2009;Certified-Fresh;81;75;127;29;156;49
Broken English;2007;Fresh;64;62;46;26;72;25
Broken Flowers;2005;Certified-Fresh;87;70;170;25;195;44
The Broken Hearts Club;2000;Fresh;62;72;18;11;29;5
Broken Horses;2015;Rotten;25;43;5;15;20;10
Broken Lance;1954;Fresh;92;60;11;1;12;1
Broken Tower;2012;Rotten;20;18;2;8;10;8
Bronco Billy;1980;Fresh;75;48;15;5;20;1
Bronson;2009;Certified-Fresh;76;74;62;20;82;27
A Bronx Tale;1993;Fresh;97;93;29;1;30;5
The Brood;1979;Fresh;83;68;19;4;23;4
Brooklyn;2015;Certified-Fresh;97;87;261;8;269;51
Brooklyn Castle;2012;Certified-Fresh;96;81;51;2;53;24
Brooklyn Lobster;2005;Rotten;44;61;7;9;16;11
Brooklyn Rules;2007;Rotten;45;51;18;22;40;16
Brooklyn's Finest;2010;Rotten;45;46;68;84;152;44
Brother (Hermano);2012;Rotten;54;82;7;6;13;5
Brother Bear;2003;Rotten;37;65;49;83;132;33
Brother Bear 2;2006;Rotten;50;56;4;4;8;0
Brother Nature;2016;Rotten;57;30;4;3;7;4
Brother Sun, Sister Moon (Fratello sole, sorella luna);1972;Rotten;42;77;8;11;19;6
Brother to Brother;2004;Certified-Fresh;77;74;33;10;43;19
Brotherhood;2011;Rotten;54;54;14;12;26;9
The Brotherhood of Satan;1971;Rotten;0;33;0;6;6;0
Brothers;2004;Certified-Fresh;89;86;66;8;74;28
Brothers at War;2009;Fresh;70;68;14;6;20;14
The Brothers Bloom;2009;Fresh;68;64;106;50;156;44
The Brothers Grimm;2005;Rotten;38;39;69;114;183;38
Brothers Hypnotic;2014;Fresh;100;55;7;0;7;3
Brother's Justice;2011;Rotten;0;23;0;9;9;6
The Brothers Karamazov;1957;Rotten;30;60;3;7;10;4
The Brothers McMullen;1995;Fresh;89;60;32;4;36;8
Brothers of the Head;2006;Fresh;69;66;48;22;70;23
The Brothers Solomon;2007;Rotten;15;31;11;62;73;26
Brown Sugar;2002;Fresh;66;90;56;29;85;30
Brubaker;1980;Fresh;75;73;18;6;24;4
Bruce Almighty;2003;Rotten;48;57;93;100;193;44
Bruiser;2000;Fresh;67;30;6;3;9;0
Bruno;2009;Fresh;67;41;153;74;227;56
Bruno;2000;Rotten;20;68;1;4;5;1
Bruoguminn (White Night Wedding);2008;Rotten;29;58;2;5;7;4
Brush With Danger;2014;Rotten;20;43;1;4;5;3
Brute Force;1947;Fresh;94;87;15;1;16;4
Bubba Ho-Tep;2003;Certified-Fresh;78;79;83;23;106;29
Bubble Boy;2001;Rotten;31;48;26;58;84;21
Buck;2011;Certified-Fresh;90;89;94;11;105;31
The Bucket List;2007;Rotten;41;77;72;103;175;40
A Bucket of Blood;1959;Fresh;71;68;10;4;14;0
Bucky Larson: Born to Be a Star;2011;Rotten;3;25;1;35;36;12
The Buddy Holly Story;1978;Fresh;100;77;29;0;29;7
Buddymoon;2016;Fresh;75;58;6;2;8;4
Budrus;2010;Fresh;88;91;21;3;24;14
Buena Vista Social Club: Adios;2017;Fresh;70;73;14;6;20;11
Buffalo '66;1998;Certified-Fresh;76;88;45;14;59;17
Buffalo Bill and the Indians, or Sitting Bull's History Lesson;1976;Fresh;67;49;10;5;15;2
Buffalo Boys;2019;Fresh;79;39;27;7;34;7
Buffalo Girls;2012;Rotten;44;53;4;5;9;6
Buffalo Soldiers;2001;Fresh;73;72;84;31;115;38
Buffy the Vampire Slayer;1992;Rotten;35;43;18;34;52;13
Bug;2006;Fresh;62;34;82;51;133;42
Bugs!;2003;Fresh;82;58;28;6;34;18
A Bug's Life;1998;Certified-Fresh;92;73;81;7;88;20
Bugsy;1991;Certified-Fresh;85;69;51;9;60;16
Bugsy Malone;1976;Fresh;83;81;20;4;24;3
Bukowski: Born into This;2003;Certified-Fresh;84;89;42;8;50;19
Bull;2020;Certified-Fresh;90;70;77;9;86;11
Bull Durham;1988;Certified-Fresh;97;82;69;2;71;14
Bullet;1900;Rotten;11;13;1;8;9;2
Bullet Head;2017;Rotten;59;31;10;7;17;8
Bullet to the Head;2013;Rotten;45;39;65;78;143;36
Bulletproof Heart;1995;Fresh;63;64;5;3;8;3
Bulletproof Monk;2003;Rotten;23;38;31;101;132;36
Bullitt;1968;Fresh;97;85;37;1;38;8
Bully;2001;Rotten;55;69;50;41;91;28
Bully;2012;Certified-Fresh;85;78;120;21;141;40
Bulworth;1998;Certified-Fresh;76;68;50;16;66;12
Bumblebee;2018;Certified-Fresh;91;74;221;23;244;35
Bunny and the Bull;1900;Fresh;67;65;22;11;33;12
Bunny Lake Is Missing;1965;Fresh;87;78;13;2;15;3
Bunraku;2011;Rotten;17;49;4;19;23;13
Bunty Aur Babli;2005;Fresh;83;77;5;1;6;2
Burden;2017;Fresh;97;93;35;1;36;15
Burden;2020;Rotten;51;97;35;33;68;15
Burden of Dreams;1982;Fresh;94;91;16;1;17;3
Buried;2010;Certified-Fresh;87;65;135;21;156;32
Burke and Hare;2011;Rotten;33;35;19;39;58;18
Burlesque;2010;Rotten;37;64;64;111;175;47
Burma VJ: Reporter i et Lukket Land (Burma VJ: Reporting from a Closed Country);2008;Certified-Fresh;97;91;60;2;62;25
Burn!;1969;Fresh;86;81;12;2;14;3
Burn;2012;Fresh;100;91;17;0;17;6
Burn;2019;Rotten;58;44;7;5;12;4
Burn After Reading;2008;Certified-Fresh;78;65;192;54;246;55
Burn Country;2016;Fresh;60;41;9;6;15;7
Night of the Eagle (Burn, Witch, Burn! );1962;Fresh;80;65;12;3;15;2
Burn Your Maps;2019;Fresh;64;82;9;5;14;7
Burning Palms;2011;Rotten;38;35;3;5;8;4
Burning (Beoning);2018;Certified-Fresh;95;80;183;10;193;36
Burning Annie;2003;Rotten;50;38;4;4;8;5
Burning Blue;2014;Rotten;25;52;3;9;12;6
Burning Dog;1900;Fresh;100;;6;0;6;0
Burning Man;2012;Fresh;77;64;20;6;26;4
The Burning Plain;2009;Rotten;38;56;30;49;79;21
Burning Sands;2017;Fresh;88;60;23;3;26;9
Burnt;2015;Rotten;28;44;44;115;159;40
Burnt by the Sun;1994;Fresh;80;94;12;3;15;5
Burnt Offerings;1976;Rotten;54;43;7;6;13;1
Burton And Taylor;1900;Fresh;100;61;12;0;12;8
Burt's Buzz;2014;Fresh;79;49;11;3;14;6
Burying the Ex;2015;Rotten;28;30;11;28;39;13
Busco Novio Para Mi Mujer;2016;Fresh;78;68;7;2;9;0
Bushwick;2017;Rotten;48;31;35;38;73;22
The Business of Being Born;2008;Fresh;81;85;21;5;26;13
The Business of Strangers;2001;Certified-Fresh;81;51;76;18;94;31
Buster's Mal Heart;2017;Fresh;70;56;35;15;50;15
Bustin' Loose;1981;Fresh;60;61;3;2;5;1
But I'm a Cheerleader;2000;Rotten;40;74;34;51;85;28
The Butcher Boy;1997;Certified-Fresh;77;82;47;14;61;16
Butcher Boys;2013;Rotten;0;20;0;5;5;0
La Soga (The Butcher's Son);2010;Rotten;44;73;7;9;16;7
The Butcher's Wife;1991;Rotten;25;29;4;12;16;4
Butt Boy;1900;Fresh;70;67;40;17;57;5
Butter;2012;Rotten;34;44;23;45;68;24
Butterfield 8;1960;Rotten;47;57;9;10;19;5
Butterflies Are Free;1972;Fresh;69;81;9;4;13;3
The Butterfly Effect;2004;Rotten;33;81;57;115;172;37
Butterfly Girl;2015;Fresh;100;93;6;0;6;4
Butterfly Kiss;1996;Fresh;77;60;10;3;13;1
bwoy;2017;Fresh;88;50;7;1;8;4
By Hook or by Crook;2002;Fresh;64;77;9;5;14;7
By the Grace of God (Grace a Dieu);2019;Certified-Fresh;96;77;92;4;96;23
By The Gun;2014;Rotten;40;19;2;3;5;1
By The Sea;2015;Rotten;34;28;54;104;158;45
Byzantium;2013;Fresh;66;51;79;41;120;36
The C Word;2016;Fresh;100;94;6;0;6;3
Cabaret;1972;Certified-Fresh;93;87;40;3;43;8
Cabaret Balkan (Bure baruta);1999;Fresh;79;85;11;3;14;6
Cabin Boy;1994;Rotten;46;42;12;14;26;3
Cabin Fever;2016;Rotten;0;12;0;28;28;8
Cabin Fever 3: Patient Zero;2014;Rotten;24;14;5;16;21;7
Cabin in the Sky;1943;Fresh;85;81;17;3;20;6
Cabiria;1914;Fresh;96;69;25;1;26;11
The Cable Guy;1996;Rotten;54;51;42;36;78;25
Cache;2005;Certified-Fresh;89;78;120;15;135;37
Cactus Flower;1969;Fresh;88;81;15;2;17;3
Caddyshack;1980;Certified-Fresh;73;87;43;16;59;13
Caddyshack II;1988;Rotten;4;18;1;23;24;6
Cadence;1989;Rotten;42;70;5;7;12;4
Cadillac Records;2008;Fresh;67;65;82;41;123;46
Caesar Must Die;2013;Certified-Fresh;92;74;46;4;50;22
Cafe de Flore;2012;Fresh;64;76;35;20;55;16
Cafe Society;2016;Fresh;71;56;179;74;253;52
Caffeine;2007;Rotten;0;39;0;9;9;3
The Caine Mutiny;1954;Fresh;92;87;23;2;25;4
Cairo Time;2010;Certified-Fresh;81;62;65;15;80;27
Cake;2015;Rotten;48;44;61;66;126;43
Calendar Girls;2003;Certified-Fresh;74;67;93;33;126;35
Calibre;1900;Fresh;95;74;19;1;20;3
California Dreamin' (Nesfarsit) (Endless);2007;Fresh;89;82;16;2;18;6
California Solo;2012;Fresh;68;54;17;8;25;15
California Split;1974;Fresh;88;83;15;2;17;7
California Suite;1978;Rotten;54;45;13;11;24;3
California Typewriter;2017;Fresh;100;83;39;0;39;13
Call Me by Your Name;2018;Certified-Fresh;94;86;335;21;356;49
Call Me Kuchu;2013;Certified-Fresh;98;89;50;1;51;18
Call Me Lucky;2015;Fresh;85;80;22;4;26;10
Call Northside 777;1948;Fresh;76;73;13;4;17;1
Callas Forever;2004;Rotten;41;54;24;34;58;23
Calle 54;2001;Certified-Fresh;87;87;41;6;47;19
Calling All Earthlings;2018;Fresh;63;100;10;6;16;6
Calvary;2014;Certified-Fresh;89;80;152;19;171;48
Calvin Marshall;2010;Fresh;60;41;6;4;10;6
CAM;2018;Certified-Fresh;93;54;91;7;98;12
Cam2Cam;2014;Rotten;0;7;0;8;8;2
Cameraman: The Life And Work Of Jack Cardiff;2011;Fresh;97;91;28;1;29;11
Cameraperson;2016;Certified-Fresh;99;68;104;1;105;26
Camilla;1994;Rotten;40;39;2;3;5;2
Camille Claudel;1988;Fresh;100;88;11;0;11;1
Camille Claudel, 1915;2013;Certified-Fresh;80;48;37;9;46;14
Camino;2016;Rotten;32;20;6;13;19;4
Camp;2003;Fresh;64;68;68;39;107;30
Camp Rock 2: The Final Jam;1900;Fresh;63;55;5;3;8;2
Camp Cold Brook;2020;Rotten;57;39;4;3;7;1
Camp Nowhere;1994;Rotten;18;58;2;9;11;2
Camp Rock;2008;Rotten;45;75;9;11;20;12
Camp X-Ray;2014;Certified-Fresh;75;63;44;15;59;22
Campfire;2004;Fresh;88;75;15;2;17;9
Can We Take a Joke?;2016;Rotten;55;76;11;9;20;5
Can You Keep a Secret?;2019;Rotten;29;38;5;12;17;5
Canadian Bacon;1995;Rotten;14;52;2;12;14;2
Canary (Kanarie);1900;Fresh;100;100;12;0;12;3
The Candidate;1972;Fresh;87;74;27;4;31;7
Candy;2006;Rotten;47;77;36;40;76;29
Candy Corn;1900;Fresh;60;25;3;2;5;0
Candy Jar;2018;Fresh;71;67;5;2;7;0
Candyman;1992;Fresh;75;62;51;17;68;10
Candyman: Farewell to the Flesh;1994;Rotten;28;30;7;18;25;7
Cane River;2020;Fresh;100;38;16;0;16;4
Caniba;2018;Rotten;59;33;19;13;32;7
Cannery Row;1982;Fresh;71;71;5;2;7;1
Cannes Man;1995;Rotten;50;45;4;4;8;0
Cannibal;2014;Fresh;67;35;10;5;15;6
Cannibal Ferox;1981;Rotten;40;44;2;3;5;1
Cannibal Holocaust;1979;Fresh;65;62;11;6;17;2
Cannibal! The Musical (Alferd Packer: The Musical);1996;Fresh;63;82;12;7;19;1
Cannonball Run II;1984;Rotten;13;45;2;14;16;4
Canoa;1975;Fresh;83;88;5;1;6;0
Canopy;2014;Fresh;75;33;18;6;24;6
Can't Buy Me Love;1987;Rotten;48;74;11;12;23;4
Can't Hardly Wait;1998;Rotten;40;63;25;37;62;17
Can't Stand Losing You;2015;Rotten;35;62;6;11;17;9
Can't Stop the Music;1980;Rotten;7;37;1;13;14;3
Can't Stop, Won't Stop: A Bad Boy Story;1900;Rotten;44;44;4;5;9;3
I Can't Think Straight;2008;Rotten;16;62;5;27;32;12
Cantinflas;2014;Rotten;45;67;9;11;20;4
Capernaum (Capharnaum);2018;Certified-Fresh;90;92;156;17;173;36
Capital;2013;Rotten;58;46;19;14;33;18
Capital in the Twenty-First Century;2020;Certified-Fresh;93;78;37;3;40;7
Capitalism: A Love Story;2009;Certified-Fresh;74;74;139;48;187;50
Capone;2020;Rotten;41;25;52;76;128;26
Capricorn One;1978;Fresh;62;57;13;8;21;2
Captain Abu Raed;2007;Fresh;80;79;28;7;35;14
Captain America;;Rotten;7;16;1;14;15;2
Captain America: Civil War;2016;Certified-Fresh;91;89;375;40;414;63
Captain America: The First Avenger;2011;Certified-Fresh;80;74;214;54;268;54
Captain America: The Winter Soldier;2014;Certified-Fresh;90;92;272;30;301;54
Captain Corelli's Mandolin;2001;Rotten;28;50;33;84;117;40
Captain Fantastic;2016;Certified-Fresh;83;85;186;39;225;47
Captain Horatio Hornblower;1951;Fresh;100;77;8;0;8;1
Captain January;1936;Fresh;86;75;6;1;7;0
Captain Kidd;1945;Fresh;100;48;5;0;5;1
Captain Marvel;2019;Certified-Fresh;79;47;411;112;523;53
Captain Phillips;2013;Certified-Fresh;93;89;256;19;274;59
Captain Ron;1992;Rotten;23;52;5;17;22;4
Captain Underpants: The First Epic Movie (Captain Underpants);2017;Certified-Fresh;87;61;117;17;134;32
Captive;2015;Rotten;27;43;14;38;52;17
Captive State;2019;Rotten;43;37;33;44;77;13
Captivity;2007;Rotten;9;23;7;71;78;23
Capture the Flag;1900;Rotten;48;42;12;13;25;4
Capturing the Friedmans;2003;Certified-Fresh;97;89;149;4;153;43
Car Wash;1976;Fresh;88;61;21;3;24;5
Caramel;2008;Certified-Fresh;92;81;73;6;79;31
Carbon Nation;2011;Rotten;40;76;6;9;15;6
Cardboard Boxer;2016;Rotten;38;54;3;5;8;4
The Cardinal;1963;Rotten;50;67;7;7;14;3
The Care Bears Movie;1985;Rotten;50;58;3;3;6;3
Career Opportunities;1991;Rotten;38;37;6;10;16;5
Careful;1993;Fresh;83;81;10;2;12;5
Careful What You Wish For;2016;Rotten;17;61;4;20;24;11
Cargo;2011;Fresh;67;33;4;2;6;3
Cargo;1900;Certified-Fresh;88;65;66;9;75;12
Carlito's Way;1993;Certified-Fresh;81;91;39;9;48;9
Carlito's Way: Rise to Power;2005;Rotten;33;50;2;4;6;2
Carlos;2010;Certified-Fresh;93;85;64;5;69;25
Carmen & Lola (Carmen y Lola);1900;Fresh;89;59;17;2;19;2
Carmen Jones;1954;Fresh;76;78;16;5;21;6
Carnage;2011;Fresh;70;66;138;58;196;57
Carnage Park;2016;Fresh;61;29;14;9;23;9
Carnal Knowledge;1971;Fresh;87;72;26;4;30;6
Carol;2015;Certified-Fresh;94;74;289;18;307;60
Carol Channing: Larger Than Life;2012;Fresh;90;87;28;3;31;14
Carousel;1956;Fresh;83;61;5;1;6;0
The Carpetbaggers;1964;Rotten;33;64;3;6;9;0
Carpool;1996;Rotten;13;39;3;20;23;9
Carrie;2013;Rotten;50;44;92;91;183;41
Carrie;1952;Fresh;83;59;5;1;6;0
Carrie Pilby;2017;Fresh;62;73;16;10;26;9
Carrington;1995;Rotten;54;74;13;11;24;9
Carry On Camping;1969;Rotten;40;78;2;3;5;2
Cars;2006;Certified-Fresh;75;79;151;51;202;47
Cars 2;2011;Rotten;39;49;85;132;217;51
Cars 3;2017;Fresh;70;69;158;69;227;41
Cartel Land;2015;Certified-Fresh;90;82;90;10;99;33
Carter & June;2018;Rotten;13;33;1;7;8;2
Cas & Dylan;2015;Rotten;31;62;4;9;13;6
Casa de los Babys;2003;Rotten;58;50;61;45;106;30
Casa de mi padre;2012;Rotten;42;35;47;65;112;40
Casanova Variations;1900;Rotten;40;40;2;3;5;0
Case 39;2010;Rotten;21;39;16;60;76;15
Casey's Shadow;1978;Fresh;78;73;7;2;9;2
Cash;2007;Rotten;20;38;1;4;5;2
Cashback;2007;Rotten;46;77;24;28;52;20
Casino Jack;2010;Rotten;40;34;39;59;98;29
Casino Jack And The United States Of Money;2010;Certified-Fresh;82;80;54;12;66;25
Casino Royale;2006;Certified-Fresh;95;89;243;14;257;57
Casper;1995;Rotten;51;49;21;20;41;11
Casper: A Spirited Beginning;1997;Rotten;0;41;0;5;5;0
Cassadaga;2013;Rotten;18;24;2;9;11;5
Cassandra's Dream;2007;Rotten;45;49;53;64;117;36
Cast Away;2000;Certified-Fresh;88;84;138;18;156;37
Casting About;2007;Fresh;63;0;10;6;16;8
Casting By;2013;Fresh;94;79;15;1;16;5
Castle Freak;1900;Fresh;63;45;5;3;8;0
Castle in the Ground;1900;Fresh;65;70;24;13;37;7
Castle in the Sky;1989;;;91;25;1;;3
Castle Keep;1969;Rotten;38;50;3;5;8;4
Casual Sex?;1988;Rotten;33;29;4;8;12;6
Casualties of War;1989;Certified-Fresh;83;75;38;8;46;8
Cat Ballou;1965;Fresh;88;74;23;3;26;0
Cat Chaser;1989;Rotten;40;15;2;3;5;0
Dr. Seuss' The Cat in the Hat;2003;Rotten;9;51;15;146;161;40
Cat Run;2011;Rotten;20;33;3;12;15;8
Catch-22;1970;Fresh;79;76;23;6;29;4
Catch a Fire;2006;Certified-Fresh;75;71;109;37;146;44
Catch and Release;2007;Rotten;22;55;30;104;134;38
Catch Hell;2014;Rotten;0;32;0;6;6;2
Catch Me If You Can;2002;Certified-Fresh;96;89;193;9;202;46
Catch That Kid;2004;Rotten;13;47;11;75;86;28
Catchfire (Backtrack);;Rotten;50;25;4;4;8;0
Catching Feelings;2018;Fresh;100;59;7;0;7;0
Catching Out;2003;Fresh;78;;7;2;9;4
Caterina in the Big City;2003;Fresh;89;77;34;4;38;19
Caterpillar;2011;Fresh;85;53;11;2;13;5
Catfight;2017;Fresh;73;43;44;16;60;18
Catfish;2010;Certified-Fresh;80;71;123;31;154;35
Cats;2019;Rotten;20;53;63;256;319;48
Cats & Dogs;2001;Rotten;54;32;63;54;117;33
Cats & Dogs: The Revenge of Kitty Galore;2010;Rotten;13;38;13;86;99;29
Cats Don't Dance;1997;Fresh;74;80;17;6;23;9
Stephen King's 'Cat's Eye';1985;Fresh;67;50;18;9;27;5
The Cat's Meow;2001;Certified-Fresh;75;51;94;32;126;37
Cats: The Musical;1998;Rotten;20;80;1;4;5;0
Catwalk: Tales From The Cat Show Circuit;1900;Fresh;80;75;4;1;5;2
Catwoman;2004;Rotten;9;18;17;181;198;48
Caught;2018;Fresh;67;29;4;2;6;4
Caught Inside;1900;Fresh;86;35;6;1;7;0
Caught Up;1998;Rotten;0;55;0;7;7;3
Cautiva;2006;Fresh;71;81;10;4;14;6
Cavalcade;1933;Rotten;59;26;17;12;29;10
The Cave;2005;Rotten;12;28;13;98;111;25
Cave of Forgotten Dreams;2011;Certified-Fresh;96;73;129;5;134;40
The Cave of the Yellow Dog (Die Hohle des gelben Hundes);2005;Certified-Fresh;90;88;45;5;50;20
Caveman;1981;Rotten;26;54;5;14;19;2
Cavemen;2014;Rotten;14;58;2;12;14;6
CB4;1993;Rotten;57;62;13;10;23;9
CBGB;2013;Rotten;7;42;3;41;44;14
Cecil B. Demented;2000;Rotten;53;67;43;38;81;25
Cedar Rapids;2011;Certified-Fresh;86;59;144;23;167;48
Celeste and Jesse Forever;2012;Certified-Fresh;71;62;101;41;142;46
Celine: Through The Eyes Of The World;2010;Rotten;33;78;2;4;6;3
Cell;2016;Rotten;11;17;6;48;54;14
Cell 213;2011;Rotten;17;20;1;5;6;2
Cellmates;2012;Rotten;47;63;7;8;15;3
Cellular;2004;Rotten;55;59;83;67;150;36
The Celluloid Closet;1996;Fresh;97;89;31;1;32;9
Celtic Pride;1996;Rotten;9;31;2;21;23;7
The Cemetery Club;1993;Rotten;57;32;4;3;7;3
Cemetery Junction;2010;Rotten;55;63;22;18;40;8
The Center of the World;2001;Rotten;34;41;28;54;82;25
Center Stage;2000;Rotten;42;82;34;47;81;23
Centigrade;2020;Rotten;40;41;17;26;43;2
Central Station (Central do Brasil);1998;Certified-Fresh;94;95;45;3;48;12
Central Intelligence;2016;Fresh;71;61;133;54;187;43
Centurion;2010;Fresh;61;43;68;43;111;29
Ceremony;2011;Rotten;39;31;14;22;36;12
Certain Women;2016;Certified-Fresh;91;51;172;16;188;40
Certified Copy (Copie Conforme);2011;Certified-Fresh;89;70;119;15;134;34
Cesar Chavez;2014;Rotten;38;60;28;45;73;27
Chain Letter;2010;Rotten;33;45;5;10;15;3
Chain of Death;1900;Fresh;60;;3;2;5;1
Chained;1900;Fresh;68;53;13;6;19;3
Chairman of the Board;1997;Rotten;13;21;0;0;8;0
Chak de! India;2007;Fresh;94;92;15;1;16;5
Chalet Girl;2011;Certified-Fresh;77;53;33;10;43;13
Chalk;2007;Certified-Fresh;80;61;35;9;44;17
The Chamber;1996;Rotten;12;39;3;22;25;8
Chameleon;1900;Fresh;100;80;11;0;11;0
Champs;2015;Fresh;67;95;18;9;27;9
Chan Is Missing;1982;Fresh;93;76;25;2;27;8
Chances Are;1989;Fresh;67;65;20;10;30;7
Chandni Chowk To China;2009;Rotten;42;31;25;34;59;30
Change in the Air;2018;Rotten;11;50;1;8;9;3
Changeland;2019;Fresh;63;58;5;3;8;2
The Changeling;1980;Fresh;83;79;19;4;23;3
Changing Lanes;2002;Certified-Fresh;77;53;116;35;151;34
Changing the Game;2012;Fresh;83;78;5;1;6;1
Chaos Theory;2008;Rotten;31;58;18;41;59;24
Chaplin;1992;Rotten;59;81;30;21;51;11
Chappaquiddick;2018;Certified-Fresh;81;68;114;27;141;34
Chappie;2015;Rotten;33;56;74;153;227;49
Charge of the Light Brigade;1936;Fresh;71;59;5;2;7;0
Chariots of Fire;1981;Certified-Fresh;82;80;60;13;73;19
Charley Varrick;1973;Fresh;83;82;10;2;12;0
Charlie and the Chocolate Factory;2005;Certified-Fresh;83;51;191;40;231;49
Charlie Bartlett;2007;Rotten;57;71;74;56;130;33
A Charlie Brown Christmas;1965;;;;15;1;;1
A Charlie Brown Thanksgiving;2003;Fresh;100;75;6;0;6;2
Charlie Casanova;1900;Rotten;13;41;1;7;8;3
Charlie Chan and the Curse of the Dragon Queen;1981;Rotten;33;32;2;4;6;0
Charlie Countryman;2013;Rotten;27;49;18;48;66;21
Charlie Says;2019;Rotten;59;70;43;30;73;16
Charlie St. Cloud;2010;Rotten;28;60;35;90;125;39
Charlie Wilson's War;2007;Certified-Fresh;82;73;165;36;201;50
Charlie's Angels;2000;Fresh;68;45;100;46;146;37
Charlie's Angels;2019;Rotten;52;78;119;108;227;34
Charlie's Angels - Full Throttle;2003;Rotten;42;40;78;108;186;44
Charlotte Gray;2002;Rotten;33;62;29;60;89;33
The Look;2011;Fresh;84;52;16;3;19;11
Charlotte's Web;2006;Certified-Fresh;78;62;116;32;148;46
Charm City;2018;Fresh;100;100;16;0;16;5
Charulata;1964;Fresh;93;91;26;2;28;10
Chasers;1994;Rotten;33;21;2;4;6;0
Chasing Amy;1997;Certified-Fresh;87;83;74;11;85;29
Chasing Coral;2017;Fresh;100;89;31;0;31;14
Chasing Ice;2012;Certified-Fresh;96;85;69;3;72;26
Chasing Liberty;2004;Rotten;18;60;21;96;117;35
Chasing Madoff;2011;Rotten;46;43;19;22;41;19
Chasing Mavericks;2012;Rotten;32;70;26;55;81;27
Chasing Papi;2003;Rotten;14;40;7;42;49;21
Chasing the Dragon;2017;Rotten;57;72;4;3;7;1
Chasing Trane: The John Coltrane Documentary;2017;Certified-Fresh;76;75;32;10;42;15
Chastity Bites;2013;Fresh;100;51;5;0;5;0
Chatroom;1900;Rotten;9;35;2;21;23;8
Chattahoochee;1989;Rotten;14;51;1;6;7;3
Chavela;2017;Fresh;95;88;35;2;37;13
Che: Part Two (Guerrilla);2008;Certified-Fresh;79;66;42;11;53;12
The Cheap Detective;1978;Rotten;47;58;7;8;15;2
Cheap Thrills;2014;Certified-Fresh;88;69;87;12;99;27
Cheaper by the Dozen;2003;Rotten;24;56;29;90;119;33
Cheaper by the Dozen;1950;Fresh;80;66;4;1;5;1
Cheaper by the Dozen 2;2005;Rotten;6;57;6;88;94;31
Checking Out;2005;Rotten;38;58;3;5;8;5
Cheech and Chong's Nice Dreams;1981;Rotten;43;68;3;4;7;0
Cheerful Weather For The Wedding;2012;Rotten;37;27;11;19;30;11
Cheetah;1989;Rotten;50;57;4;4;8;1
The Cheetah Girls;2003;Fresh;71;49;5;2;7;2
Chef;2014;Certified-Fresh;87;85;165;24;189;47
Chef Flynn;2018;Fresh;75;69;21;7;28;8
Chelsea on the Rocks;2009;Fresh;71;44;20;8;28;13
Chelsea Peretti: One of the Greats;1900;Fresh;100;;7;0;7;4
Chelsea Walls;2001;Rotten;26;40;12;35;47;16
Chely Wright: Wish Me Away;2012;Fresh;92;85;12;1;13;7
Chennai Express;2013;Rotten;50;53;8;8;16;5
Cheri;2009;Rotten;51;39;70;68;138;46
Cherish;2002;Rotten;51;55;42;41;83;29
Chernobyl Diaries;2012;Rotten;19;28;17;72;89;19
Cherry;2010;Fresh;64;67;7;4;11;5
Cherry 2000;1988;Rotten;38;41;8;13;21;2
Cherry Tree;2016;Rotten;8;21;1;11;12;1
Cherry Tree Lane;1900;Fresh;61;25;17;11;28;14
Cheyenne Autumn;1964;Rotten;57;47;8;6;14;4
Chi-Raq;2015;Certified-Fresh;82;49;120;26;146;42
Chi-Town;1900;Fresh;100;86;6;0;6;3
Chicago;2002;Certified-Fresh;86;83;220;37;257;55
Chicken Little;2005;Rotten;37;47;60;104;164;41
Chicken People;2016;Fresh;100;63;20;0;20;5
Chicken Run;2000;Certified-Fresh;97;64;166;5;171;43
Chicken with Plums;2012;Certified-Fresh;74;71;51;18;69;24
Chico & Rita;2012;Certified-Fresh;87;77;62;9;71;25
Child 44;2015;Rotten;27;41;22;61;83;22
Child Of God;2014;Rotten;42;26;21;29;50;26
Children of a Lesser God;1986;Fresh;82;79;27;6;33;8
Children of Heaven (Bacheha-Ye aseman);1999;Fresh;83;96;25;5;30;7
The Children of Huang Shi;2008;Rotten;31;66;24;54;78;28
Children Of Invention;2010;Fresh;79;60;11;3;14;9
Children of Love;2003;Fresh;86;33;6;1;7;4
Children of Men;2006;Certified-Fresh;92;85;231;20;251;55
Children of Paradise (Les Enfants du Paradis);1946;Certified-Fresh;98;96;39;1;40;13
Children of the Corn 666: Isaac's Return;1999;Rotten;0;31;0;5;5;0
Children of the Corn II: The Final Sacrifice;1993;Rotten;22;20;2;7;9;1
Children of the Corn V: Fields of Terror;1998;Rotten;0;22;0;6;6;0
Children of the Revolution;1997;Fresh;80;71;16;4;20;9
Children of the Sea (Kaiju no Kodomo);2020;Fresh;61;62;17;11;28;4
Children Shouldn't Play with Dead Things;1973;Rotten;42;39;5;7;12;0
Children Underground;2001;Fresh;94;92;16;1;17;7
The Children's Hour;1961;Fresh;88;84;7;1;8;0
Child's Play;1988;Fresh;71;63;35;14;49;10
Child's Play 2;;Rotten;44;47;7;9;16;2
Child's Play;2019;Fresh;63;57;128;74;202;26
Child's Play 3;1991;Rotten;29;33;4;10;14;2
Child's Pose;2014;Certified-Fresh;92;76;78;7;85;32
Chill Factor;1999;Rotten;10;30;8;69;77;27
Chillerama;2011;Rotten;33;44;2;4;6;0
Chimera Strain;2019;Fresh;60;93;3;2;5;1
Chimes at Midnight;1965;Certified-Fresh;98;85;47;1;48;17
China Heavyweight;2012;Fresh;82;60;18;4;22;14
China Moon;1994;Rotten;40;37;4;6;10;1
China Seas;1935;Fresh;80;72;4;1;5;0
The China Syndrome;1979;Fresh;85;81;29;5;34;5
Chinatown;1974;Certified-Fresh;99;93;74;1;75;15
Chinese Box;1998;Fresh;64;54;14;8;22;5
Fist of Fury (Jing wu men);1972;Fresh;81;83;13;3;16;2
Chinese Puzzle (Casse-tete chinois);2014;Certified-Fresh;79;67;52;14;66;24
Chinese Zodiac;2013;Rotten;25;45;2;6;8;4
Chipmunk Adventure;1987;Fresh;75;87;6;2;8;4
CHIPS;2017;Rotten;18;45;20;91;111;25
Chisum;1970;Fresh;83;74;5;1;6;0
Chitty Chitty Bang Bang;1968;Fresh;67;71;18;9;27;3
Chloe in the Afternoon (L'amour l'apres-midi);1972;Fresh;91;89;20;2;22;4
Chlorine;2014;Rotten;8;33;1;12;13;6
Chocolat;2000;Fresh;62;83;73;44;117;34
Choke;2008;Rotten;55;52;79;64;143;39
Choking Man;2007;Rotten;50;38;17;17;34;19
Chooch;2004;Rotten;0;50;0;6;6;4
Choose Connor;2008;Rotten;43;47;6;8;14;7
Chopper;2001;Fresh;72;89;50;19;69;21
Chopping Mall (Killbots);1986;Rotten;50;39;5;5;10;0
Chopsticks;1900;Rotten;17;78;1;5;6;0
The Chorus (Les Choristes);2005;Fresh;69;92;75;34;109;32
A Chorus Line;1985;Rotten;40;62;14;21;35;12
Chris Rock: Kill the Messenger - London, New York, Johannesburg;2008;Fresh;100;;5;0;5;0
Chris & Don;2007;Fresh;94;85;34;2;36;19
Chris Rock: Bigger & Blacker;1999;Fresh;86;89;6;1;7;6
Chris Rock: Tamborine;1900;Certified-Fresh;100;36;23;0;23;12
Christine;1983;Fresh;69;64;20;9;29;6
Christine;2016;Certified-Fresh;88;71;110;15;124;36
Christmas Carol - The Movie;1900;Rotten;13;48;1;7;8;1
Christmas Eve;2015;Rotten;0;53;0;10;10;3
Christmas Evil;1980;Fresh;75;32;6;2;8;0
Christmas Inheritance;2017;Rotten;43;35;3;4;7;1
Christmas With the Kranks;2004;Rotten;5;38;7;126;133;35
Christopher Robin;2018;Fresh;73;83;196;74;270;46
Chronic;2016;Certified-Fresh;77;57;46;14;60;15
Chronically Metropolitan;2017;Rotten;40;38;4;6;10;5
Chronicle;2012;Certified-Fresh;85;71;158;27;185;40
The Chronicles of Narnia: The Lion, The Witch and The Wardrobe;2005;Certified-Fresh;76;61;166;52;218;48
The Chronicles of Narnia: Prince Caspian;2008;Fresh;67;73;128;64;192;44
The Chronicles of Narnia: The Voyage of the Dawn Treader;2010;Rotten;50;58;84;83;167;42
The Chronicles of Riddick;2004;Rotten;29;65;49;118;167;36
Chroniques sexuelles d'une famille d'aujourd'hui (Sexual Chronicles of a French Family);2012;Rotten;0;27;0;5;5;2
Chrystal;2004;Fresh;80;57;16;4;20;6
Chuck & Buck;2000;Certified-Fresh;84;66;74;14;88;33
Chuck Berry: Hail! Hail! Rock 'n' Roll;1987;Fresh;88;95;15;2;17;8
Chuck Close: A Portrait in Progress;1997;Fresh;100;82;6;0;6;5
C.H.U.D. (Chud);1984;Rotten;29;32;4;10;14;0
The Chumscrubber;2005;Rotten;37;76;22;38;60;12
Church Ball;2006;Rotten;17;39;2;10;12;2
Churchill;2017;Rotten;49;55;57;59;116;28
Chutney Popcorn;1999;Fresh;83;50;10;2;12;5
Ciao;2008;Rotten;25;45;3;9;12;9
Ciao! Manhattan;1972;Fresh;64;64;7;4;11;4
Cidade dos Homens (City of Men);2007;Certified-Fresh;75;78;61;20;81;27
The Cider House Rules;1999;Fresh;71;77;80;32;112;26
The Cincinnati Kid;1965;Fresh;82;78;18;4;22;5
Cinderella;1950;Fresh;97;80;34;1;35;7
Cinderella;2015;Certified-Fresh;84;78;206;41;246;54
Cinderella II: Dreams Come True;2002;Rotten;11;32;1;8;9;0
Cinderella III: A Twist in Time;2007;Fresh;75;61;6;2;8;0
Cinderella Liberty;1973;Fresh;63;62;5;3;8;1
Cinderella Man;2005;Certified-Fresh;80;91;171;43;214;48
A Cinderella Story;2004;Rotten;12;53;12;92;104;35
Cinema Paradiso (Nuovo Cinema Paradiso);1988;Certified-Fresh;90;97;70;8;78;22
Cinema Verite;1900;Fresh;61;60;25;16;41;26
Cinemania;2002;Fresh;86;65;32;5;37;11
Circle;1900;Rotten;50;42;3;3;6;1
Circle of Iron;1979;Rotten;38;59;3;4;8;0
Circo;2011;Fresh;92;80;24;2;26;11
Circumstance;2011;Certified-Fresh;86;68;68;11;79;34
Circus of Books;1900;Certified-Fresh;98;82;54;1;55;15
Cirque Du Soleil: Worlds Away;2012;Rotten;45;95;21;26;47;19
Citadel;2012;Rotten;56;32;25;20;45;14
Citizen Duane;2006;Rotten;33;38;2;4;6;2
Citizen Jane: Battle for the City;2017;Certified-Fresh;95;67;54;3;57;19
Citizen Kane;1941;Certified-Fresh;100;90;93;0;93;23
Citizen Koch;2014;Rotten;54;55;19;16;35;14
Citizen Ruth;1996;Fresh;81;74;21;5;26;6
Citizen Soldier;2016;Fresh;86;67;6;1;7;4
Citizen Verdict;2005;Rotten;20;22;1;4;5;2
Citizen X;1995;Fresh;88;86;7;1;8;0
Citizenfour;2014;Certified-Fresh;96;87;140;6;146;46
City by the Sea;2002;Rotten;48;40;69;76;145;36
City for Conquest;1940;Fresh;80;76;4;1;5;2
City Hall;1996;Rotten;56;37;14;11;25;9
City Heat;1984;Rotten;22;24;4;14;18;6
City Hunter (Sing si lip yan);1993;Rotten;50;61;4;4;8;0
City Island;2010;Certified-Fresh;82;79;84;19;103;37
City Lights;1931;Certified-Fresh;98;96;51;1;52;13
City of Angels;1998;Rotten;58;82;35;25;60;17
City of Ember;2008;Rotten;53;46;68;60;128;38
City of Ghosts;2003;Rotten;47;45;31;35;66;24
Cidade de Deus (City of God);2003;Certified-Fresh;91;97;147;15;162;39
City Of Gold;2016;Certified-Fresh;90;80;56;6;62;24
City of Industry;1997;Rotten;43;38;6;8;14;7
City of Joy;1992;Rotten;53;75;9;8;17;3
City of Joy;2018;Fresh;100;60;8;0;8;1
City of Life and Death;2011;Certified-Fresh;92;86;49;4;53;19
The City of Lost Children (La Cite des Enfants Perdus);1995;Certified-Fresh;79;90;44;12;56;16
Paura nella citta dei morti viventi (City Of The Living Dead) (The Gates of Hell);1980;Rotten;54;56;7;6;13;0
City of Women (La citta delle donne);1981;Fresh;72;75;13;6;18;7
The City of Your Final Destination;2010;Rotten;39;38;22;34;56;20
City Slickers;1991;Certified-Fresh;90;64;38;4;42;7
City Slickers 2 - The Legend of Curly's Gold;1994;Rotten;17;31;4;19;23;4
Civic Duty;2006;Rotten;56;33;32;25;57;25
A Civil Action;1998;Fresh;61;55;43;27;70;18
Civil Brand;2003;Rotten;16;81;3;16;19;9
CJ7;2008;Rotten;49;52;40;41;81;27
The Claim;2000;Fresh;62;49;53;32;85;30
Claire in Motion;2017;Fresh;63;30;12;7;19;7
Claire of the Moon;2012;Rotten;13;45;1;7;8;4
Claire's Camera (La camera de Claire);2018;Certified-Fresh;88;59;43;6;49;12
Clambake;1967;Rotten;20;62;1;4;5;1
The Clan of the Cave Bear;1986;Rotten;10;47;1;9;10;2
Clara;2019;Rotten;50;87;12;12;24;4
Clara's Ghost;2018;Fresh;74;36;23;8;31;8
Clash by Night;1952;Fresh;73;70;11;4;15;4
Clash of the Titans;1981;Fresh;68;70;30;14;44;5
Wrath of the Titans;2012;Rotten;27;49;46;127;173;36
Clash of the Titans;2010;Rotten;27;40;72;192;264;52
Class;1983;Rotten;29;50;4;10;14;2
Class of 1984;1982;Fresh;75;66;15;5;20;1
Class of 1999;;Fresh;67;49;4;2;6;3
Class of Nuke 'Em High;1986;Rotten;20;49;1;4;5;0
Class Rank;2018;Fresh;86;67;12;2;14;2
Clay Pigeons;1998;Fresh;62;67;33;20;53;12
Clean and Sober;1988;Fresh;62;62;8;5;13;1
Clean, Shaven;1995;Fresh;90;83;9;1;10;3
Cleaner;2008;Rotten;17;40;2;10;12;4
Cleanskin;1900;Rotten;53;65;9;8;17;6
Clear and Present Danger;1994;Certified-Fresh;80;74;35;9;44;10
Clear History;1900;Fresh;61;54;17;11;28;13
The Clearing;2004;Rotten;43;32;57;77;134;35
Clemency;2019;Certified-Fresh;92;65;134;11;145;35
Cleopatra Jones;1900;Fresh;79;45;11;3;14;2
Cleopatra's Second Husband;1998;Rotten;52;12;13;12;25;6
Clerks;1994;Certified-Fresh;89;89;51;6;57;16
Clerks II;2006;Fresh;64;84;106;60;166;40
Click;2006;Rotten;34;66;59;115;174;42
The Client;1994;Fresh;78;69;28;8;36;8
Clifford;1994;Rotten;13;67;4;27;31;9
Clifford's Really Big Movie;2004;Rotten;53;35;17;15;32;12
Clip;2013;Rotten;50;47;5;5;10;3
Cloak and Dagger;1984;Fresh;64;56;7;4;11;3
The Clock;1945;Fresh;100;82;11;0;11;2
Clockers;1995;Fresh;71;74;41;17;58;17
Clockstoppers;2002;Rotten;29;30;25;60;85;22
Clockwise;1986;Fresh;80;65;4;1;5;1
A Clockwork Orange;1971;Certified-Fresh;88;93;56;8;64;14
Star Wars: The Clone Wars;2008;Rotten;18;39;31;140;171;40
Close;1900;Rotten;37;35;13;22;35;4
Close Encounters of the Fifth Kind: Contact has Begun;1900;Rotten;17;79;1;5;6;3
Close Encounters of the Third Kind;1977;Certified-Fresh;94;85;61;4;65;14
Close Enemies (Freres Ennemis);1900;Rotten;58;53;7;5;12;2
Close Range;2015;Fresh;86;27;6;1;7;2
Close-up (Nema-ye Nazdik);1999;Fresh;88;89;15;2;17;5
Closed Circuit;2013;Rotten;43;31;57;77;134;38
Ostre Sledovane Vlaky (Closely Watched Trains);1966;Fresh;100;87;17;0;17;1
Closer;2004;Fresh;68;81;144;67;211;49
Closer To The Moon;2015;Rotten;46;55;6;7;13;4
The Closet (Le Placard);2001;Certified-Fresh;85;78;68;12;80;26
Closet Monster;2016;Fresh;81;72;25;6;31;11
Cloud Atlas;2012;Fresh;67;66;188;94;282;57
Cloudburst;2012;Fresh;100;77;9;0;9;2
Clouds of Sils Maria;2015;Certified-Fresh;90;65;156;17;173;50
Cloudy with a Chance of Meatballs 2;2013;Fresh;70;66;85;36;121;30
Clover;2020;Rotten;28;60;5;13;18;6
Cloverfield;2008;Certified-Fresh;77;68;162;48;210;39
Clown;2016;Rotten;44;37;11;14;25;4
Clowntergeist;2017;Rotten;17;29;1;5;6;0
ClownTown;2016;Rotten;9;30;1;10;11;3
Club Dread;2004;Rotten;29;44;29;72;101;28
Club Life;2015;Rotten;20;17;1;4;5;3
Club Paradise;1986;Rotten;11;35;3;25;28;8
Clue;1985;Fresh;65;86;20;11;31;6
Clueless;1995;Certified-Fresh;82;76;58;13;71;15
Coach Carter;2005;Fresh;64;85;96;54;150;39
Coachella;2006;Fresh;88;75;7;1;8;3
Coal Miner's Daughter;1980;Fresh;86;86;19;3;22;7
Cobb;1994;Fresh;65;59;31;17;48;18
Cobra;1986;Rotten;14;42;3;18;21;5
Cobra Verde;1987;Fresh;82;76;14;3;17;5
The Cockettes;2002;Certified-Fresh;91;83;39;4;43;14
Cockneys vs Zombies;2013;Certified-Fresh;76;45;38;12;50;13
Cocktail;1988;Rotten;7;58;3;41;44;12
Cocktail;2012;Fresh;60;44;3;2;5;1
Coco;2017;Certified-Fresh;97;94;333;10;342;51
Coco Before Chanel;2009;Fresh;64;57;86;49;135;48
Coco Chanel & Igor Stravinsky;2010;Rotten;53;43;49;44;93;27
Cocoon: The Return;1988;Rotten;33;35;4;8;12;1
Coda;2020;Rotten;50;57;5;5;10;4
Thick as Thieves (The Code);2009;Rotten;20;33;1;4;5;1
Code 46;2004;Rotten;51;58;52;50;102;34
Code 8;2019;Fresh;79;63;15;4;19;3
Code Black;2014;Certified-Fresh;88;80;37;5;42;19
Code Name: Geronimo;1900;Rotten;36;28;4;7;11;4
Code Name: The Cleaner;2007;Rotten;4;38;3;81;84;26
Code of Silence;1985;Fresh;63;51;12;7;19;5
Code Unknown (Code inconnu: Recit incomplet de divers voyages);2000;Fresh;75;79;38;13;51;17
Codegirl;1900;Fresh;60;71;3;2;5;3
Coffee and Cigarettes;2004;Fresh;64;75;81;45;126;36
Coffee & Kareem;1900;Rotten;20;30;14;55;69;17
Coffin Rock;2009;Fresh;70;30;14;6;20;6
Coffy;1973;Fresh;79;76;19;5;24;5
C.O.G.;2013;Fresh;69;35;25;11;36;15
Coherence;2014;Certified-Fresh;88;81;77;11;88;23
Cold Brook;2019;Fresh;80;83;8;2;10;3
Cold Comes The Night;2014;Rotten;44;29;19;24;43;16
Cold Creek Manor;2003;Rotten;12;23;13;98;111;28
Cold Fish;2011;Fresh;74;75;17;6;23;6
Cold in July;2014;Certified-Fresh;83;67;96;19;115;38
Cold Moon;2017;Fresh;70;34;7;3;10;2
Cold Mountain;2003;Fresh;71;77;163;68;231;48
Cold November;2018;Fresh;100;63;6;0;6;0
Cold Pursuit;2019;Fresh;69;49;127;56;183;38
Cold Skin;2018;Rotten;48;56;13;14;27;2
Cold Souls;2009;Certified-Fresh;75;54;94;31;125;41
Cold Sweat (Sudor frio);1900;Fresh;75;42;9;3;12;0
Cold Turkey;1971;Fresh;60;65;9;6;15;5
Cold Turkey;2013;Rotten;20;37;3;12;15;9
Cold War 2;2016;Rotten;56;57;5;4;9;5
Cold Weather;2011;Certified-Fresh;78;52;49;14;63;23
Coldwater;2014;Fresh;64;60;14;8;22;10
Colette;2018;Certified-Fresh;87;69;188;28;216;42
Collaborator;2012;Fresh;73;61;19;7;26;10
Collateral;2004;Certified-Fresh;86;84;202;32;234;48
Collateral Beauty;2016;Rotten;14;64;25;159;184;44
College Road Trip;2008;Rotten;12;50;9;65;74;27
Collide;2017;Rotten;23;34;9;31;40;6
Colliding Dreams;2016;Fresh;94;62;16;1;17;8
Colma: The Musical;2006;Fresh;90;69;27;3;30;10
Colombiana;2011;Rotten;28;67;29;74;103;26
Colonia;2016;Rotten;26;61;12;35;47;11
The Color of Lies (Au coeur du mensonge);1999;Fresh;100;60;6;0;6;1
Color of Freedom;2007;Rotten;44;;8;10;18;8
The Color of Friendship;2000;Fresh;100;76;6;0;6;4
The Color of Money;1986;Certified-Fresh;89;73;42;5;47;12
Color of Night;1994;Rotten;22;30;11;39;50;14
The Color of Paradise;2000;Fresh;87;96;27;4;31;6
Color Out of Space;2020;Certified-Fresh;86;82;168;27;195;21
The Color Purple;1985;Fresh;81;94;25;6;31;2
Colossal;2017;Certified-Fresh;81;59;210;49;259;47
Color Me Kubrick;2007;Rotten;51;42;31;30;61;26
The Comancheros;1961;Fresh;100;75;6;0;6;0
Combat Shock (Fuerza en combate);1986;Rotten;40;65;2;3;5;0
Come And Find Me;2016;Fresh;62;33;8;5;13;5
Come As You Are;2020;Certified-Fresh;94;79;51;3;54;10
Come Back, Little Sheba;1952;Fresh;86;80;6;1;7;1
Come Back To Me;2014;Rotten;17;36;1;5;6;5
Come Out And Play;2013;Rotten;48;23;10;11;21;5
Come See the Paradise;;Fresh;64;73;7;4;11;4
Come Sunday;1900;Fresh;68;60;23;11;34;11
Come to Daddy;2020;Certified-Fresh;87;75;87;13;100;15
Come Undone (Cosa voglio di piu);2010;Fresh;86;50;6;1;7;4
Come Undone;2000;Fresh;77;67;24;7;31;11
Come What May;2016;Rotten;43;56;9;12;21;9
The Comebacks;2007;Rotten;9;33;3;30;33;10
Comedian;2002;Certified-Fresh;77;69;69;21;90;28
The Comedians;1967;Rotten;27;48;3;8;11;5
The Comedians of Comedy;2005;Rotten;44;83;4;5;9;3
Comes A Bright Day;1900;Rotten;38;34;3;5;8;3
Comes a Horseman;1978;Fresh;70;54;7;3;10;1
Comet;2014;Rotten;42;52;13;18;31;15
Comic Book Confidential;1999;Fresh;75;62;6;2;8;0
Comic Book - The Movie;2004;Rotten;40;39;2;3;5;0
Comic-Con: Episode IV - A Fan's Hope;2012;Certified-Fresh;82;79;46;10;56;19
Coming Through The Rye;2016;Fresh;70;65;16;7;23;12
Coming to America;1988;Fresh;65;85;28;15;43;8
Coming to My Senses;1900;Fresh;80;57;4;1;5;0
Coming Up Roses;2012;Rotten;17;71;1;5;6;6
Commandments;1997;Rotten;24;36;4;13;17;7
Commitment;2013;Rotten;40;58;4;6;10;5
Commune;2006;Fresh;95;46;19;1;20;12
Compadres;2016;Rotten;38;51;6;10;16;3
Company Man;2001;Rotten;14;44;9;54;63;23
The Company of Wolves;1984;Fresh;80;73;12;3;15;1
A Complete History of My Sexual Failures;1900;Rotten;56;56;5;4;9;3
Complete Unknown;2016;Rotten;52;24;39;36;75;25
Compliance;2012;Certified-Fresh;89;60;127;16;143;45
Compulsion;1959;Fresh;100;86;10;0;10;0
Computer Chess;2013;Certified-Fresh;88;53;72;10;81;30
The Computer Wore Tennis Shoes;1900;Rotten;50;40;3;3;6;0
Comradeship (Kameradschaft);1931;Fresh;89;79;8;1;9;1
Con Artist;2010;Fresh;100;85;8;0;8;3
Con Air;1997;Rotten;56;75;37;29;66;17
Conan O'Brien Can't Stop;2011;Certified-Fresh;82;68;62;14;76;29
Conan the Barbarian;1982;Fresh;64;74;23;13;36;5
Conan the Barbarian;2011;Rotten;25;30;38;113;151;36
Conan the Destroyer;1984;Rotten;25;38;6;18;24;1
Concerning Violence;2014;Fresh;90;71;28;3;31;12
Concussion;2013;Certified-Fresh;75;58;44;15;59;26
Concussion;2015;Rotten;59;74;119;83;201;39
The Condemned;2007;Rotten;15;58;15;86;101;30
Condorman;1981;Rotten;23;65;3;10;13;2
Coneheads;1993;Rotten;35;37;11;20;31;9
Confessions of a Burning Man;2003;Rotten;30;60;6;14;20;7
Confessions of a Dangerous Mind;2003;Certified-Fresh;79;75;130;35;165;37
Confessions of a Shopaholic;2009;Rotten;25;49;42;125;167;51
Confessions of a Superhero;2007;Fresh;100;73;12;0;12;6
Confessions of a Teenage Drama Queen;2004;Rotten;14;35;13;81;94;27
Confetti;2006;Rotten;57;48;43;33;76;29
Confidence;2003;Fresh;69;70;108;49;157;41
Confirmation;2016;Certified-Fresh;83;74;39;8;47;27
Confucius;2010;Rotten;45;38;5;6;11;4
Congo;1995;Rotten;22;29;11;40;51;14
Congo: White King, Red Rubber, Black Death;2003;Fresh;100;80;11;0;11;4
Connected: An Autoblogography About Love, Death & Technology;2011;Rotten;36;46;5;9;14;8
Conor McGregor: Notorious;1900;Rotten;50;72;7;7;14;4
Conquest Of The Planet Of The Apes;1972;Rotten;50;46;11;11;22;4
Conspiracy Theory;1997;Rotten;57;64;25;19;44;15
The Constant Gardener;2005;Certified-Fresh;83;82;161;32;193;43
Constantine;2005;Rotten;46;72;106;124;230;47
Constantine's Sword;2007;Fresh;87;77;27;4;31;12
Contagion;2011;Certified-Fresh;85;63;231;42;273;57
Contamination;1980;Rotten;40;29;2;3;5;0
Conte d'hiver (A Tale of Winter);1992;Fresh;95;80;19;1;20;10
Contempt;1964;Certified-Fresh;93;85;52;4;56;19
Continental Divide;1981;Fresh;70;53;7;3;10;2
Contraband;2012;Rotten;52;57;84;79;163;42
Contract Killer;2002;Fresh;80;53;4;1;5;0
Contract to Kill;2016;Rotten;0;18;0;5;5;5
Contracted;2013;Rotten;53;29;9;8;17;4
Contracted: Phase II;2015;Rotten;38;14;5;8;13;7
Control;2007;Certified-Fresh;88;89;102;14;116;42
Conventioneers;2005;Fresh;75;59;9;3;12;7
The Conversation;1974;Certified-Fresh;96;90;53;2;55;8
Conviction;2010;Fresh;67;70;128;62;190;46
Coogan's Bluff;1968;Fresh;94;50;17;1;18;5
Cook Off!;2017;Rotten;25;64;2;6;8;3
The Cook, the Thief, His Wife & Her Lover;1989;Certified-Fresh;85;88;41;7;48;15
Cookie;1989;Rotten;15;39;2;11;13;1
Cookie's Fortune;1999;Certified-Fresh;86;65;49;8;57;13
The Cookout;2004;Rotten;5;37;2;40;42;15
Cool as Ice;1991;Rotten;6;44;1;17;18;2
A Cool Dry Place;1998;Rotten;54;59;7;6;13;1
Cool Hand Luke;1967;Certified-Fresh;100;95;51;0;51;8
Cool It;2010;Rotten;52;74;23;21;44;16
The Cooler;2003;Certified-Fresh;77;69;134;40;174;40
Cooley High;1975;Fresh;85;89;11;2;13;2
Cooties;2015;Rotten;45;37;19;23;42;13
Cop;1988;Fresh;83;48;15;3;18;4
Cop & 1/2;1993;Rotten;14;34;2;12;14;3
Cop Car;2015;Certified-Fresh;80;53;69;17;86;23
Cop Land;1997;Certified-Fresh;75;67;49;16;65;19
Cop Out;2010;Rotten;19;40;31;131;162;41
Copperhead;2013;Rotten;21;45;4;15;19;10
Cops And Robbersons;1994;Rotten;14;22;3;18;21;7
Copwatch;2017;Fresh;60;87;6;4;10;1
Copying Beethoven, (Klang der Stille);2006;Rotten;28;56;23;58;81;33
Coral Reef Adventure;2004;Fresh;91;73;21;2;23;5
Coraline;2009;Certified-Fresh;90;73;242;26;268;53
The Core;2003;Rotten;40;34;63;94;157;33
Coriolanus;2011;Certified-Fresh;92;58;141;12;153;48
Corky Romano;2001;Rotten;7;39;6;78;84;25
Corman's World: Exploits Of A Hollywood Rebel;2011;Certified-Fresh;92;84;47;4;51;17
Corpo Celeste;2012;Fresh;83;45;15;3;18;9
Corporate Animals;2019;Rotten;25;15;13;38;51;9
The Corporation;2004;Certified-Fresh;90;90;101;11;112;32
Tim Burton's Corpse Bride;2005;Certified-Fresh;84;77;165;31;196;40
Correspondence (La corrispondenza);1900;Rotten;14;36;1;6;7;2
Corrina, Corrina;1994;Rotten;39;69;7;11;18;4
The Corruptor;1998;Rotten;48;43;23;25;48;16
Corvette Summer;1978;Rotten;50;43;4;4;8;3
Cosmopolis;2012;Fresh;65;31;120;64;184;45
Cost of a Soul;2011;Rotten;27;48;3;8;11;9
Cottage Country;1900;Rotten;20;29;1;4;5;2
The Cotton Club;1984;Fresh;76;55;22;7;29;8
The Couch Trip;1988;Rotten;33;45;3;6;9;1
Count Yorga, Vampire;1970;Rotten;44;42;4;5;9;0
Countdown;2019;Rotten;26;72;18;52;70;11
Countdown to Zero;2010;Certified-Fresh;79;72;69;18;87;33
Counterfeiters;2018;Fresh;71;91;5;2;7;1
The Country Bears;2002;Rotten;31;33;26;59;85;23
Country Strong;2011;Rotten;22;53;29;105;134;44
The Aryan Couple, (The Couple);2005;Rotten;12;57;3;23;26;18
Couples Retreat;2009;Rotten;10;39;17;146;163;43
Courage Under Fire;1996;Certified-Fresh;85;66;46;8;54;17
Courageous;2011;Rotten;36;86;8;14;22;8
Court;2015;Certified-Fresh;98;79;57;1;58;15
The Court Jester;1956;Fresh;96;94;27;1;28;5
Cousin Jules;2013;Fresh;100;83;16;0;16;7
Cousins;1989;Rotten;50;67;4;4;8;1
The Covenant;2006;Rotten;4;62;3;71;74;22
Cover;2007;Rotten;0;78;0;12;12;6
The Cowboys;1972;Fresh;79;88;11;3;14;1
The Wicker Tree;2012;Rotten;27;10;4;11;15;4
Cowboys & Aliens;2011;Rotten;44;43;113;143;256;53
Coyote Lake;2019;Fresh;83;83;5;1;6;2
Coyote Ugly;2000;Rotten;23;71;24;79;103;31
CQ;2002;Fresh;66;69;50;26;76;23
Crack in the World;1965;Fresh;86;41;6;1;7;3
Cracks;2011;Rotten;43;48;21;28;49;17
Cradle 2 the Grave;2003;Rotten;25;52;31;91;122;27
Cradle of Champions;1900;Fresh;100;;13;0;13;2
Cradle Will Rock;1999;Fresh;64;71;46;26;72;17
The Craft;1996;Rotten;56;65;32;25;57;13
Craigslist Joe;2012;Rotten;33;64;2;4;6;3
Crank;2006;Fresh;61;71;57;37;94;20
Crank 2: High Voltage;2009;Fresh;64;49;44;25;69;15
Crash Pad;2017;Rotten;54;53;7;6;13;4
Crave;2013;Rotten;31;26;5;11;16;3
Crawford;2008;Fresh;100;72;5;0;5;0
Crawl;2011;Fresh;63;20;5;3;8;2
Crawl;2019;Certified-Fresh;83;75;166;33;199;26
The Crazies;1973;Fresh;67;43;16;8;24;2
Crazy/Beautiful;2001;Fresh;63;69;62;37;99;30
Crazy About Tiffany's;2016;Rotten;27;36;4;11;15;6
Crazy as Hell;2002;Rotten;53;54;8;7;15;5
Crazy Eyes;2012;Rotten;25;21;5;15;20;9
Crazy Heart;2009;Certified-Fresh;90;76;189;20;209;49
Crazy Horse;2012;Certified-Fresh;85;52;47;8;55;24
Crazy in Alabama;1999;Rotten;30;64;17;39;56;22
Crazy Love;2007;Certified-Fresh;79;73;70;19;89;38
Crazy on the Outside;2010;Rotten;8;28;1;11;12;9
Crazy People;;Rotten;37;62;7;12;19;4
Crazy Rich Asians;2018;Certified-Fresh;91;76;321;32;352;48
Crazy, Stupid, Love.;2011;Certified-Fresh;79;78;187;49;236;49
Creative Control;2016;Fresh;60;38;33;22;55;19
Creator;1985;Rotten;38;76;5;8;13;2
Creature;1985;Rotten;40;12;2;3;5;0
Creature;2011;Rotten;10;17;3;26;29;6
Creed;2015;Certified-Fresh;95;89;291;15;306;55
Creed II;2018;Certified-Fresh;83;80;253;50;303;47
Creep;2015;Fresh;89;65;24;3;27;4
Creep 2;2017;Fresh;100;72;23;0;23;2
Creeping Flesh;1973;Fresh;83;54;5;1;6;0
Creepshow;1982;Fresh;73;68;27;10;37;5
Creepshow 2;1987;Rotten;30;40;7;16;23;5
Creepy (Kuripi: Itsuwari no rinjin);2016;Certified-Fresh;90;57;46;5;51;15
Cries and Whispers;1972;Fresh;90;91;27;3;30;6
Crime After Crime;2011;Fresh;91;82;31;3;34;17
Crime & Punishment in Suburbia;2000;Rotten;21;58;6;23;29;14
The Crime of Padre Amaro;2002;Fresh;61;74;51;32;83;32
Crime Spree;2003;Rotten;33;56;2;4;6;3
Crimes of Passion;1984;Rotten;36;55;4;7;11;2
Crimes of the Heart;1986;Fresh;81;65;17;4;21;7
Criminal;2016;Rotten;30;47;41;94;135;31
Criminal Activities;2015;Rotten;48;42;10;11;21;8
Criminal Law;1989;Rotten;33;26;3;6;9;1
Crimson Peak;2015;Fresh;72;55;200;76;276;42
The Crimson Pirate;1952;Fresh;100;85;13;0;13;0
Crimson Tide;1995;Certified-Fresh;88;83;45;6;51;14
Crip Camp: A Disability Revolution;1900;Certified-Fresh;100;92;84;0;84;24
Criss Cross;1949;Fresh;92;80;11;1;12;2
Critical Care;1997;Rotten;59;30;10;7;17;10
Critical Thinking;2020;Fresh;93;85;27;2;29;4
Critters;1986;Rotten;52;45;11;10;21;2
Critters 2: The Main Course;1988;Rotten;25;36;3;9;12;1
Critters 3;1991;Rotten;0;23;0;7;7;0
Critters Attack!;1900;Rotten;44;26;7;9;16;1
Crna macka, beli macor (Black Cat, White Cat);1999;Fresh;83;95;29;6;35;9
Crocodile Dundee;1986;Fresh;88;59;28;4;32;5
Crocodile Dundee II;1988;Rotten;10;38;3;28;31;6
Crocodile Dundee in Los Angeles;2001;Rotten;11;25;9;72;81;26
Cromwell;1970;Rotten;43;69;3;4;7;1
Cronicas;2005;Certified-Fresh;71;77;52;21;73;24
Cronos;1994;Certified-Fresh;91;69;49;5;54;10
Crooked Arrows;2012;Rotten;41;62;11;16;27;14
Crooked House;2017;Rotten;57;56;17;13;30;7
Crooklyn;1994;Fresh;77;90;23;7;30;10
Cropsey;2010;Certified-Fresh;91;61;41;4;45;15
Cross Creek;1983;Fresh;67;75;8;4;12;4
Cross of Iron;1977;Fresh;75;87;12;4;16;1
Crossfire;1947;Fresh;82;74;14;3;17;5
Crossfire Trail;2001;Rotten;40;77;2;3;5;1
Crossing Delancey;1988;Fresh;88;78;22;3;25;1
The Crossing Guard;1995;Fresh;75;53;21;7;28;6
Crossing Over;2009;Rotten;16;49;17;92;109;43
Crossing the Line;2007;Fresh;90;85;19;2;21;10
Crossover;2006;Rotten;2;59;1;64;65;24
Crossworlds;1996;Rotten;20;41;1;4;5;0
Crouching Tiger, Hidden Dragon;2001;Certified-Fresh;97;86;153;4;157;35
The Crow;1994;Certified-Fresh;83;90;48;10;58;14
The Crow - Salvation;2000;Rotten;22;43;2;7;9;1
The Crow: City of Angels;1996;Rotten;12;40;4;30;34;9
Crown and Anchor;2018;Fresh;100;;5;0;5;1
Crown Heights;2017;Certified-Fresh;77;77;64;19;83;23
Crown Vic;2019;Rotten;58;73;15;11;26;8
CRSHD;1900;Fresh;75;60;15;5;20;3
Cruel Intentions;1999;Rotten;54;81;62;52;114;38
Cruel Intentions 2;2000;Rotten;17;21;2;10;12;0
The Cruise;1998;Fresh;86;88;18;3;21;4
Cruise;2018;Rotten;38;71;3;5;8;3
Cruising;1980;Rotten;50;48;26;26;52;12
Crumb;1995;Certified-Fresh;95;89;41;2;43;6
Crush The Skull;1900;Fresh;100;54;6;0;6;1
Crusoe;1988;Fresh;67;43;4;2;6;1
Cry-Baby;;Fresh;73;77;40;15;55;15
Cry Freedom;1987;Fresh;76;88;19;6;25;7
Evil Angels (A Cry in the Dark);1988;Fresh;93;74;26;2;28;7
Cry of the Owl;2009;Rotten;11;20;1;8;9;2
Cry_Wolf;2005;Rotten;24;51;11;35;46;11
The Crying Game;1992;Certified-Fresh;94;78;63;4;67;19
Crypto;2019;Rotten;17;59;1;5;6;2
Crystal Fairy;2013;Certified-Fresh;83;50;78;16;94;32
CSA: The Confederate States of America;2005;Certified-Fresh;80;56;53;13;66;22
CSNY Deja Vu;2008;Fresh;68;71;28;13;41;19
Cthulhu;2008;Fresh;62;28;8;5;13;3
Cub (Welp);1900;Rotten;38;33;9;15;24;5
Cuba And The Cameraman;2017;Fresh;100;93;7;0;7;4
Cuban Fury;2014;Rotten;54;43;52;44;96;26
Cubby;2019;Fresh;73;56;8;3;11;2
Cube;1998;Fresh;63;76;24;14;38;6
Cube 2 - Hypercube;2003;Rotten;45;35;5;6;11;0
Cuck;2019;Rotten;44;65;7;9;16;6
Cujo;1983;Fresh;63;45;25;15;40;5
Cult of Chucky;1900;Fresh;79;46;19;5;24;1
Cunningham;2019;Certified-Fresh;89;88;54;7;61;19
Cupcakes;2015;Fresh;78;62;18;5;23;10
Curdled;1996;Rotten;17;58;2;10;12;2
The Curious Case of Benjamin Button;2008;Certified-Fresh;72;80;182;72;254;55
Curly Sue;1991;Rotten;13;50;2;13;15;3
Curse of Chucky;1900;Fresh;76;56;16;5;21;1
The Curse of Frankenstein;1957;Fresh;78;77;14;4;18;3
The Curse of the Cat People;1945;Fresh;87;66;27;4;31;4
Curse of the Demon;1958;Fresh;100;85;16;0;16;2
Curse of the Golden Flower;2006;Fresh;65;65;83;44;127;39
The Curse of the Jade Scorpion;2001;Rotten;46;53;56;67;123;38
Curse of the Pink Panther;1983;Rotten;29;24;4;10;14;0
Curtains;1983;Rotten;57;39;4;3;7;0
Curtiz;1900;Rotten;57;64;4;3;7;0
Curvature;2018;Rotten;47;54;8;9;17;2
Dead Man's Curve;1998;Rotten;11;53;1;8;9;1
Custer of the West;1967;Rotten;25;32;2;6;8;3
Cut;2000;Rotten;11;25;1;8;9;2
Cut Bank;2015;Rotten;37;29;14;24;38;11
Cut Shoot Kill;1900;Fresh;71;50;5;2;7;0
Cut Sleeve Boys;2007;Rotten;42;49;5;7;12;3
Cut Snake;1900;Fresh;69;46;11;5;16;5
Cutie And The Boxer;2013;Certified-Fresh;95;75;70;4;74;31
Cutter's Way;1981;Fresh;91;70;21;2;23;8
Cutthroat Island;1995;Rotten;38;40;15;25;40;10
Cyber-Seniors;2014;Fresh;80;58;12;3;15;7
Cypher;2002;Rotten;58;65;11;8;19;1
Cyrano de Bergerac;1950;Fresh;78;81;21;6;27;8
Cyrus;2010;Certified-Fresh;80;53;125;31;156;47
D2: The Mighty Ducks;1994;Rotten;20;59;3;12;15;1
D3: The Mighty Ducks;1996;Rotten;20;45;3;12;15;4
D-Tox (Eye See You);2002;Rotten;18;28;4;18;22;5
The D Train;2015;Rotten;53;23;71;63;133;37
Da Sweet Blood of Jesus;2015;Rotten;47;19;20;24;43;16
The Da Vinci Code;2006;Rotten;26;57;59;172;231;48
Dabangg;2010;Fresh;60;60;3;2;5;0
Dad;1989;Fresh;60;60;6;4;10;1
Daddy Day Camp;2007;Rotten;1;38;1;80;81;30
Daddy Day Care;2003;Rotten;27;48;36;96;132;38
Daddy Issues;2020;Rotten;0;;0;7;7;1
Daddy's Home 2;2017;Rotten;21;50;27;102;129;26
Daddy's Home;2015;Rotten;31;49;37;84;121;31
Daddy's Little Girls;2007;Rotten;26;81;14;40;54;22
Dad's Army;2016;Rotten;31;36;11;24;35;8
Daffodils;1900;Fresh;60;;3;2;5;0
Dagon;1900;Fresh;69;56;9;4;13;0
Daguerrotype (Le secret de la chambre noire);1900;Rotten;53;50;9;8;17;4
Dahmer;2002;Fresh;69;40;27;12;39;10
Dai-Nipponjin (Big Man Japan);2009;Fresh;77;54;27;8;35;12
Daisy Kenyon;1947;Fresh;100;58;5;0;5;1
Daisy Miller;1974;Fresh;75;29;9;3;12;1
Daleks - Invasion Earth 2150 A.D.;1966;Fresh;67;53;8;4;12;3
Dalida;2017;Rotten;33;88;2;4;6;2
Dallas Buyers Club;2013;Certified-Fresh;93;91;239;19;257;59
Damage;1900;Fresh;78;73;18;5;23;5
Damascus Cover;2018;Rotten;14;59;3;19;22;7
Dames;1934;Fresh;60;65;3;2;5;1
Damien---Omen II;1978;Rotten;44;49;11;14;25;3
Damn the Defiant!;1962;Fresh;100;62;6;0;6;0
Damnation Alley;1977;Rotten;44;34;4;5;9;0
The Damned United;2009;Certified-Fresh;92;85;127;11;138;42
Damsel;2018;Fresh;67;55;75;37;112;30
Damsels in Distress;2012;Certified-Fresh;75;39;107;36;143;49
Dan in Real Life;2007;Fresh;65;69;110;60;170;42
Dana Carvey - Squatting Monkeys Tell No Lies;1900;Rotten;20;;1;4;5;3
Dance Academy: The Comeback;2018;Fresh;100;81;15;0;15;3
Dance Flick;2009;Rotten;18;30;17;79;96;26
Dance, Girl, Dance;1940;Fresh;83;65;10;2;12;4
Dance Me Outside;1994;Fresh;69;91;9;4;13;5
Dance with Me;1998;Rotten;51;67;22;21;43;14
Dancer;2016;Fresh;88;86;29;4;33;12
Dancer in the Dark;2000;Fresh;69;91;84;37;121;31
Dancer, Texas Pop. 81;1998;Fresh;80;72;12;3;15;3
The Dancer Upstairs;2002;Fresh;64;76;73;41;114;37
Dances With Wolves;;Certified-Fresh;83;87;63;13;76;19
Dancing Across Borders;2010;Rotten;57;70;12;9;21;10
Dancing at Lughnasa;1998;Fresh;64;58;21;12;33;7
Dancing at the Blue Iguana;2000;Rotten;23;42;5;17;22;6
Dancing In Jaffa;2014;Certified-Fresh;88;73;36;5;41;16
Dancing Lady;1933;Fresh;80;69;4;1;5;0
Danger Close;2017;Rotten;20;81;1;4;5;3
Danger Close;2019;Fresh;71;71;25;10;35;4
Danger: Diabolik;1968;Fresh;64;71;14;8;22;4
Dangerous Beauty;1998;Fresh;68;86;19;9;28;8
Dangerous Ishhq;2012;Rotten;20;31;1;4;5;2
Dangerous Liaisons;2012;Fresh;68;54;13;6;19;11
Dangerous Lies (Windfall);1900;Rotten;25;22;7;21;28;5
The Dangerous Lives of Altar Boys;2002;Certified-Fresh;77;79;86;25;111;31
Dangerous Minds;1995;Rotten;29;64;12;29;41;12
A Dangerous Woman;1993;Rotten;50;31;6;6;12;3
Daniel;1983;Rotten;43;56;3;4;7;1
Daniel & Ana;2010;Rotten;56;89;5;4;9;3
Daniel Isn't Real;2019;Certified-Fresh;82;56;65;14;79;11
Danika;2006;Rotten;29;32;2;5;7;1
Danny Collins;2015;Certified-Fresh;77;73;102;30;132;41
Danny Deckchair;2003;Rotten;55;77;42;35;77;25
Danny Says;2016;Fresh;74;51;23;8;31;12
Unleashed;2005;Fresh;66;75;88;46;134;34
Dante's Peak;1997;Rotten;26;38;8;23;31;11
Darby O'Gill and the Little People;1959;Fresh;100;77;15;0;15;2
Dare;2009;Rotten;57;34;12;9;21;9
Daredevil;2003;Rotten;44;35;100;129;229;45
The Darjeeling Limited;2007;Fresh;69;78;132;60;192;49
Dark Shadows;2012;Rotten;36;46;91;164;255;53
Dark Blue;2003;Rotten;59;52;78;55;133;34
Dark Blue World;2001;Fresh;62;84;36;22;58;22
Dark City;1998;Certified-Fresh;76;85;65;20;85;21
Dark Crimes;2018;Rotten;0;30;0;37;37;9
The Dark Crystal;1982;Certified-Fresh;79;81;37;10;47;7
Dark Days;2000;Certified-Fresh;94;89;64;4;68;26
Dark Encounter (Transience);1900;Fresh;67;43;4;2;6;0
Harlequin (Dark Forces) (The Minister's Magician);1980;Rotten;40;48;2;3;5;0
Entre tinieblas (Dark Habits) (Dark Hideout);1983;Fresh;69;69;9;4;13;1
The Dark Half;1993;Rotten;58;37;19;14;33;10
Dark Horse;2012;Fresh;70;41;55;24;79;33
Dark Matter;2008;Rotten;40;40;16;24;40;19
Dark Night of the Scarecrow;1981;Rotten;50;65;3;3;6;0
The Mercenaries (Dark of the Sun);1968;Fresh;67;77;4;2;6;0
Dark Passage;1947;Fresh;93;82;26;2;28;7
Dark Phoenix;2019;Rotten;22;64;82;288;370;44
Dark Places;2015;Rotten;23;33;19;63;82;21
Dark River;2018;Certified-Fresh;80;64;47;12;59;14
Dark Signal;2017;Rotten;33;33;2;4;6;1
Dark Skies;2013;Rotten;41;49;38;55;93;20
Dark Summer;2015;Rotten;29;15;7;17;24;9
Dark Tide;2012;Rotten;0;16;0;20;20;5
Dark Touch;2013;Fresh;64;28;7;4;11;2
Dark Victory;1939;Fresh;88;81;21;3;24;1
Dark Was The Night;2015;Rotten;52;35;11;10;21;7
Dark Water;2005;Rotten;47;28;72;82;154;39
Dark Waters;2019;Certified-Fresh;90;95;196;22;218;36
Darkest Hour;2017;Certified-Fresh;84;82;262;51;312;52
Darkman;;Certified-Fresh;84;59;52;10;61;11
Darkman II: The Return of Durant;1995;Rotten;29;19;2;5;7;0
Darkman III: Die Darkman Die;1996;Rotten;33;20;2;4;6;0
Darkness;2004;Rotten;4;30;2;53;55;13
Darkness Falls;2003;Rotten;9;34;12;118;130;34
Darkon;2006;Fresh;89;65;17;2;19;9
Darlin';2019;Fresh;70;50;21;9;30;6
Darling;2016;Fresh;71;44;20;8;28;8
Darling Companion;2012;Rotten;21;29;19;72;91;33
Darling Lili;1970;Rotten;40;69;2;3;5;1
D.A.R.Y.L.;1985;Rotten;53;54;9;8;17;5
Das finstere Tal (The Dark Valley);2014;Rotten;33;66;2;4;6;1
Das Versprechen (The Promise);1995;Fresh;71;75;5;2;7;1
Date And Switch;2014;Rotten;30;37;3;7;10;5
Date Night;2010;Fresh;66;55;152;78;230;50
Date with an Angel;1987;Rotten;14;58;1;6;7;2
American Experience;2004;Certified-Fresh;79;60;60;16;76;33
Daughter of the Wolf;2019;Rotten;22;40;2;7;9;4
Daughters of the Dust;1991;Certified-Fresh;98;64;42;1;43;15
Daughters of the Sexual Revolution: The Untold Story of the Dallas Cowboys Cheerleaders;2018;Fresh;83;89;5;1;6;3
Dave;1993;Certified-Fresh;95;72;57;3;60;21
Dave Chappelle: Sticks & Stones;1900;Rotten;35;99;6;11;17;3
David and Bathsheba;1951;Fresh;83;31;5;1;6;3
David & Layla;2007;Rotten;53;43;10;9;19;11
David and Lisa;1962;Fresh;83;79;10;2;12;3
David Cross: Making America Great Again;1900;Fresh;71;57;5;2;7;3
Davy Crockett, King of the Wild Frontier;1955;Fresh;100;79;6;0;6;0
Dawn of the Dead;2004;Certified-Fresh;75;77;141;47;188;38
Dawn Of The Planet Of The Apes;2014;Certified-Fresh;90;88;283;30;313;63
Dawn Patrol;2015;Rotten;0;11;0;6;6;2
The Day After Tomorrow;2004;Rotten;44;50;98;123;221;45
A Day at the Races;1937;Fresh;94;89;16;1;17;2
Day for Night;1973;Fresh;100;91;37;0;37;7
Day Night Day Night;2006;Fresh;67;56;31;15;46;17
Day of the Dead: Bloodline;2018;Rotten;13;9;1;7;8;2
Day of the Falcon;2013;Rotten;11;51;3;24;27;7
Day of the Flowers;1900;Rotten;58;52;7;5;12;5
The Day of the Jackal;1973;Fresh;89;88;24;3;27;7
The Day of the Locust;1975;Fresh;60;76;9;6;15;4
Day of the Outlaw;1959;Fresh;100;70;5;0;5;0
The Day the Earth Stood Still;2008;Rotten;21;27;40;155;195;49
Day Watch;2007;Fresh;62;68;60;37;97;33
Day Zero;2007;Rotten;24;44;5;16;21;8
Daybreakers;2010;Fresh;69;49;106;48;154;37
Daydream Nation;2011;Fresh;68;50;15;7;22;10
Daylight;1996;Rotten;27;37;11;30;41;12
Daylight;2011;Fresh;91;63;10;1;11;6
Daylight Robbery;2008;Rotten;22;45;2;7;9;5
Giorni e Nuvole (Days and Clouds);2007;Fresh;81;62;26;6;32;10
Days and Nights;2014;Rotten;0;36;0;13;13;4
Days of Glory;2007;Certified-Fresh;83;79;71;15;86;33
Days of Grace;2015;Fresh;65;62;13;7;20;8
Days of Heaven;1978;Certified-Fresh;92;89;49;4;53;11
Days of Thunder;;Rotten;38;60;25;40;65;18
The Daytrippers;1997;Fresh;73;74;19;7;26;6
Dazed and Confused;1993;Certified-Fresh;92;90;57;5;62;11
D.C. Cab;1983;Rotten;14;53;1;6;7;2
DCU: Justice League: The Flashpoint Paradox;1900;Fresh;100;92;5;0;5;0
Ddongpari (Breathless);2009;Fresh;84;82;21;4;25;9
De rouille et d'os (Rust and Bone);2012;Certified-Fresh;82;80;134;30;164;54
De Sade;2001;Rotten;0;25;0;6;6;1
De zaak Alzheimer (The Memory of a Killer);2005;Certified-Fresh;84;80;57;11;68;24
Dead Man Running;2009;Rotten;14;52;3;19;22;4
Dylan Dog: Dead of Night;2011;Rotten;7;29;3;41;44;8
Dead or Alive: Hanzaisha;1999;Rotten;55;74;12;10;22;5
Dead Again;1991;Certified-Fresh;83;77;39;8;47;11
Dead Alive;1993;Certified-Fresh;88;87;37;5;42;7
Dead and Buried;1981;Fresh;75;58;12;4;16;0
Dead Ant;2019;Fresh;64;46;9;5;14;3
Dead Awake;2017;Rotten;20;17;2;8;10;3
Dead Bang;1989;Rotten;33;44;4;8;12;0
Dead Calm;1989;Fresh;83;63;24;5;29;6
Dead Dicks;2019;Fresh;100;58;9;0;9;0
Dead End;1937;Fresh;91;76;10;1;11;0
Dead Heat on a Merry-Go-Round;1966;Rotten;40;34;2;3;5;0
Dead Hooker in a Trunk;2009;Fresh;80;42;4;1;5;0
Dead Kids;1900;Rotten;17;76;1;5;6;1
Dead Man;1995;Fresh;71;88;37;15;52;14
Dead Man Down;2013;Rotten;40;47;42;63;105;27
Dead Man on Campus;1998;Rotten;15;55;7;39;46;16
Dead Man's Burden;2013;Fresh;74;49;14;5;19;11
Dead Man's Shoes;2006;Rotten;58;91;26;19;45;14
Dead Men Don't Wear Plaid;1982;Fresh;79;72;19;5;24;1
Dead Night;2018;Fresh;63;52;10;6;16;2
Dead of Night (Deathdream);1974;Fresh;83;64;10;2;12;0
Dead of Winter;1986;Fresh;77;46;10;3;13;2
Dead or Alive: Final;2002;Rotten;42;40;5;7;12;3
Dead Poets Society;1989;Certified-Fresh;84;92;48;9;57;10
The Dead Pool;1988;Rotten;55;44;17;14;31;1
Dead Ringer;1964;Fresh;100;80;9;0;9;0
Dead Ringers;1988;Certified-Fresh;83;82;34;7;41;7
Dead Silence;2007;Rotten;20;51;16;64;80;20
Dead Snow;2009;Fresh;69;56;53;24;77;24
Dead Snow 2: Red vs. Dead;2014;Fresh;81;68;25;6;31;9
Dead Water;2019;Rotten;17;24;1;5;6;3
The Dead Zone;1983;Certified-Fresh;89;77;42;5;47;5
Deadfall;2012;Rotten;34;37;28;54;82;32
Deadline;2012;Rotten;0;53;0;9;9;5
Deadly Blessing;1982;Rotten;14;28;1;6;7;0
The Deadly Companions (Trigger Happy);1961;Fresh;83;32;5;1;6;2
Deadly Friend;1986;Rotten;8;38;1;11;12;1
Deadpool;2016;Certified-Fresh;85;90;290;52;342;51
Deadpool 2;2018;Certified-Fresh;83;85;344;68;412;51
Deadtectives;1900;Fresh;63;58;5;3;8;0
Deadtime Stories;1986;Rotten;0;21;0;5;5;0
Deal of the Century;1983;Rotten;11;17;1;8;9;1
Dealing With Idiots;2013;Rotten;37;31;7;12;19;12
Dealt;2017;Fresh;96;84;24;1;25;7
Dear Lemon Lima;2011;Fresh;75;64;9;3;12;5
Dear Diary (Caro diario);1994;Fresh;68;85;13;6;19;4
Dear Dictator;2018;Rotten;16;43;4;21;25;7
Dear Ex;1900;Fresh;89;88;8;1;9;1
Dear Frankie;2005;Certified-Fresh;81;90;91;21;112;35
Dear God;1996;Rotten;12;28;4;30;34;11
Dear Heart;1964;Rotten;40;66;2;3;5;1
Dear Jesse;1998;Fresh;86;;6;1;7;2
Dear John;2010;Rotten;29;55;39;97;136;39
Dear Mr. Watterson;2013;Fresh;62;51;21;13;34;16
Dear Wendy;2005;Rotten;36;66;23;41;64;18
Dear White People;2014;Certified-Fresh;91;61;122;12;133;42
Death and the Maiden;1995;Certified-Fresh;82;81;41;9;50;11
Death at a Funeral;2007;Fresh;62;79;82;50;132;40
Death at a Funeral;2010;Rotten;43;45;59;79;138;30
Death Becomes Her;1992;Rotten;54;61;27;23;50;16
Death by China;2012;Rotten;38;72;5;8;13;7
Death Defying Acts;2008;Rotten;42;26;16;22;38;14
Death House;2018;Rotten;40;39;2;3;5;0
Death Line (Raw Meat);1972;Fresh;91;44;10;1;11;1
Death Note;1900;Rotten;38;24;29;47;76;15
Death of a Cyclist (Muerte de un ciclista);1958;Fresh;100;86;10;0;10;3
Death of a President;2006;Rotten;38;58;38;62;100;39
Death Proof;2007;Fresh;64;72;27;15;42;11
Death Race;2008;Rotten;42;60;67;92;159;34
Death Race 2;1900;Rotten;17;37;1;5;6;0
Death Race 2000;1975;Fresh;83;64;30;6;36;6
Death Race 3: Inferno;1900;Rotten;50;45;3;3;6;0
Da uomo a uomo (Death Rides A Horse) (As Man to Man);1967;Rotten;40;71;2;3;5;2
Death Sentence;2007;Rotten;20;60;23;90;113;39
Death Takes a Holiday;1934;Fresh;88;80;7;1;8;0
Death to Smoochy;2002;Rotten;42;66;50;69;119;28
Death Wish;1974;Fresh;68;68;19;9;28;4
Death Wish;2018;Rotten;18;71;29;132;161;33
Death Wish 3;1985;Rotten;11;54;2;16;18;6
Death Wish 4: The Crackdown;1987;Rotten;14;40;1;6;7;0
Death Wish II;1982;Rotten;33;44;6;12;18;6
Death Wish V: The Face of Death;1993;Rotten;0;32;0;5;5;4
Deathgasm;2015;Fresh;88;66;28;4;32;8
The Deaths of Ian Stone;2007;Rotten;57;34;4;3;7;1
Deathstroke: Knights & Dragons;1900;Fresh;80;57;8;2;10;0
Deathtrap;1982;Fresh;71;71;12;5;17;4
D.E.B.S.;2004;Rotten;39;55;25;37;61;21
Debt Collectors;2020;Fresh;82;38;9;2;11;1
Decasia;2002;Fresh;86;81;12;2;14;3
Deceiver;1998;Rotten;48;58;13;14;27;8
December Boys;2007;Rotten;41;52;29;41;70;27
Deception;2008;Rotten;11;31;11;89;100;34
Deceptive Practice: The Mysteries and Mentors of Ricky Jay;2013;Fresh;92;71;36;3;39;21
Decision Before Dawn;1951;Fresh;100;71;6;0;6;2
Deck the Halls;2006;Rotten;6;30;5;79;84;28
Declaration of War;2012;Certified-Fresh;86;70;36;6;42;20
The Decline of Western Civilization Part II: The Metal Years;1988;Fresh;90;77;9;1;10;5
Decoding Annie Parker;2014;Rotten;56;41;14;11;25;11
Decoding Deepak;2012;Rotten;55;59;6;5;11;6
Dead Sushi;2013;Fresh;100;52;7;0;7;0
Dedication;2007;Rotten;40;64;18;27;45;20
The Deep;1977;Rotten;48;38;10;11;21;0
Deep Blue Sea 2;1900;Rotten;0;10;0;5;5;0
Deep Blue Sea 3;1900;Fresh;69;38;9;4;13;0
The Deep End;2001;Certified-Fresh;82;59;98;21;119;31
The Deep End of the Ocean;1999;Rotten;43;59;15;20;35;8
Deep Impact;1998;Rotten;45;43;39;47;86;21
Deep Red (Profondo rosso);1975;Fresh;96;86;23;1;24;3
Deep Rising;1998;Rotten;28;43;9;23;32;6
Deep Sea 3D;2006;Fresh;91;79;31;3;34;15
Deep Web;2015;Fresh;79;72;11;3;14;3
Deeply;2001;Rotten;20;59;1;4;5;1
DeepStar Six;1989;Rotten;9;24;1;10;11;0
Deepwater Horizon;2016;Certified-Fresh;83;82;216;45;260;55
Deerskin;2020;Certified-Fresh;87;71;90;13;103;15
Defamation;2009;Fresh;85;75;17;3;20;10
Defending Your Life;1991;Fresh;97;83;31;1;32;4
Defendor;2009;Fresh;74;58;17;6;23;7
Defence of the Realm (Defense of the Realm);1985;Fresh;100;69;6;0;6;1
Defiance;2009;Rotten;58;72;107;79;186;49
The Defiant Ones;1958;Fresh;83;87;20;4;24;4
Deidra & Laney Rob a Train;2017;Fresh;92;57;22;2;24;6
Deja Vu;2006;Rotten;56;73;90;72;162;41
Delgo;2008;Rotten;11;26;5;39;44;17
Delhi 6;2009;Rotten;36;41;4;7;11;6
Delhi Belly;2011;Fresh;88;82;15;2;17;7
Delhi Safari;2012;Rotten;20;35;3;12;15;6
Deli Man;2015;Fresh;81;66;30;7;37;17
Delicatessen;1992;Certified-Fresh;89;91;49;6;55;12
Delirious;1991;Rotten;44;39;4;5;9;1
Delirium;2018;Rotten;0;39;0;5;5;3
Deliver Us From Eva;2003;Rotten;44;76;36;46;82;29
Deliver Us from Evil;2006;Certified-Fresh;100;89;72;0;72;28
Deliver Us from Evil;2014;Rotten;29;42;38;95;133;34
Deliverance;1972;Certified-Fresh;89;82;56;7;63;6
Delivery Man;2013;Rotten;39;47;58;89;147;38
Delivery: The Beast Within;2014;Fresh;71;30;5;2;7;1
De-Lovely;2004;Rotten;48;66;75;81;156;41
Delta Farce;2007;Rotten;5;38;2;42;44;13
The Delta Force;1986;Rotten;18;49;2;9;11;2
Delta Force 2: The Colombian Connection;;Rotten;11;40;1;8;9;2
Delta of Venus;1995;Rotten;0;50;0;5;5;0
Dementia 13;1963;Fresh;63;35;15;9;24;3
Demetrius and the Gladiators;1954;Fresh;83;64;5;1;6;0
Demolition;2016;Rotten;53;54;108;96;204;42
Demolition Man;1993;Fresh;60;66;26;17;43;11
Demon;2016;Certified-Fresh;92;56;65;6;71;17
Demon House;2018;Rotten;50;62;6;6;12;3
Demon Seed;1977;Rotten;55;46;12;10;22;2
Demonlover;2003;Rotten;50;40;40;40;80;26
Demons 2: The Nightmare Returns;1987;Fresh;60;44;6;4;10;0
Den of Thieves;2018;Rotten;41;62;56;79;135;22
Denial;2016;Certified-Fresh;82;71;135;29;164;41
Denise Ho: Becoming the Song;2020;Fresh;90;;9;1;10;4
Dennis the Menace;1993;Rotten;27;38;7;19;26;9
The Dentist 2: Brace Yourself;1998;Rotten;0;24;0;0;5;0
The Departed;2006;Certified-Fresh;91;94;254;26;280;60
Depraved;2019;Certified-Fresh;84;46;47;9;56;8
The Circle;2014;Fresh;100;78;23;0;23;11
Der Samurai;1900;Fresh;100;52;9;0;9;0
Derailed;2005;Rotten;21;58;26;99;125;36
Derailroaded;2005;Fresh;82;83;9;2;11;4
Derrida;2002;Fresh;82;58;28;6;34;13
Dersu Uzala;1975;Fresh;73;94;11;4;15;2
Descendants 2;1900;Fresh;71;70;5;2;7;3
The Descent;2006;Certified-Fresh;85;76;153;26;179;37
Desert Bayou;2007;Fresh;78;59;18;5;23;11
Desert Blue;1999;Rotten;37;47;7;12;19;5
Desert Dancer;2015;Rotten;33;62;14;29;43;16
The Desert Fox;1951;Fresh;71;62;5;2;7;0
Desert Hearts;1986;Fresh;95;76;21;1;22;4
The Desert Rats;1953;Fresh;83;70;5;1;6;0
Desert Saints;2002;Rotten;29;54;2;5;7;1
Desierto;2016;Fresh;63;47;57;34;91;19
Designing Woman;1957;Fresh;82;69;9;2;11;1
Desk Set;1957;Fresh;100;83;23;0;23;5
Desperate Acts Of Magic;2013;Fresh;60;70;6;4;10;4
Desperate Living;1977;Fresh;70;80;7;3;10;0
Desperate Measures;1997;Rotten;19;37;6;25;31;7
Desperately Seeking Susan;1985;Fresh;83;62;25;5;30;8
Despicable Me 2;2013;Certified-Fresh;75;85;139;46;185;43
Despicable Me 3;2017;Rotten;58;53;112;80;192;33
Despite The Falling Snow;2017;Rotten;9;44;2;20;22;10
Destination Tokyo;1943;Fresh;80;65;4;1;5;0
Destination Wedding;2018;Rotten;51;58;44;42;86;25
Destiny (Der mude Tod);1924;Fresh;90;88;19;2;21;4
Destiny Turns on the Radio;1995;Rotten;17;21;3;15;18;4
Destroy All Monsters;1969;Fresh;75;68;6;2;8;1
Destroyer;2018;Certified-Fresh;73;50;195;71;265;46
Destry Rides Again;1939;Fresh;96;82;24;1;25;3
Detachment;2012;Rotten;57;74;41;31;72;25
The Detective;1968;Fresh;100;46;8;0;8;1
Detective Dee and the Mystery of the Phantom Flame;2011;Certified-Fresh;80;62;44;11;55;24
Detective Story;1951;Fresh;75;72;9;3;12;1
Detention;2012;Rotten;41;46;18;26;44;15
Detention Of The Dead;2013;Rotten;57;24;4;3;7;1
Deterrence;2000;Rotten;46;59;18;21;39;11
Detour;1945;Fresh;100;78;29;0;29;5
Detour;2017;Fresh;65;42;20;11;31;7
Detroit;2017;Certified-Fresh;82;79;246;54;300;51
Detroit 9000;1998;Rotten;25;49;2;6;8;3
Detroit Rock City;1999;Rotten;48;82;19;21;40;6
Detropia;2012;Certified-Fresh;86;63;36;6;42;20
Deuce Bigalow: Male Gigolo;1999;Rotten;22;42;17;59;76;20
Deuce Bigalow: European Gigolo;2005;Rotten;9;33;9;91;100;27
Deuces Wild;2002;Rotten;3;51;2;73;75;23
Devil;2010;Rotten;50;43;49;49;98;13
The Devil and Max Devlin;1900;Rotten;18;25;2;9;11;2
The Devil and Miss Jones;1941;Fresh;100;81;8;0;8;0
The Devil Came on Horseback;2007;Certified-Fresh;96;90;52;2;54;18
Devil in a Blue Dress;1995;Certified-Fresh;88;70;52;7;59;17
The Devil's Advocate;1997;Fresh;63;80;35;21;56;15
The Devil's Backbone (El Espinazo del diablo);2001;Certified-Fresh;92;89;110;9;119;33
The Devil's Brigade;1968;Fresh;60;69;3;2;5;1
The Devil's Chair ;1900;Fresh;60;33;3;2;5;1
Devil's Due;2014;Rotten;18;21;10;46;56;14
Devil's Gate;2018;Rotten;38;24;6;10;16;4
Devil's Knot;2014;Rotten;24;39;24;75;98;30
Devils on the Doorstep (Guizi lai le);2002;Fresh;91;95;10;1;11;4
The Devil's Own;1997;Rotten;35;41;14;26;40;10
The Devil's Rejects;2005;Rotten;54;78;75;63;138;32
The Dhamma Brothers;2008;Fresh;83;78;19;4;23;10
Dheepan;2016;Certified-Fresh;87;82;109;16;125;38
Mumbai Diaries;2011;Fresh;65;70;17;9;26;12
Dhoom: 2;2006;Fresh;92;77;11;1;12;3
Diablo;2016;Rotten;19;27;4;17;21;4
Dial A Prayer;2015;Fresh;71;39;5;2;7;1
Dial M for Murder;1954;Certified-Fresh;89;92;42;5;47;11
Diamonds Are Forever;1971;Fresh;64;58;32;18;50;8
Diana;2013;Rotten;8;25;8;98;106;39
Diana Kennedy: Nothing Fancy;2020;Fresh;100;;33;0;33;8
Diana Vreeland: The Eye Has To Travel;2012;Certified-Fresh;94;79;67;4;71;34
Diane;2019;Certified-Fresh;93;70;87;7;94;25
Diane;2018;Fresh;88;46;7;1;8;3
Diary of the Dead;2007;Fresh;62;41;80;50;130;35
Diary of a Chambermaid (Le journal d'une femme de chambre);1965;Fresh;87;83;20;3;23;2
Diary of a Lost Girl (Tagebuch einer Verlorenen);1900;Fresh;100;88;8;0;8;1
Diary of a Mad Black Woman;2005;Rotten;16;87;18;97;115;32
Diary of a Wimpy Kid;2010;Rotten;54;49;57;49;106;35
Diary of a Wimpy Kid 2: Rodrick Rules;2011;Rotten;47;61;47;53;100;33
Diary of a Wimpy Kid: Dog Days;2012;Rotten;52;63;39;36;75;26
Diary Of A Wimpy Kid: The Long Haul;2017;Rotten;18;32;13;59;72;24
The Diary of Anne Frank;1959;Fresh;79;77;15;4;19;3
The Diary of Ellen Rimbauer;2003;Rotten;17;50;1;5;6;3
Dickie Roberts: Former Child Star;2003;Rotten;22;46;27;94;121;36
Die Another Day;2002;Rotten;57;41;125;96;221;48
Die! Die! My Darling!;1965;Rotten;50;58;5;5;10;2
Die Falschung (Circle of Deceit);1981;Fresh;100;71;7;0;7;3
Die Hard;1988;Certified-Fresh;94;94;72;5;77;17
Die Hard 2;;Fresh;69;70;44;20;64;17
Die Hard: With a Vengeance;1995;Rotten;59;83;43;30;73;18
Die, Monster, Die!;1965;Fresh;71;40;5;2;7;0
Die Wand (The Wall);2013;Certified-Fresh;78;71;31;9;40;16
Dig!;2004;Certified-Fresh;89;90;67;8;75;28
Dig Two Graves;2017;Fresh;71;39;20;8;28;10
Diggers;2007;Fresh;70;57;39;17;56;21
Digging For Fire;2015;Fresh;66;41;44;24;67;24
Digging to China;1998;Rotten;43;73;3;4;7;1
Digging Up the Marrow;2015;Fresh;60;41;12;8;20;3
Diggstown;1992;Fresh;60;77;9;6;15;1
Dil Bole Hadippa! (My Heart Goes Hooray!);2009;Fresh;63;56;5;3;8;2
Dilili in Paris (Dilili a Paris);2019;Fresh;61;48;14;9;23;4
Dim Sum: A Little Bit of Heart;1985;Fresh;88;52;7;1;8;2
Dim Sum Funeral;2008;Rotten;0;36;0;5;5;1
Diminished Capacity;2008;Rotten;35;37;11;20;31;15
Diner;1982;Certified-Fresh;93;78;37;3;40;10
Dinner for Schmucks;2010;Rotten;42;42;79;111;190;46
The Dinner Game;1999;Fresh;74;90;34;12;46;13
Dinner with Friends;2001;Fresh;90;47;9;1;10;3
Dinosaur 13;2014;Fresh;73;76;36;13;49;20
Dinosaurs Alive! 3D;2007;Fresh;75;36;6;2;8;2
Dinosaurs: Giants of Patagonia;2007;Fresh;100;52;7;0;7;3
Dinotasia;2012;Rotten;25;46;2;6;8;4
Dior and I;2015;Certified-Fresh;84;76;61;12;73;26
Diplomacy;2014;Certified-Fresh;94;81;47;3;50;20
Dirt Music;1900;Rotten;29;55;12;29;41;8
Dirty Dancing;1987;Fresh;68;90;47;22;69;15
Dirty Dancing;1900;Rotten;19;16;4;17;21;12
Dirty Dancing: Havana Nights;2004;Rotten;23;73;25;83;108;37
The Dirty Dozen;1967;Certified-Fresh;85;90;34;6;40;9
Dirty Girl;2011;Rotten;33;53;13;27;40;19
Dirty Grandpa;2016;Rotten;11;44;15;121;135;22
Dirty Harry;1971;Certified-Fresh;89;90;41;5;46;6
Dirty Love;2005;Rotten;6;68;2;29;31;11
Dirty Mary Crazy Larry;1974;Rotten;47;68;8;9;17;3
Dirty Pretty Things;2003;Certified-Fresh;94;82;134;8;142;44
Dirty Rotten Scoundrels;1988;Fresh;89;84;33;4;37;7
A Dirty Shame;2004;Rotten;53;51;62;55;117;34
Dirty Wars;2013;Certified-Fresh;85;74;60;11;71;26
Disappearance at Clifton Hill;2020;Fresh;73;44;32;12;44;8
The Disappearance of Alice Creed;2010;Certified-Fresh;81;67;79;19;98;30
The Disappearance of Garcia Lorca;1900;Rotten;29;58;2;5;7;2
Disappearances;2007;Rotten;52;44;11;10;21;13
Disappearing Acts;2000;Fresh;60;85;3;2;5;3
Disaster Movie;2008;Rotten;1;21;1;73;74;19
Disclosure;1994;Rotten;59;41;36;25;61;19
Disco Pigs;2003;Rotten;20;75;1;4;5;1
Disco Godfather;1979;Fresh;83;50;5;1;6;0
Disconnect;2013;Fresh;70;75;55;24;79;29
Discreet;2018;Fresh;78;33;7;2;9;4
The Discreet Charm Of The Bourgeoisie (Le Charme Discret de la Bourgeoisie);1972;Certified-Fresh;98;89;51;1;52;15
The Disenchanted;;Fresh;100;44;6;0;6;0
Disgrace;2008;Certified-Fresh;83;62;50;10;60;23
The Dish;2001;Certified-Fresh;96;81;95;4;99;29
Disneynature Bears;2014;Certified-Fresh;90;78;53;6;59;21
Disneynature Chimpanzee;2012;Certified-Fresh;76;75;74;24;98;31
Disneynature Crimson Wing;2008;Fresh;75;74;15;5;20;4
Disneynature Earth;2009;Certified-Fresh;86;82;81;13;94;28
Disneynature Monkey Kingdom;2015;Certified-Fresh;93;76;51;4;55;21
Disneynature Oceans;2010;Certified-Fresh;81;75;64;15;79;26
Aladdin;1992;Certified-Fresh;95;92;71;4;75;18
Disobedience;2018;Certified-Fresh;84;75;171;33;204;41
Disorder (Maryland);2016;Certified-Fresh;72;52;57;22;79;19
The Disorderly Orderly;1964;Fresh;60;68;3;2;5;0
Disorganized Crime;1989;Rotten;50;57;3;3;6;0
Distorted;2018;Rotten;18;82;2;9;11;1
Banlieue 13 - Ultimatum (District 13: Ultimatum);2009;Certified-Fresh;74;55;55;19;74;24
District 9;2009;Certified-Fresh;90;82;280;32;312;56
District B13 (Banlieue 13);2006;Certified-Fresh;80;78;93;23;116;34
Disturbia;2007;Fresh;69;77;121;54;175;48
Disturbing Behavior;1998;Rotten;34;39;13;25;38;8
Disturbing The Peace;2016;Fresh;100;69;13;0;13;5
Disturbing the Peace;2020;;;;4;16;;4
William Kunstler: Disturbing the Universe;2009;Fresh;79;78;22;6;28;12
Divergent;2014;Rotten;41;69;96;138;234;52
Divide and Conquer: The Story of Roger Ailes;2018;Certified-Fresh;90;76;46;5;51;17
Divided We Fall;2001;Certified-Fresh;90;91;56;6;62;24
Divine Secrets of the Ya-Ya Sisterhood;2002;Rotten;45;65;65;81;146;38
Divines;2016;Fresh;84;74;16;3;19;6
Divorce American Style;1967;Fresh;100;56;7;0;7;1
The Divorcee;1930;Fresh;75;63;6;2;8;0
Dixie Chicks - Shut Up and Sing;2006;Certified-Fresh;89;86;110;14;124;47
Dixieland;2015;Rotten;10;40;1;9;10;7
Django;1966;Fresh;92;84;12;1;13;1
Django;2018;Rotten;58;79;14;10;24;10
Django Unchained;2012;Certified-Fresh;87;91;250;38;288;55
Do I Sound Gay?;2015;Certified-Fresh;81;47;38;9;47;24
Do Knot Disturb;2009;Rotten;20;22;1;4;5;2
Do Not Resist;2016;Certified-Fresh;91;62;40;4;44;16
Do the Right Thing;1989;Certified-Fresh;93;90;89;7;96;22
Do You Believe?;2015;Rotten;25;83;5;15;20;6
Do You Trust this Computer?;1900;Fresh;71;94;10;4;14;4
DOA: Dead or Alive;2007;Rotten;33;36;15;31;46;14
Doc Holliday;1971;Rotten;40;47;4;6;10;3
Doc Hollywood;1991;Fresh;68;50;23;11;34;6
Doctor Dolittle;1967;Rotten;29;57;6;15;21;4
Doctor Faustus;1968;Rotten;10;30;1;9;10;3
Doctor Strange;2016;Certified-Fresh;89;86;333;41;373;56
Dodgeball - A True Underdog Story;2004;Fresh;71;76;116;48;164;38
Dodsworth;1936;Fresh;90;86;18;2;20;3
Dog Day Afternoon;1975;Certified-Fresh;96;90;43;2;45;8
Dog Days;2018;Fresh;63;76;42;25;67;18
Dog Eat Dog;2016;Rotten;50;18;35;35;70;20
Dog Park;1998;Rotten;36;28;9;16;25;6
Dog Pound;2010;Fresh;65;69;17;9;26;10
Dog Soldiers;2002;Fresh;79;79;30;8;38;4
Doghouse;2009;Rotten;48;46;11;12;23;7
Dogtooth (Kynodontas);2010;Certified-Fresh;93;76;62;5;67;22
Dogtown and Z-Boys;2001;Certified-Fresh;92;88;90;8;98;33
Dogville;2003;Fresh;70;89;117;51;168;47
Doin' It in the Park: Pick-Up Basketball, NYC;2013;Fresh;75;69;6;2;8;4
La Dolce Vita;1960;Certified-Fresh;96;90;67;3;70;22
Dolemite;1975;Rotten;57;67;8;6;14;2
Dolemite Is My Name;2019;Certified-Fresh;97;91;219;7;226;39
Dolittle;2020;Rotten;14;76;31;197;228;41
$ (Dollars) (The Heist);1971;Fresh;86;51;6;1;7;2
Dolly Parton's Coat of Many Colors;1900;Fresh;78;68;7;2;9;6
Dolores Claiborne;1995;Certified-Fresh;84;81;37;7;44;11
Dolphin Tale;2011;Certified-Fresh;81;80;92;21;113;32
Dolphin Tale 2;2014;Fresh;66;72;57;30;87;28
Dolphins;2000;Fresh;89;65;8;1;9;2
Dom Hemingway;2014;Rotten;56;38;71;56;127;37
Domain;2018;Fresh;67;53;4;2;6;1
Domestic Disturbance;2001;Rotten;24;37;24;76;100;28
Dominick Dunne: After the Party;1900;Fresh;86;93;6;1;7;1
Dominion: Prequel to the Exorcist;2005;Rotten;30;25;14;32;46;15
Domino;2005;Rotten;18;56;29;129;158;36
Domino;2019;Rotten;33;18;23;47;70;16
Don Juan DeMarco;1994;Fresh;69;68;25;11;36;12
Don 2;2011;Fresh;69;72;9;4;13;5
Don Jon;2013;Certified-Fresh;79;58;160;43;202;54
Don McKay;2010;Rotten;38;23;10;16;26;9
Don Peyote;2014;Rotten;7;29;1;13;14;5
Don Quixote;1992;Rotten;43;40;3;4;7;2
Don Verdean;2015;Rotten;29;23;11;27;38;17
Donkey Punch;2008;Rotten;52;24;27;25;52;16
Donnie Brasco;1997;Certified-Fresh;88;89;50;7;57;18
Donnie Darko;2001;Certified-Fresh;86;80;101;16;117;16
Donnybrook;2019;Rotten;39;35;18;28;46;14
Donovan's Echo;1900;Rotten;33;43;3;6;9;3
Donovan's Reef;1963;Rotten;55;76;6;5;11;0
Don't Ask Don't Tell;2002;Rotten;36;25;4;7;11;3
Don't Be a Menace to South Central While Drinking Your Juice in The Hood;1996;Rotten;31;80;8;18;26;7
Don't Be Afraid of the Dark;1973;Fresh;71;57;5;2;7;0
Don't Be Afraid Of The Dark;2011;Fresh;60;34;105;70;175;41
Don't Be Nice;2019;Fresh;100;86;10;0;10;3
Don't Bother to Knock;1952;Fresh;100;76;11;0;11;0
Don't Breathe;2016;Certified-Fresh;88;78;205;28;232;39
Don't Call Me Son (Mae So Ha Uma);2016;Fresh;83;64;15;3;18;7
Don't Come Back from the Moon;2019;Fresh;88;71;15;2;17;9
Don't Come Knocking;2006;Rotten;43;60;43;58;101;34
Don't Go;2018;Rotten;39;25;9;14;23;4
Don't Go in the House;1980;Rotten;40;33;2;3;5;0
Don't Hang Up;2017;Rotten;25;31;4;12;16;2
Don't Kill It;2017;Fresh;93;38;13;1;14;2
Don't Knock Twice;2017;Rotten;24;21;6;19;25;4
Don't Leave Home;2018;Fresh;74;22;14;5;19;5
Don't Let Go (Relive);2019;Rotten;42;79;39;53;92;18
Dont Look Back;1967;Fresh;100;92;21;0;21;7
Don't Look Now;1973;Certified-Fresh;95;76;69;4;73;17
Hot Pursuit;2015;Rotten;7;35;12;162;173;44
Don't Say a Word;2001;Rotten;24;49;27;87;114;33
Don't Sleep;2017;Rotten;9;21;1;10;11;3
Don't Stop Believin': Everyman's Journey;2013;Fresh;64;72;29;16;45;16
Don't Tell Mom the Babysitter's Dead;1991;Rotten;33;56;10;20;30;9
Don't Think Twice;2016;Certified-Fresh;98;69;132;3;135;35
Don't Torture a Duckling;1972;Fresh;83;77;5;1;6;0
Don't Trip...He Ain't Through with Me Yet;2006;Rotten;45;73;5;6;11;5
Don't Worry, He Won't Get Far on Foot;2018;Certified-Fresh;76;75;143;44;187;37
Doom;2005;Rotten;19;34;26;112;138;30
Doom: Annihilation;1900;Rotten;43;16;3;4;7;0
The Doom Generation;1995;Rotten;47;62;16;18;34;15
Doomsday;2008;Rotten;51;44;37;36;73;13
Doomsday Book;1900;Fresh;80;54;4;1;5;1
The Doors;1991;Rotten;57;79;35;26;61;17
Dopamine;2003;Rotten;52;53;27;25;52;20
Dope;2015;Certified-Fresh;89;83;140;18;158;42
Dora and the Lost City of Gold;2019;Certified-Fresh;85;88;127;23;150;23
Dorfman in Love;2013;Rotten;21;51;3;11;14;7
National Lampoon Presents Dorm Daze;2003;Rotten;0;26;0;7;7;1
Dormant Beauty;2014;Fresh;80;39;20;5;25;10
Dot the I;2003;Rotten;25;76;15;44;59;24
Double Dare;2005;Fresh;97;79;36;1;37;11
Double Dragon;1994;Rotten;13;26;2;14;16;4
Double Impact;1991;Rotten;35;42;7;13;20;4
Double Indemnity;1944;Certified-Fresh;97;95;62;2;64;13
La Double Vie de Veronique (The Double Life of Veronique);1991;Fresh;82;92;23;5;28;6
Double Lover (L'amant double);2018;Fresh;70;49;73;31;104;22
Double Team;1997;Rotten;11;25;2;17;19;5
Double Whammy;2002;Rotten;36;29;4;7;11;1
Doubt;2008;Certified-Fresh;80;78;174;43;217;56
Doug's 1st Movie;1999;Rotten;26;28;9;25;34;11
Dovlatov;2018;Fresh;80;60;12;3;15;6
Down Terrace;2010;Fresh;86;61;30;5;35;14
Down a Dark Hall;2018;Rotten;50;21;13;13;26;8
Down And Dangerous;2014;Fresh;60;26;3;2;5;2
Down and Derby;2005;Rotten;22;51;6;21;27;11
Down and Out in Beverly Hills;1986;Fresh;79;52;22;6;28;7
Down by Law;1986;Fresh;87;94;26;4;30;9
Down in the Delta;1998;Fresh;79;70;19;5;24;8
Down in the Valley;2006;Rotten;52;53;53;48;101;36
Down Periscope;1996;Rotten;12;62;4;30;34;9
Down the Shore;2013;Rotten;45;36;5;6;11;7
Down to the Bone;2005;Fresh;94;71;31;2;33;13
Down to You;2000;Rotten;3;49;2;57;59;17
Down With Love;2003;Fresh;60;62;107;72;179;41
Downfall (Der Untergang);2004;Certified-Fresh;90;94;126;14;140;35
Downhill Racer;1969;Fresh;85;59;23;4;27;8
Downriver;1900;Fresh;90;55;9;1;10;3
Downsizing;2017;Rotten;46;23;139;160;299;52
Downton Abbey;2019;Certified-Fresh;84;94;209;40;249;42
Downtown 81;2001;Fresh;79;73;23;6;29;11
Dr. Bronner's Magic Soapbox;2007;Fresh;86;62;12;2;14;8
Dr. Cyclops;1940;Fresh;77;56;10;3;13;3
Dr. Dolittle;1998;Rotten;42;35;22;30;52;10
Dr. Dolittle 2;2001;Rotten;42;26;45;62;107;33
Dr. Feelgood: Dealer or Healer?;2016;Fresh;83;48;5;1;6;3
Dr. Giggles;1992;Rotten;17;41;5;24;29;7
Dr. Goldfoot and the Bikini Machine;1965;Rotten;29;43;2;5;7;0
Dr. Jekyll and Sister Hyde;1971;Fresh;80;63;4;1;5;0
Dr. Mabuse the Gambler (Dr. Mabuse, der Spieler - Ein Bild der Zeit) (Dr. Mabuse, King of Crime);1922;Fresh;94;87;15;1;16;3
Dr. No;1962;Certified-Fresh;95;82;57;3;60;6
Dr. Phibes Rises Again;1972;Rotten;59;57;10;7;17;3
Dr. Strangelove Or How I Learned to Stop Worrying and Love the Bomb;1964;Certified-Fresh;98;94;89;2;91;14
Dr. T and the Women;2000;Rotten;57;20;62;47;109;34
Dr. Who and the Daleks;1965;Rotten;42;41;8;11;19;3
Dracula 2000;2000;Rotten;17;39;12;57;69;21
Dracula A.D. 1972;1972;Rotten;22;40;2;7;9;3
Dracula - Dead and Loving It;1995;Rotten;11;49;4;32;36;11
Dracula Has Risen From the Grave;1969;Fresh;80;60;12;3;15;1
Dracula II: Ascension;2003;Rotten;0;30;0;7;7;0
Dracula Untold;2014;Rotten;24;58;32;103;135;28
Dracula's Daughter;1936;Rotten;55;41;11;9;20;3
Draft Day;2014;Rotten;59;65;94;64;158;41
Drag Me to Hell;2009;Certified-Fresh;92;62;247;21;268;56
Dragged Across Concrete;2019;Certified-Fresh;76;68;109;35;144;28
Dragon and the Hawk;2001;Rotten;0;;0;7;7;0
Dragon Ball Super: Broly;2019;Fresh;82;92;46;10;56;3
Dragon Ball Z: Battle Of Gods;2014;Fresh;88;80;7;1;8;2
Dragon Ball Z: Resurrection 'F';2015;Fresh;83;84;15;3;18;3
Dragon Blade (Tian jiang xiong shi);2015;Rotten;36;39;17;30;47;16
Dragon: The Bruce Lee Story;1993;Fresh;71;79;15;6;21;5
Dragon Wars;2007;Rotten;30;19;11;26;37;7
Dragonball Evolution;2009;Rotten;15;20;9;52;61;14
Dragonheart;1996;Rotten;50;60;15;15;30;5
Dragonheart - A New Beginning;2000;Rotten;40;35;2;3;5;0
Dragonslayer;1981;Fresh;84;62;27;5;32;6
Dragonslayer;2011;Fresh;90;61;18;2;20;11
Dreadnaught;1981;Fresh;60;85;3;2;5;1
Dream a Little Dream;1989;Rotten;0;67;0;10;10;3
Dream Big: Engineering Our World;2017;Fresh;100;66;7;0;7;4
Dream for an Insomniac;1996;Rotten;50;75;6;6;12;3
Dream Home;2010;Fresh;76;60;16;5;21;2
Dream House;2011;Rotten;6;36;5;82;87;18
Dreamcatcher;2003;Rotten;28;35;52;131;183;41
Dreamer: Inspired by a True Story;2005;Fresh;64;78;75;42;117;32
Dreamgirls;2006;Certified-Fresh;78;71;163;45;208;54
Dreaming of Joseph Lees;1999;Rotten;36;54;5;9;14;5
Dreamland;2020;Rotten;48;;16;17;33;9
Dreams;;Fresh;65;86;17;9;26;7
Dreams of a Life;2012;Fresh;77;65;23;7;30;13
Dreams Rewired;2015;Fresh;75;45;12;4;16;7
Dreams With Sharp Teeth;2008;Fresh;100;85;22;0;22;7
Dreamscape;1984;Fresh;77;46;24;7;31;4
Dredd;2012;Certified-Fresh;79;72;130;34;164;34
The Dresser;1983;Fresh;100;87;14;0;14;1
Drew: The Man Behind The Poster;2013;Rotten;50;71;5;5;10;6
Drift;2013;Rotten;32;56;6;13;19;8
Drifter;2017;Rotten;42;12;5;7;12;2
Drillbit Taylor;2008;Rotten;25;44;37;109;146;37
Drinking Buddies;2013;Certified-Fresh;83;49;101;20;121;34
Drive Angry;2011;Rotten;47;37;58;65;123;29
Drive;2011;Certified-Fresh;92;79;245;20;265;55
Drive;1900;Rotten;0;17;0;8;8;0
Drive Hard;2014;Rotten;8;12;2;24;25;10
Drive, He Said;1971;Fresh;62;23;8;5;13;5
Drive Me Crazy;1999;Rotten;28;53;10;26;36;8
Driven;2019;Fresh;63;67;32;19;51;12
Driven;1900;Fresh;71;86;5;2;7;0
DriverX;2018;Rotten;44;87;4;5;9;4
Driveways;1900;Certified-Fresh;100;89;66;0;66;18
Drone;2017;Rotten;27;25;3;8;11;4
Drones;2014;Rotten;33;29;2;4;6;2
Drop Dead Fred;1991;Rotten;11;77;4;32;36;11
Drop Dead Gorgeous;1999;Rotten;45;75;31;38;69;22
Drop Zone;1994;Rotten;41;32;9;13;22;4
Drowning Mona;2000;Rotten;29;46;22;54;76;24
The Drowning Pool;1975;Rotten;50;50;8;8;16;5
Drug Lord: The Legend Of Shorty;2014;Fresh;63;43;5;3;8;2
Drug War;2013;Certified-Fresh;94;77;51;3;54;18
Drugstore Cowboy;1989;Fresh;100;85;28;0;28;7
Drumline;2002;Certified-Fresh;82;70;69;15;84;27
The Drum (Drums);1938;Fresh;83;56;5;1;6;0
Drums Along the Mohawk;1939;Fresh;82;60;9;2;11;0
Drunk Parents;2019;Rotten;0;16;0;5;5;0
Drunk Stoned Brilliant Dead: The Story of the National Lampoon;2015;Certified-Fresh;88;68;56;8;64;19
Drunkboat;2012;Rotten;23;23;3;10;13;5
Drunken Master (Jui kuen);1978;Fresh;79;85;15;4;19;0
Drunks;1995;Rotten;57;44;4;3;7;3
The Dry Land;2010;Fresh;64;46;16;9;25;9
DTF;1900;Fresh;67;50;4;2;6;1
Duane Hopwood;2005;Rotten;55;60;11;9;20;9
Duck;2005;Rotten;50;45;9;9;18;6
Duck Butter;2018;Rotten;57;42;21;16;37;15
Duck Season (Temporada de patos);2006;Certified-Fresh;91;78;69;7;76;27
Duck Soup;1933;Certified-Fresh;92;91;47;4;51;10
Duck, You Sucker (A Fistful of Dynamite) (Giu la testa);1972;Fresh;92;83;22;2;24;6
DuckTales: The Movie - Treasure of the Lost Lamp;;Fresh;88;69;7;1;8;3
Dude Bro Party Massacre III;2015;Fresh;90;77;9;1;10;0
Dude, Where's My Car?;2000;Rotten;17;47;10;48;58;16
Dudley Do-Right;1999;Rotten;16;23;7;38;45;15
Due Date;2010;Rotten;39;52;76;117;193;43
The Duellists;1977;Fresh;92;83;24;2;26;5
The Dukes;2007;Rotten;57;34;13;10;23;13
The Dukes of Hazzard;2005;Rotten;14;47;23;147;170;42
The Dukes of Hazzard: The Beginning;2007;Rotten;20;47;1;4;5;0
Dum Maaro Dum;2011;Rotten;50;43;3;3;6;2
Duma;2005;Certified-Fresh;93;80;57;4;61;28
Dumb and Dumber;1994;Fresh;68;84;36;17;53;13
Dumb and Dumber To;2014;Rotten;30;35;45;106;151;36
Dumb and Dumberer: When Harry Met Lloyd;2003;Rotten;10;23;12;107;119;33
Dumbo;1941;Certified-Fresh;98;70;41;1;42;6
Dumbo;2019;Rotten;46;48;168;195;363;46
Dumbstruck;2011;Fresh;72;78;21;8;29;12
Dumplin';2018;Certified-Fresh;85;74;53;9;62;16
The Dungeon Masters;2008;Fresh;67;27;4;2;6;0
Dungeons & Dragons;2000;Rotten;10;19;9;83;92;29
Dunkirk;2017;Certified-Fresh;92;81;419;34;453;61
Dunston Checks In;1996;Rotten;12;40;2;15;17;5
The Dunwich Horror;1970;Rotten;17;30;1;5;6;0
Duplex;2003;Rotten;35;40;39;73;112;32
Duplicity;2009;Fresh;66;37;124;65;189;47
Dust;2003;Rotten;20;62;3;12;15;5
Dust Devil;1992;Rotten;29;60;2;5;7;0
The Dust Factory;2004;Rotten;9;57;1;10;11;4
Dust to Glory;2005;Fresh;60;91;41;27;68;23
Dying Breed;2009;Rotten;50;23;5;5;10;3
The Dying Gaul;2005;Rotten;50;52;35;35;70;24
Dying Laughing;2017;Fresh;89;29;17;3;19;8
Dying of the Light;2014;Rotten;8;15;3;33;36;12
Dying To Know: Ram Dass & Timothy Leary;2014;Fresh;78;83;7;2;9;4
Dynamite Warrior;2007;Fresh;67;35;10;5;15;6
Dysfunktional Family;2003;Rotten;43;77;27;36;63;20
E-Demon;2018;Rotten;33;78;2;4;6;0
Eagle Eye;2008;Rotten;26;62;48;135;183;46
Eagle vs Shark;2007;Rotten;55;67;59;48;107;41
Eagles of Death Metal: Nos Amis (Our Friends);2017;Fresh;100;92;7;0;7;4
Eames: The Architect And The Painter;2011;Fresh;88;82;22;3;25;14
Early Man;2018;Certified-Fresh;80;49;140;34;174;37
Early Summer;1951;Fresh;100;93;11;0;11;1
Earth Girls Are Easy;1989;Fresh;68;42;23;11;34;8
Earth: One Amazing Day;2017;Fresh;100;84;21;0;21;7
Earth to Echo;2014;Rotten;50;47;63;62;125;34
Earth vs. the Flying Saucers;1956;Fresh;73;54;11;4;15;0
Earthquake;1974;Rotten;42;35;11;15;26;4
Earthquake Bird;2019;Rotten;50;54;20;20;40;10
Easier with Practice;2009;Fresh;88;70;30;4;34;13
East Palace West Palace (Dong gong xi gong) (Behind the Forbidden City);1998;Fresh;80;59;4;1;5;0
East Is East;1999;Fresh;78;78;25;7;32;7
East Side Sushi;2015;Fresh;95;83;19;1;20;8
East Side, West Side;1949;Rotten;33;74;2;4;6;2
Easter Bunny, Kill! Kill!;1900;Fresh;100;;5;0;5;0
Easter Parade;1948;Fresh;91;86;21;2;23;6
Eastern Boys;2015;Fresh;89;76;33;4;37;13
Eastern Promises;2007;Certified-Fresh;89;83;178;22;200;49
East/West;2000;Fresh;65;88;20;11;31;7
Easy;2004;Rotten;59;48;10;7;17;7
Easy A;2010;Certified-Fresh;85;77;162;28;190;41
Easy Come, Easy Go;1967;Rotten;43;37;3;4;7;1
Easy Does It;1900;Rotten;29;79;2;5;7;1
Easy Living;1900;Rotten;40;19;2;3;5;1
Easy Living;2017;Fresh;78;76;7;2;9;2
Easy Money: Hard to Kill;2014;Rotten;50;45;10;10;20;10
Easy Rider;1969;Certified-Fresh;83;82;44;9;53;8
Eat Drink Man Woman (Yin shi nan nu);1994;Certified-Fresh;88;92;43;6;49;13
Eat Pray Love;2010;Rotten;36;42;74;129;203;47
Eat That Question: Frank Zappa in His Own Words;2016;Certified-Fresh;92;73;67;6;73;23
Eat the Rich;1987;Rotten;43;81;3;4;7;5
Eating;;Fresh;75;40;6;2;8;1
Eating Animals;2018;Certified-Fresh;91;74;42;4;46;17
Eating Out;2004;Rotten;16;58;4;21;25;11
Eating Out 2: Sloppy Seconds;2006;Rotten;44;63;7;9;16;10
Eating Out: All You Can Eat;2009;Rotten;17;53;1;5;6;4
Eating Raoul;1982;Fresh;86;72;18;3;21;2
Eating Up Easter;1900;Fresh;86;;6;1;7;1
Echelon Conspiracy;2009;Rotten;8;31;1;12;13;3
Echo In the Canyon;2019;Certified-Fresh;90;92;71;8;79;19
Echoes of Innocence;2005;Rotten;0;62;0;7;7;3
Echoes of War;2015;Rotten;31;44;4;9;13;5
Ecstasy;2012;Rotten;15;24;3;17;20;7
Ed;1996;Rotten;0;22;0;16;16;5
Ed Gein;2001;Rotten;10;40;1;9;10;2
Ed Wood;1994;Certified-Fresh;92;88;60;5;65;14
EDC 2013: Under the Electric Sky;2014;Rotten;53;66;8;7;15;8
Eddie Murphy: Delirious;1900;Fresh;83;;5;1;6;0
Eddie Murphy Raw;1987;Fresh;81;85;17;4;21;3
Eddie The Eagle;2016;Certified-Fresh;82;82;163;36;199;38
Eddie The Sleepwalking Cannibal;2013;Fresh;61;52;11;7;18;9
Eden;1998;Rotten;50;59;6;6;12;5
Eden;2013;Certified-Fresh;85;68;34;6;40;15
Eden;2015;Certified-Fresh;83;57;87;18;105;30
Eden Lake;2008;Fresh;79;66;22;6;28;8
Eden Log;2007;Rotten;50;34;4;4;8;0
The Edge;1997;Fresh;64;70;32;18;50;12
Edge of Darkness;2010;Rotten;55;49;119;96;215;49
The Edge of Love;2008;Rotten;37;43;22;37;59;21
Edge of Seventeen;1999;Fresh;78;73;18;5;23;9
Edge of Winter;2016;Rotten;50;33;11;11;22;7
Edie;2019;Fresh;62;70;26;16;42;13
Edison (Edison Force);2006;Rotten;13;36;1;7;8;2
Edmond;2005;Rotten;47;45;35;39;74;26
EDtv;1999;Fresh;64;30;30;17;47;9
The Education of Charlie Banks;2009;Rotten;48;45;15;16;31;15
The Education of Little Tree;1997;Rotten;59;75;10;7;17;6
Edward Scissorhands;;Certified-Fresh;90;91;54;6;60;11
Edwin Boyd (Citizen Gangster);2012;Rotten;53;40;8;7;15;8
Eegah;1962;Rotten;0;22;0;8;8;0
Egg;2019;Fresh;100;38;11;0;11;4
Eight Below;2006;Certified-Fresh;73;79;111;42;153;41
Eight Legged Freaks;2002;Rotten;48;32;69;76;145;29
Eight Men Out;1988;Certified-Fresh;86;80;44;7;51;12
Eight Miles High!;2008;Rotten;47;54;8;9;17;8
Eighth Grade;2018;Certified-Fresh;99;82;302;3;305;50
Eyes Wide Open (Einaym Pkuhot);2010;Fresh;86;77;30;5;35;15
Eisenstein In Guanajuato;2016;Fresh;61;51;33;21;54;19
Ejecta;2015;Rotten;40;15;4;6;10;1
EK MAIN AIR EKK TU;2012;Fresh;67;39;6;3;9;3
Eklavya;2007;Fresh;75;64;6;2;8;4
El Nino Pez (The Fish Child);2009;Fresh;80;46;4;1;5;0
El artista y la modelo (The Artist and the Model);2013;Fresh;70;55;30;13;43;22
El Aura (The Aura);2006;Certified-Fresh;87;76;41;6;47;17
El Bulli: Cooking In Progress;2011;Fresh;60;49;28;19;47;22
El Camino: A Breaking Bad Movie;2019;Certified-Fresh;91;81;115;11;126;27
El Camino Christmas;2017;Rotten;40;39;2;3;5;0
El Cantante;2007;Rotten;25;63;27;80;107;40
El Chicano;2019;Rotten;38;55;9;15;24;12
El Dorado;1967;Fresh;100;87;22;0;22;6
El Mariachi;1993;Fresh;93;76;27;2;29;7
El Norte;1984;Fresh;86;82;18;3;21;4
El Topo;1970;Certified-Fresh;79;84;34;9;43;14
Elaine Stritch: Shoot Me;2014;Certified-Fresh;99;79;66;1;67;33
Election;1999;Certified-Fresh;92;79;104;9;113;25
Triad Election (Hak se wui yi wo wai kwai);2007;Certified-Fresh;96;81;46;2;48;22
Electra Glide in Blue;1973;Fresh;60;75;6;4;10;0
Electric Boogaloo: The Wild, Untold Story of Cannon Films;2012;Certified-Fresh;91;81;43;4;47;7
The Electric Horseman;1979;Fresh;64;57;14;8;22;4
Electric Man;2012;Rotten;20;55;2;8;10;3
Electric Slide;2015;Rotten;14;28;1;6;7;2
Electroma;2006;Fresh;60;73;3;2;5;1
Elektra;2005;Rotten;11;29;18;148;166;42
Elektra Luxx;2011;Rotten;24;19;8;25;33;11
Elena;2012;Certified-Fresh;94;73;61;4;65;26
Elephant;2003;Fresh;73;79;118;43;161;46
Elephant Walk;1954;Fresh;60;50;6;4;10;4
Elevator to the Gallows (Ascenseur pour l'echafaud);1958;Certified-Fresh;93;91;53;4;57;25
Elf;2003;Certified-Fresh;84;79;163;31;194;47
Elf: Buddy's Musical Christmas;2014;Fresh;89;42;8;1;9;7
Elfie Hopkins;2012;Rotten;0;14;0;16;16;5
Eli;2019;Rotten;48;38;12;13;25;3
Elis;2018;Rotten;29;67;2;5;7;1
Elisa & Marcela;1900;Rotten;43;;6;8;14;3
Tropa de Elite (The Elite Squad);2007;Rotten;53;87;18;16;34;12
Elite Squad: The Enemy Within;1900;Certified-Fresh;93;91;42;3;45;22
Stonehearst Asylum;2014;Rotten;54;49;31;26;56;16
Elizabeth Harvest;2018;Rotten;52;40;11;10;21;7
Elizabethtown;2005;Rotten;28;66;50;126;176;43
Ella Enchanted;2004;Rotten;50;57;58;57;115;32
Elle;2016;Certified-Fresh;91;73;216;21;237;43
$ellebrity;2013;Fresh;63;53;5;3;8;3
Elles;2012;Rotten;23;26;14;47;61;23
Ellie Parker;2005;Rotten;51;43;25;24;49;18
Elling;2002;Certified-Fresh;85;91;50;9;59;18
Eloise;2017;Rotten;11;17;1;8;9;5
Elsa & Fred;2014;Rotten;32;50;9;19;28;12
Elstree 1976;2016;Fresh;81;39;22;5;27;10
Elvira, Mistress of the Dark;1988;Rotten;50;65;10;10;20;4
Elvira's Haunted Hills;2001;Fresh;67;46;6;3;9;3
Elvis & Nixon;2016;Certified-Fresh;77;57;118;35;153;39
Elvis from Outer Space;2020;Rotten;0;;0;6;6;0
Elvis: That's the Way It Is;1970;Fresh;91;92;10;1;11;2
Elysium;2013;Fresh;65;58;167;89;255;57
Emanuel;2019;Fresh;100;98;19;0;19;6
Embrace Of The Serpent (El Abrazo De La Serpiente);2016;Certified-Fresh;96;84;140;6;146;41
Embrace of the Vampire;1900;Rotten;10;27;1;9;10;0
Emelie;2016;Fresh;88;41;30;4;34;9
Emergo (Apartment 143);2012;Rotten;17;22;1;5;6;1
Emma.;2020;Certified-Fresh;87;72;204;31;235;42
Emmanuel's Gift;2005;Fresh;82;85;18;4;22;8
Emmet Otter's Jug-Band Christmas;1977;Fresh;100;85;8;0;8;1
Empathy, Inc.;2019;Fresh;85;88;23;4;27;4
Emperor;2013;Rotten;32;46;29;62;91;30
Emperor;2020;Fresh;77;68;10;3;13;4
The Emperor's New Clothes;2002;Fresh;73;63;62;23;85;29
The Emperor's New Groove;2000;Certified-Fresh;85;83;112;19;131;34
The Empire in Africa;2006;Fresh;67;79;6;3;9;3
Empire of the Ants;1977;Rotten;6;25;1;17;18;3
Empire of the Sun;1987;Certified-Fresh;75;90;42;14;56;13
Empire Records;1995;Rotten;29;84;10;24;34;9
Star Wars: Episode V - The Empire Strikes Back;1980;Certified-Fresh;94;97;97;6;103;29
Employee of the Month;2006;Rotten;20;53;18;74;92;30
Empties (Vratne lahve);2007;Fresh;100;82;5;0;5;3
A Royal Affair;2012;Certified-Fresh;90;82;99;11;110;35
En soap;2006;Rotten;55;69;6;5;11;6
Enchanted;2007;Certified-Fresh;93;80;177;14;191;49
Enchanted April;1992;Fresh;84;83;27;5;32;9
Encino Man;1992;Rotten;15;56;5;29;34;9
End Game;2018;Fresh;100;84;7;0;7;1
The End of America;2008;Fresh;80;73;8;2;10;3
End of Days;1999;Rotten;11;32;11;91;102;26
The End Of Poverty;2008;Rotten;52;76;12;11;23;8
End of Sentence;2020;Certified-Fresh;92;94;49;4;53;7
End of the Century: The Story of the Ramones;2004;Certified-Fresh;95;93;59;3;62;29
End of the Spear;2006;Rotten;41;82;22;32;54;18
The End of Violence;1997;Rotten;29;44;10;25;35;10
End of Watch;2012;Certified-Fresh;85;86;152;27;179;51
Ender's Game;2013;Fresh;62;65;138;85;223;47
Endings, Beginnings;2020;Rotten;44;59;31;39;70;13
Endless;2020;Rotten;13;11;3;21;24;5
Endless Love;1900;Rotten;28;52;5;13;18;5
Endless Love;2014;Rotten;16;58;15;80;94;31
Endless Poetry (Poesia Sin Fin);2017;Certified-Fresh;93;81;55;4;59;16
The Endless Summer;1966;Fresh;100;91;22;0;22;5
Endurance;1999;Rotten;50;50;13;13;26;9
Enduring Love;2004;Rotten;59;60;58;41;99;38
Enemies of the People;2010;Fresh;100;85;33;0;33;12
Enemies, a Love Story;1989;Fresh;85;52;11;2;13;1
Enemies Closer;2014;Fresh;79;29;11;3;14;7
Enemies of Laughter;2003;Rotten;57;;4;3;7;1
Enemy;2014;Certified-Fresh;70;63;83;35;118;31
Enemy at the Gates;2001;Rotten;53;82;74;65;139;34
The Enemy Below;1957;Fresh;86;87;6;1;7;0
Enemy Lines;1900;Rotten;20;48;1;4;5;1
Enemy Mine;1985;Fresh;63;68;15;9;24;1
Enemy of the State;1998;Fresh;72;78;62;24;86;22
Enemy Territory (Septembers Of Shiraz);2016;Rotten;31;44;4;9;13;7
England Is Mine;2017;Rotten;52;37;34;31;65;15
The English Patient;1996;Certified-Fresh;85;83;75;13;88;31
English Vinglish;2012;Fresh;80;83;4;1;5;4
The Englishman Who Went up a Hill But Came Down A Mountain;1995;Rotten;58;55;14;10;24;7
The Enigma of Kaspar Hauser (Jeder fur sich und Gott gegen alle)(Every Man for Himself and God Against All);1974;Fresh;95;90;20;1;21;8
Enough Said;2013;Certified-Fresh;95;75;182;9;190;53
Enron: The Smartest Guys in the Room;2005;Certified-Fresh;97;87;116;3;119;38
Entangled;2019;Rotten;20;;1;4;5;0
Entanglement;2018;Fresh;64;52;23;13;36;10
Enter the Anime;1900;Rotten;0;;0;5;5;0
Enter the Dangerous Mind;2015;Rotten;23;29;3;10;13;4
Enter the Dragon;1973;Certified-Fresh;94;92;50;3;53;11
Enter the Fat Dragon;2020;Fresh;64;90;7;4;11;0
Enter the Void (Soudain le vide);2010;Fresh;72;72;66;26;92;26
Enter The Warriors Gate (Warrior's Gate);2017;Rotten;50;43;4;4;8;1
Entertaining Angels: The Dorothy Day Story;1996;Rotten;50;69;3;3;6;1
Entertainment;2015;Certified-Fresh;83;46;44;10;53;19
Entourage;2015;Rotten;33;57;70;143;213;46
Entrapment;1999;Rotten;39;50;32;51;83;18
Step Up To The Plate;2012;Fresh;67;45;18;9;27;12
Entre nos (Between Us);1900;Fresh;88;84;7;1;8;3
Entropy;1999;Rotten;40;75;2;3;5;0
Entwined;2020;Fresh;63;;12;7;19;0
Epic;2013;Fresh;65;65;82;45;127;30
Epic Movie;2007;Rotten;2;29;1;65;66;19
Equal Means Equal;2016;Fresh;75;67;6;2;8;2
Equalizer 2;2018;Rotten;52;61;103;97;200;39
Equals;2016;;;42;30;53;;29
Equilibrium;2002;Rotten;41;81;37;54;91;25
Equity;2016;Certified-Fresh;82;52;81;18;99;26
Eragon;2006;Rotten;16;47;20;105;125;33
Erased;2013;Rotten;28;36;13;33;46;19
Eraser;1996;Rotten;38;39;19;31;50;15
Eraserhead;1977;Certified-Fresh;90;83;54;6;59;13
Erik the Viking;1989;Rotten;47;58;8;9;17;6
Erin Brockovich;2000;Certified-Fresh;84;81;123;23;146;38
Ernest in the Army;1998;Rotten;17;32;1;5;6;0
Ernest Scared Stupid;1991;Rotten;17;50;1;5;6;0
Ernest & Celestine;2014;Certified-Fresh;98;88;79;2;80;24
Ernest Goes to Jail;;Rotten;13;48;1;7;8;0
Ernest Rides Again;1993;Rotten;14;43;1;6;7;2
Ernest Saves Christmas;1988;Rotten;36;42;5;9;14;1
Eros;2004;Rotten;34;45;23;45;68;26
The Errand Boy;1961;Rotten;50;72;5;5;10;1
Errementari: The Blacksmith and the Devil (El herrero y el diablo);2018;Fresh;78;71;7;2;9;1
Errors Of The Human Body;2013;Fresh;75;41;9;3;12;1
Escaflowne: The Movie;2000;Rotten;43;69;6;8;14;4
Escanaba in da Moonlight;2000;Rotten;50;79;3;3;6;3
Escape and Evasion;1900;Fresh;80;;4;1;5;2
Escape Fire: The Fight to Rescue American Healthcare;2012;Fresh;78;92;18;5;23;10
Escape From Alcatraz;1979;Fresh;96;85;26;1;27;5
John Carpenter's Escape from L.A.;1996;Rotten;53;39;27;24;51;15
Escape From Planet Earth;2013;Rotten;35;54;15;28;43;14
Escape from Pretoria;2020;Fresh;71;74;30;12;42;7
Escape from the Planet of the Apes;1971;Fresh;77;53;23;7;30;7
Escape From Tomorrow;2013;Rotten;57;25;50;37;86;30
Escape Plan;2013;Rotten;50;55;56;55;111;28
Escape Plan 2: Hades;1900;Rotten;8;15;2;22;24;4
Escape Plan: The Extractors;1900;Rotten;25;30;3;9;12;1
Escape Room;2019;Rotten;51;51;80;77;157;24
Escape to Witch Mountain;1975;Fresh;76;59;16;5;21;4
Essential Killing;1900;Certified-Fresh;77;46;40;12;52;19
Essex Boys;2000;Rotten;17;62;1;5;6;1
Esteros;2016;Fresh;100;76;8;0;8;2
Estranged;1900;Fresh;100;34;6;0;6;1
E.T. The Extra-Terrestrial;1982;Certified-Fresh;98;72;128;2;130;37
Eternal Sunshine of the Spotless Mind;2004;Certified-Fresh;93;94;229;18;247;52
Ethan Mao;2004;Rotten;36;59;4;7;11;7
Ethan Frome;1993;Rotten;55;39;6;5;11;3
Etoiles: Dancers of the Paris Opera Ballet;2002;Fresh;62;79;8;5;13;6
Etz Limon (Lemon Tree);2009;Certified-Fresh;91;83;62;6;68;26
Eulogy;2004;Rotten;34;71;12;23;35;9
Eulogy for a Vampire;1900;Rotten;0;14;0;6;6;3
Euphoria;2019;Rotten;19;38;5;21;26;7
Eureka;1984;Rotten;33;50;2;4;6;2
Europa Report;2013;Certified-Fresh;81;57;65;15;80;22
Eurotrip;2003;Rotten;47;75;56;64;120;29
Eva;1962;Fresh;67;56;8;4;12;4
Eva Hesse;2016;Fresh;80;64;16;4;20;11
Evan Almighty;2007;Rotten;23;52;45;150;195;51
Eve of Destruction;;Rotten;20;14;2;8;10;0
Evelyn;2002;Fresh;64;78;75;42;117;34
Even Dwarfs Started Small (Auch Zwerge haben klein angefangen);1970;Fresh;100;77;9;0;9;2
Even Money;2006;Rotten;24;29;8;26;34;14
The Even Stevens Movie;2003;Rotten;40;52;2;3;5;2
Even the Rain (Meme La Pluie);2011;Certified-Fresh;87;85;53;8;61;21
Evening;2007;Rotten;27;48;35;94;129;45
The Evening Star;1996;Rotten;22;62;6;21;27;7
Event Horizon;1997;Rotten;28;61;21;55;76;18
Ever After: A Cinderella Story;1998;Certified-Fresh;91;84;59;6;65;17
Everest;1998;Fresh;93;75;13;1;14;2
Everest;2015;Fresh;73;68;165;63;227;46
Evergreen;2004;Rotten;44;30;16;20;36;19
Evergreen: The Road to Legalization in Washington;2014;Fresh;83;47;10;2;12;7
Everlasting;1900;Fresh;100;82;11;0;11;0
An Everlasting Piece;2001;Rotten;48;78;22;24;46;20
Everly;2015;Rotten;30;29;17;41;57;15
Every Act of Life;1900;Fresh;91;100;10;1;11;3
Ever Again;2006;Rotten;50;54;7;7;14;12
Every Day;2011;Rotten;34;24;11;21;32;12
Every Day;2018;Fresh;63;55;39;23;62;15
Every Little Step;2009;Certified-Fresh;92;88;88;8;96;34
Every Man for Himself (Sauve qui peut (la vie));1980;Fresh;100;65;5;0;5;0
Every Secret Thing;2015;Rotten;32;32;12;26;38;18
Every Thing Will Be Fine;2015;Rotten;28;23;11;29;40;16
Every Time I Die;2019;Fresh;100;55;9;0;9;2
Every Which Way But Loose;1978;Rotten;37;55;10;17;27;5
Everybody Knows (Todos lo saben);2019;Certified-Fresh;78;60;138;39;177;36
Everybody Knows... Elizabeth Murray;2017;Fresh;100;17;6;0;6;5
Everybody Loves Somebody;2017;Fresh;89;70;17;2;19;5
Everybody Wants Some!!;2016;Certified-Fresh;87;68;208;32;240;52
Everybody Wants to Be Italian;2007;Rotten;9;33;2;21;23;10
Everybody's All-American;1988;Rotten;42;46;13;18;31;11
Everybody's Famous!;2001;Rotten;55;64;29;24;53;21
Everyday;2013;Fresh;74;42;25;9;34;14
Everyday Sunshine: The Story of Fishbone;2011;Certified-Fresh;100;85;47;0;47;16
Everyone Stares: The Police Inside Out;1900;Rotten;29;64;2;5;7;2
Everyone's Hero;2006;Rotten;42;44;29;40;69;27
Everything, Everything;2017;Rotten;45;61;54;67;121;24
Everything is Illuminated;2005;Fresh;67;89;80;40;120;34
Everything Must Go;2011;Certified-Fresh;73;53;98;36;134;42
Everything Strange and New;2011;Fresh;67;27;4;2;6;3
Everything You Always Wanted to Know About Sex * But Were Afraid to Ask;1972;Fresh;88;69;21;3;24;0
Everything's Cool;2007;Rotten;50;77;4;4;8;4
Eve's Bayou;1996;Certified-Fresh;82;90;46;10;56;18
Evidence;2013;Rotten;6;28;1;16;17;8
Evil Dead 2: Dead by Dawn;1987;Certified-Fresh;95;89;57;3;60;11
Evil Little Things;1900;Rotten;50;0;3;3;6;0
The Evil of Frankenstein;1964;Rotten;57;36;4;3;7;0
Evil Under the Sun;1982;Fresh;90;72;9;1;10;1
Evilspeak;1982;Rotten;43;37;6;8;14;1
Evita;1996;Fresh;63;68;24;14;38;7
Evocateur: The Morton Downey Jr. Movie;2013;Fresh;91;84;30;3;33;22
Evolution;2016;Certified-Fresh;83;44;52;11;63;18
Ex Drummer;2011;Rotten;44;71;8;10;18;10
Ex Machina;2015;Certified-Fresh;92;86;254;21;275;53
Exam;1900;Fresh;63;56;19;11;30;6
Examined Life;2009;Fresh;77;73;27;8;35;19
Excalibur;1981;Certified-Fresh;80;80;36;9;45;6
Excess Baggage;1997;Rotten;32;41;10;21;31;6
Excision;1900;Fresh;84;61;21;4;25;6
Excuse Me for Living;2012;Rotten;14;15;1;6;7;7
Executive Action;1973;Fresh;67;61;6;3;9;1
Executive Suite;1954;Fresh;100;72;9;0;9;1
Exhibition;2014;Fresh;84;44;27;5;32;12
Fong juk (Exiled);2006;Certified-Fresh;80;80;52;13;65;23
Existenz;1999;Fresh;74;69;53;19;72;15
Exists;2014;Rotten;33;29;8;16;24;7
Exit Plan (Selvmords turisten);2020;Rotten;38;33;10;16;26;6
Exit Through The Gift Shop;2010;Certified-Fresh;96;91;108;5;113;40
Exit Wounds;2001;Rotten;33;45;22;44;66;19
Exodus: Gods and Kings;2014;Rotten;30;35;62;144;206;50
The Exorcism of Emily Rose;2005;Rotten;44;60;70;88;158;31
The Exorcist;1973;Certified-Fresh;83;87;67;14;81;19
The Exorcist III;;Rotten;59;55;24;17;41;5
Exorcist II: The Heretic;1977;Rotten;15;13;4;23;27;0
Exorcist: The Beginning;2004;Rotten;10;27;14;120;134;25
Expelled: No Intelligence Allowed;2008;Rotten;11;68;5;42;47;19
Experiment in Terror;1962;Fresh;100;77;7;0;7;1
Experiment Perilous;1944;Fresh;100;36;6;0;6;0
Experimenter;2015;Certified-Fresh;85;61;68;12;79;19
Expired;2008;Rotten;59;45;13;9;22;9
Explicit Ills;2009;Rotten;52;39;13;12;25;11
The Exploding Girl;2010;Fresh;76;54;28;9;37;13
Explorers;1985;Fresh;77;67;20;6;26;4
Exporting Raymond;2011;Fresh;72;67;18;7;25;12
Exposed;2016;Rotten;8;15;2;23;25;7
Exterminating Angels;2007;Rotten;49;32;22;23;45;18
The Exterminator;1980;Rotten;38;40;5;8;13;4
Extinction;2015;Rotten;18;33;2;9;11;3
Extinction;2018;Rotten;33;47;8;16;24;3
The Extra Man;2010;Rotten;42;37;30;42;72;28
Extraction;2015;Rotten;6;17;1;17;18;6
Extraction;1900;Fresh;66;69;137;70;207;32
Extracurricular;1900;Fresh;67;42;4;2;6;0
Extraordinary Measures;2010;Rotten;29;53;41;102;143;41
Extraordinary Tales;2015;Rotten;58;49;11;8;19;8
Extraterrestrial;2012;Fresh;69;39;20;9;29;10
Extraterrestrial;2014;Rotten;29;26;11;27;38;11
Extreme Measures;1996;Rotten;56;40;19;15;34;8
Extreme Ops;2002;Rotten;7;28;5;62;67;21
Extreme Prejudice;1987;Fresh;70;58;7;3;10;1
An Extremely Goofy Movie;2000;Fresh;63;48;5;3;8;0
Extremely Loud & Incredibly Close;2012;Rotten;45;61;85;102;187;51
Extremely Wicked, Shockingly Evil and Vile;2019;Rotten;54;57;98;82;180;27
Extremities;1986;Rotten;40;65;4;6;10;1
Extremity;2018;Fresh;100;44;5;0;5;0
Eye for an Eye;1996;Rotten;8;55;3;35;38;14
Eye for an Eye (Quien a hierro mata);1900;Fresh;88;61;7;1;8;0
Eye In The Sky;2016;Certified-Fresh;95;82;205;11;216;40
Eye of the Dolphin;2007;Rotten;29;58;5;12;17;6
Eye of the Needle;1981;Fresh;82;74;14;3;17;1
Eyes of Laura Mars;1978;Rotten;50;43;13;13;26;7
The Eyes of Tammy Faye;2000;Fresh;86;72;31;5;36;8
Eyes Wide Shut;1999;Certified-Fresh;75;73;118;39;157;40
Eyes Without a Face;1962;Certified-Fresh;98;87;54;1;55;12
F;2010;Fresh;77;23;10;3;13;5
F for Fake;1974;Certified-Fresh;88;89;44;6;50;15
A Face in the Crowd;1957;Fresh;88;94;28;4;32;4
Face to Face;1900;Fresh;91;91;10;1;11;1
Face/Off;1997;Certified-Fresh;92;82;80;7;87;28
Faces;1968;Fresh;83;87;20;4;24;2
Faces in the Crowd;1900;Rotten;0;34;0;5;5;0
Faces Places (Visages, villages);2017;Certified-Fresh;99;89;139;2;141;29
Facing the Giants;2006;Rotten;16;85;4;21;25;6
Facing Windows;2004;Fresh;63;87;42;25;67;29
Factory Girl;2007;Rotten;20;60;23;91;114;43
Factotum;2006;Certified-Fresh;75;62;91;30;121;36
The Faculty;1998;Rotten;52;55;27;25;52;7
Fading Of The Cries;2011;Rotten;0;39;0;7;7;4
Fading Gigolo;2014;Rotten;54;41;78;66;144;44
Fados;2009;Fresh;96;81;25;1;26;14
Fagara (Huajiao zhiwei);2019;Fresh;100;86;8;0;8;2
Fahrenheit 11/9;2018;Certified-Fresh;82;61;149;33;182;38
Fail-Safe;1964;Fresh;93;91;25;2;27;3
Failure to Launch;2006;Rotten;23;52;36;118;154;40
Fair Game;2010;Certified-Fresh;79;65;139;37;176;45
Fairy Tale: A True Story;1997;Rotten;57;66;13;10;23;6
Faith Connections;2014;Rotten;40;82;2;3;5;2
Faith Of Our Fathers;2015;Rotten;9;56;1;10;11;5
Faithful;1996;Rotten;7;49;1;14;15;6
Fake It So Real;2012;Fresh;91;49;10;1;11;7
The Falcon and the Snowman;1985;Fresh;82;69;18;4;22;4
Falcon Rising;2014;Rotten;43;43;3;4;7;5
Fall Down Dead;2007;Rotten;0;5;0;7;7;1
The Fall of Fujimori;2006;Fresh;92;91;12;1;13;8
The Fall of the Roman Empire;1964;Fresh;100;69;11;0;11;1
Fall to Grace;2006;Rotten;56;20;5;4;9;3
Fallen (Falling);2006;Rotten;27;43;3;8;11;5
Fallen;2017;Rotten;7;66;1;13;14;3
The Fallen Idol;1949;Fresh;100;88;34;0;34;14
Falling Angels;2005;Fresh;63;66;5;3;8;3
Falling Down;1993;Certified-Fresh;73;84;41;15;56;12
Falling from Grace;1992;Fresh;78;44;7;2;9;3
Falling in Love;1984;Rotten;58;63;7;5;12;2
Falling Inn Love;1900;Fresh;65;32;13;7;20;3
Falling Overnight;2012;Rotten;40;64;2;3;5;3
Fame;1980;Fresh;84;69;26;5;31;8
Fame-ish;1900;Fresh;86;;6;1;7;0
Family Business;1989;Rotten;38;27;6;10;16;1
The Family Jewels;1965;Fresh;80;72;4;1;5;1
The Family Man;2000;Rotten;53;67;68;60;128;33
Family Plot;1976;Fresh;92;62;33;3;36;8
Family Romance, LLC;1900;Certified-Fresh;75;70;38;13;51;14
The Family Stone;2005;Rotten;53;63;83;75;158;40
A Family Thing;1996;Fresh;73;71;16;6;22;6
Family Weekend;2013;Rotten;36;51;8;14;22;10
Famous Nathan;1900;Fresh;100;69;7;0;7;5
Fanboys;2008;Rotten;32;57;31;66;97;30
Fancy Pants;1950;Fresh;80;72;4;1;5;0
Fando y Lis (Fando and Lis);1970;Fresh;70;75;7;3;10;4
Fanny & Alexander;1982;Fresh;100;94;37;0;37;15
Fanny, Annie & Danny;2011;Fresh;67;83;6;3;9;3
Fantasia 2000;2000;Certified-Fresh;81;75;69;16;85;22
Fantastic Beasts and Where to Find Them;2016;Certified-Fresh;74;79;250;88;338;58
Fantastic Beasts: The Crimes of Grindelwald;2018;Rotten;36;54;117;206;323;42
Fantastic Four;2005;Rotten;27;45;58;156;214;41
Fantastic Four;2015;Rotten;9;18;23;235;258;51
Fantastic Four: Rise of the Silver Surfer;2007;Rotten;37;51;63;107;170;44
Fantastic Planet;1973;Fresh;91;87;29;3;32;4
Fantastic Voyage;1966;Fresh;91;67;30;3;33;4
Fantasy Island;2020;Rotten;7;48;8;99;107;20
Far and Away;1992;Rotten;50;62;18;18;36;10
Far From Heaven;2003;Certified-Fresh;88;80;193;27;220;54
Far From Home - The Adventures Of Yellow Dog;1995;Rotten;57;53;4;3;7;0
Far from Men;2015;Fresh;84;72;27;5;32;10
Far From the Madding Crowd;2015;Certified-Fresh;84;75;160;30;190;53
Far From the Tree;2018;Certified-Fresh;90;95;38;4;42;15
Far Out Isn't Far Enough: The Tomi Ungerer Story;2013;Fresh;91;89;21;2;23;9
Farewell (L'affaire Farewell);2010;Certified-Fresh;86;76;66;11;77;30
Farewell;2010;;;;0;0;;0
Farewell, Herr Schwarz;2015;Fresh;91;50;10;1;11;5
Farewell, My Queen;2012;Certified-Fresh;93;56;77;6;83;27
A Farewell to Arms;1932;Fresh;93;53;14;1;14;2
Farewell to the King;1989;Rotten;55;54;6;5;11;1
Fargo;1996;Certified-Fresh;94;93;90;6;96;33
Farinelli;1994;Rotten;58;82;14;10;24;7
Farmageddon;2011;Rotten;57;81;8;6;14;8
Farming;2019;Rotten;56;78;18;14;32;8
POV;2004;Fresh;79;74;11;3;14;7
Farmland;2014;Rotten;38;84;5;8;13;7
Farscape: The Peacekeeper Wars;2004;Fresh;60;92;3;2;5;1
Fascination;2005;Rotten;4;25;1;24;25;10
The Ex;2007;Rotten;18;32;18;81;99;33
Fast & Furious;2009;Rotten;29;67;50;125;175;41
Fast & Furious 6;2013;Fresh;71;84;146;61;207;43
Fast & Furious Presents: Hobbs & Shaw;2019;Fresh;67;88;226;111;337;48
The Fast and the Furious: Tokyo Drift;2006;Rotten;37;69;51;87;138;41
Fast, Cheap & Out of Control;1997;Fresh;91;84;29;3;32;4
Fast Color;2019;Certified-Fresh;81;61;70;16;86;17
Fast Company;1979;Fresh;88;30;7;1;8;0
Fast Five;2011;Certified-Fresh;77;83;155;46;201;44
Fast Food Nation;2006;Rotten;50;42;74;75;149;49
Fast Girls;1900;Fresh;83;59;19;4;23;4
Fast Times At Ridgemont High;1982;Certified-Fresh;76;80;39;12;51;8
Fastball;2016;Fresh;90;79;18;2;20;12
Faster;2004;Rotten;53;90;9;8;17;6
Faster;2010;Rotten;42;49;55;75;130;34
Faster, Pussycat! Kill! Kill!;1965;Fresh;70;78;19;8;27;4
Fat;2015;Fresh;60;67;3;2;5;2
Fat Albert;2004;Rotten;23;44;21;70;91;34
Fat City;1972;Fresh;100;85;24;0;24;10
Fat Girl;2001;Fresh;74;64;64;23;87;27
Fat Girls;2006;Rotten;32;49;6;13;19;8
Fat Kid Rules the World;2012;Fresh;84;61;21;4;25;12
Fat Man and Little Boy;1989;Rotten;47;45;9;10;19;3
Fat, Sick and Nearly Dead;2011;Fresh;69;85;9;4;13;5
Fatal Beauty;1987;Rotten;23;42;3;10;13;4
Father (Father: Diary of One Week);1967;Fresh;100;78;5;0;5;2
Father of Invention;2011;Rotten;0;27;0;16;16;7
Father Figures;2017;Rotten;17;24;8;40;48;14
Father Goose;1964;Fresh;80;86;12;3;15;0
Father Hood;1993;Rotten;10;34;2;18;20;9
The Father of My Children (Le pere de mes enfants);2010;Certified-Fresh;90;61;52;6;58;24
Father of the Bride: Part II;1995;Rotten;48;60;10;11;21;5
Father of the Year;1900;Rotten;0;50;0;11;11;2
Fathers And Daughters;2016;Rotten;28;58;14;36;50;16
Fathers' Day;1997;Rotten;25;25;15;46;61;22
Father's Day;2012;Fresh;80;62;8;2;10;1
Father's Little Dividend;1951;Fresh;100;61;9;0;9;1
Fatima;2020;Fresh;62;94;26;16;42;7
Faults;2015;Fresh;91;68;32;3;35;9
Faust;1994;Fresh;73;91;8;3;11;1
Favela Rising;2005;Fresh;67;87;14;7;21;7
The Favor;1994;Rotten;27;20;3;8;11;3
Fay Grim;2007;Rotten;46;57;42;49;91;32
Fear and Desire;1953;Fresh;80;36;12;3;15;3
Fear and Loathing in Las Vegas;1998;Rotten;49;89;34;35;69;12
Fear City;1984;Fresh;60;33;6;4;10;1
Fear, Inc.;2016;Rotten;50;39;6;6;12;0
Fear No Evil;1981;Rotten;56;26;5;4;9;2
Angst Essen Seele auf (Ali: Fear Eats the Soul);1974;Fresh;100;91;36;0;36;9
Fear Strikes Out;1957;Fresh;83;77;20;4;24;7
Fear X;2003;Rotten;58;38;21;15;36;9
Feardotcom;2002;Rotten;3;18;3;98;101;28
Jet Li's Fearless (Huo Yuan Jia) (Legend of a Fighter);2006;Certified-Fresh;73;86;80;30;110;33
Fearless Freaks;2005;Fresh;100;94;12;0;12;6
Feast;2006;Rotten;57;59;32;24;56;11
Feast of Love;2007;Rotten;39;55;46;71;117;38
Feast of the Seven Fishes;2019;Fresh;88;93;14;2;16;5
Fed Up;2014;Certified-Fresh;81;84;55;13;68;29
Federal Hill;1994;Fresh;82;68;14;3;17;10
Feel the Beat;2020;Rotten;47;57;7;8;15;1
Feel the Noise;2007;Rotten;11;42;3;24;27;10
Feeling Minnesota;1996;Rotten;14;27;3;18;21;6
Feels Good Man;2020;Certified-Fresh;96;87;64;3;67;8
Felicia's Journey;1999;Certified-Fresh;88;71;36;5;41;9
Felix & Meira;2015;Certified-Fresh;78;61;35;10;45;25
Felony;2014;Fresh;70;46;23;10;33;9
Felt;2015;Fresh;64;37;21;13;33;9
Female Perversions;1997;Fresh;70;46;16;7;23;9
Female Trouble;1974;Fresh;88;85;23;3;26;2
The Shrine;1900;Fresh;67;34;4;2;6;0
Feminists: What Were They Thinking?;2018;Fresh;80;58;4;1;5;1
Fences;2016;Certified-Fresh;92;75;243;22;265;54
Feral;2018;Rotten;35;21;6;11;17;4
Feral;2020;Fresh;100;;12;0;12;3
Ferdinand;2017;Fresh;72;51;86;34;120;22
La Habitacion de Fermat (Fermat's Room);2009;Fresh;70;52;19;8;27;9
FernGully - The Last Rainforest;1992;Fresh;63;63;10;6;16;2
Ferris Bueller's Day Off;1986;Certified-Fresh;81;92;54;13;67;13
Festival Express;2003;Certified-Fresh;96;85;77;3;80;31
Festival in Cannes;2002;Fresh;65;34;35;19;54;21
Fetih 1453 (Conquest 1453);2012;Rotten;40;53;2;3;5;2
Fetishes;1998;Rotten;50;;3;3;6;1
Fever Pitch;2005;Fresh;65;60;127;69;196;47
A Few Good Men;1992;Certified-Fresh;83;89;53;11;64;18
Fiddler on the Roof;1971;Certified-Fresh;83;92;34;7;41;9
Fido;2007;Fresh;73;72;56;21;77;18
Field of Dreams;1989;Certified-Fresh;87;86;52;8;60;13
Field of Lost Shoes;2014;Rotten;40;50;2;3;5;2
Fiend Without a Face;1957;Fresh;67;45;8;4;12;0
Fierce People;2005;Rotten;24;57;11;34;45;18
Fierce Creatures;1997;Rotten;55;58;18;15;33;5
The Fifth Element;1997;Fresh;70;86;47;20;67;16
Fifty Shades Darker;2017;Rotten;11;48;23;181;203;46
Fifty Shades Freed;2018;Rotten;11;37;22;171;192;37
Fifty Shades of Black;2016;Rotten;7;19;3;43;46;11
Fifty Shades of Grey;2015;Rotten;25;41;69;211;280;58
Fifty/Fifty (50-50);1993;Rotten;20;29;1;4;5;0
Fight Club;1999;Certified-Fresh;79;96;137;36;173;40
Fighting;2009;Rotten;40;36;51;78;129;38
The Fighting 69th;1940;Rotten;57;57;4;2;7;0
The Fighting Seabees;1944;Fresh;100;73;6;0;6;0
The Fighting Temptations;2003;Rotten;42;66;47;64;111;36
Fighting Tommy Riley;2005;Fresh;63;54;5;3;8;6
Fighting with My Family;2019;Certified-Fresh;92;82;217;18;234;39
Fightville;2012;Fresh;61;67;11;7;18;9
Fill the Void;2013;Certified-Fresh;89;69;66;8;74;26
Filly Brown;2013;Rotten;42;72;5;7;12;6
Film Geek;2005;Fresh;64;34;14;8;22;7
Film Stars Don't Die in Liverpool;2017;Certified-Fresh;80;67;134;33;167;35
A Film Unfinished;2010;Certified-Fresh;97;86;63;2;65;22
Filth;2014;Fresh;66;67;64;33;97;24
The Filth and the Fury;2000;Certified-Fresh;95;88;38;2;40;7
Filth and Wisdom;2008;Rotten;25;42;16;47;63;30
Final;2001;Rotten;44;34;17;22;39;11
Final Analysis;1992;Rotten;54;36;14;12;26;8
Omen III: The Final Conflict;1981;Rotten;30;33;6;14;20;2
The Final Countdown;1980;Rotten;47;61;8;9;17;4
The Final Cut;2004;Rotten;37;45;30;51;81;29
Final Destination;2000;Rotten;35;68;33;62;95;29
Final Destination 2;2003;Rotten;48;58;53;58;111;25
Final Destination 3;2006;Rotten;43;57;50;66;116;29
Final Destination 5;2011;Fresh;62;52;85;52;137;34
The Final Destination;2009;Rotten;28;35;28;72;100;21
Final Exam;1981;Rotten;13;16;1;7;8;0
Final Fantasy: The Spirits Within;2001;Rotten;45;48;64;79;143;32
Final Fantasy VII: Advent Children;2006;Rotten;33;84;2;4;6;0
Final Girl;2015;Rotten;31;24;4;9;13;2
Final Portrait;2018;Certified-Fresh;73;48;94;35;129;31
Final Score;2018;Fresh;71;38;24;10;34;8
Final Terror;1985;Rotten;33;24;3;6;9;0
Find Me Guilty;2006;Fresh;62;63;66;40;106;36
Finder's Fee;2001;Fresh;60;59;3;2;5;0
Finders Keepers;2015;Certified-Fresh;98;73;45;1;46;14
Finding Altamira (Altamira);2016;Fresh;69;46;11;5;16;6
Finding Amanda;2008;Rotten;40;28;17;26;43;19
Finding Bliss;2009;Rotten;30;30;6;14;20;8
Finding Dory;2016;Certified-Fresh;94;84;310;20;329;62
Finding Fela!;2014;Rotten;59;68;33;23;56;22
Finding Forrester;2000;Certified-Fresh;74;79;94;33;127;33
Finding Kim;2017;;;;3;2;;1
Finding Nemo;2003;Certified-Fresh;99;86;264;2;266;61
Finding Neverland;2004;Certified-Fresh;83;87;172;36;208;46
Finding Steve McQueen;2019;Rotten;52;63;12;11;23;6
Finding Vivian Maier;2014;Certified-Fresh;95;89;95;5;100;33
Finding Your Feet;2018;Fresh;70;55;62;26;88;21
A Fine Madness;1966;Rotten;40;33;2;3;5;0
A Fine Mess;1986;Rotten;33;34;2;4;6;2
Fingers;1978;Fresh;83;69;10;2;12;1
Finian's Rainbow;1968;Rotten;53;53;8;7;15;5
Finishing the Game;2007;Rotten;34;47;12;23;35;12
Fire at Sea (Fuocoammare);2016;Certified-Fresh;95;65;88;5;93;24
Fire Birds;;Rotten;10;36;2;19;21;9
Fire in Babylon;2011;Fresh;91;87;21;2;23;10
Fire in Paradise;1900;Fresh;80;83;4;1;5;2
Fire in the Sky;1993;Rotten;42;57;8;11;19;4
Fire With Fire;2012;Rotten;7;36;1;14;15;3
Fireball (Muay Thai Dunk);2009;Rotten;15;38;2;11;13;4
Fired Up;2009;Rotten;25;52;26;80;106;32
Firefox;1982;Rotten;38;42;5;8;13;2
Firehouse Dog;2007;Rotten;38;62;31;51;82;35
Firelight;1997;Rotten;50;83;7;7;14;3
Firestarter;1984;Rotten;37;53;10;17;27;2
Firewalker;1986;Rotten;8;32;1;12;13;4
Firewall;2006;Rotten;18;37;29;129;158;44
Fireworks Wednesday (Chaharshanbe-soori);2016;Certified-Fresh;100;84;44;0;44;16
First Blood;1982;Certified-Fresh;85;85;40;7;47;8
First Comes Love;2013;Rotten;50;67;6;6;12;6
First Cow;2020;Certified-Fresh;96;56;137;6;143;30
First Daughter;2004;Rotten;8;43;7;79;86;28
The First Deadly Sin;1980;Fresh;63;31;5;3;8;1
First Family;1980;Rotten;20;6;1;4;5;2
First Kid;1996;Rotten;20;32;3;12;15;2
First Kill;2017;Rotten;15;24;3;17;20;5
First Knight;1995;Rotten;43;55;20;26;46;14
First Love (Hatsukoi);2019;Certified-Fresh;97;88;112;3;115;21
First Man;2018;Certified-Fresh;86;67;385;60;444;57
First Match;1900;Fresh;85;82;17;3;20;7
H.G. Wells' First Men in the Moon;1964;Fresh;67;53;6;3;9;0
First Position;2012;Certified-Fresh;93;84;71;5;76;32
The First Power;;Rotten;30;45;3;7;10;2
First Reformed;2018;Certified-Fresh;93;68;221;16;237;43
The First Saturday in May;2008;Fresh;69;86;18;8;26;16
First Sunday;2008;Rotten;12;57;9;67;76;28
First They Killed My Father;2017;Certified-Fresh;87;80;62;9;71;27
First to the Moon;1900;Fresh;100;;8;0;8;0
The First Wives Club;1996;Rotten;50;68;36;36;72;21
Firstborn;1984;Rotten;36;54;5;9;14;5
A Fish Called Wanda;1988;Certified-Fresh;95;84;63;3;66;13
Fish Tank;2010;Certified-Fresh;91;79;134;13;147;50
Fish Without a Bicycle;2004;Rotten;10;20;1;9;10;6
The Fisher King;1991;Certified-Fresh;84;86;51;10;61;11
Fisherman's Friends;1900;Fresh;67;70;33;16;49;7
Fist Fight;2017;Rotten;24;40;32;100;131;31
Fist of Legend (Jing wu ying xiong);2008;Fresh;100;92;10;0;10;0
A Fistful of Dollars (Per un Pugno di Dollari);1964;Certified-Fresh;98;91;50;1;51;7
Fists Of Legend;2013;Fresh;71;61;5;2;7;4
Fitzcarraldo;1982;Fresh;78;92;21;6;27;5
Five;1951;Fresh;63;48;5;3;8;0
Five Corners;1987;Fresh;78;54;7;2;9;0
Five Dances;2013;Rotten;58;56;7;5;12;7
Five Easy Pieces;1970;Certified-Fresh;88;84;44;6;50;15
Five Feet Apart;2019;Rotten;53;79;64;57;121;28
Five Graves to Cairo;1943;Fresh;100;80;16;0;16;4
The Five Heartbeats;1991;Rotten;39;95;7;11;18;4
Five Nights in Maine;2016;Rotten;28;30;8;21;29;12
Five Star;2015;Fresh;75;51;15;5;20;9
Five Star Day;2011;Rotten;44;34;8;10;18;9
Fixed Bayonets!;1951;Fresh;100;70;7;0;7;1
Flags of Our Fathers;2006;Certified-Fresh;73;69;143;53;196;50
Flakes;2007;Rotten;22;46;4;14;18;7
The Flame and the Arrow;1950;Fresh;100;60;7;0;7;1
Flamenco, Flamenco;2014;Fresh;76;88;26;8;34;14
Flaming Star;1960;Fresh;91;72;10;1;11;0
Flammen & Citronen (Flame & Citron) (The Flame and the Lemon);2008;Certified-Fresh;86;82;60;10;70;30
Flannel Pajamas;2006;Rotten;51;39;23;22;45;22
Flash of Genius;2008;Fresh;61;55;66;42;108;32
Flash Point;2007;Rotten;40;67;8;12;20;7
Flashbacks of a Fool;2008;Rotten;38;51;8;13;21;10
Flashdance;1983;Rotten;36;61;16;28;44;7
Flatliners;;Rotten;48;59;21;23;44;14
Flatliners;2017;Rotten;4;32;3;73;76;15
Flawless;1999;Rotten;41;53;22;32;54;12
Fled;1996;Rotten;18;23;6;27;33;13
Flesh;1900;Fresh;67;51;6;3;9;2
Flesh And Bone;1993;Fresh;68;42;17;8;25;4
Flesh and the Devil;1926;Fresh;93;84;13;1;14;4
Flesh for the Beast;2003;Rotten;50;29;5;5;10;4
Flesh Gordon;1974;Fresh;67;45;4;2;6;0
Fletch;1985;Fresh;77;81;23;7;30;6
Fletch Lives;1989;Rotten;37;54;11;19;30;10
Flex Is Kings;2014;Fresh;67;33;4;2;6;3
Flicka;2006;Rotten;53;82;42;37;79;26
Flickering Lights;2001;Fresh;70;90;7;3;10;4
Flight;2012;Certified-Fresh;78;75;183;53;236;49
Flight of the Navigator;1986;Fresh;84;75;26;5;31;10
Flight of the Phoenix;2004;Rotten;30;40;36;83;119;27
Le Voyage du Ballon Rouge (The Flight of the Red Balloon);2007;Certified-Fresh;82;60;75;17;92;33
Flightplan;2005;Rotten;37;48;65;112;177;38
The Flintstones in Viva Rock Vegas;2000;Rotten;25;20;18;54;72;24
Flipped;2010;Rotten;54;78;41;35;76;22
Flirt;1996;Fresh;80;72;8;2;10;2
Flirting With Disaster;1996;Certified-Fresh;87;69;46;7;53;10
Flock of Dudes;2016;Rotten;36;47;4;7;11;3
Floored;2010;Fresh;60;73;3;2;5;4
Florence Foster Jenkins;2016;Certified-Fresh;87;68;200;29;229;47
Reaching for the Moon;2013;Fresh;65;69;24;13;37;14
Flow: For Love of Water;2008;Certified-Fresh;81;78;39;9;48;17
Flower;2018;Rotten;50;45;36;36;72;18
Flower Drum Song;1961;Rotten;50;72;6;6;12;3
The Flower of Evil;2003;Fresh;64;49;39;22;61;21
Flowers in the Attic;1987;Rotten;13;51;1;7;8;1
Flowers in the Attic;1900;Rotten;52;39;12;11;23;12
Floyd Norman: An Animated Life;2016;Fresh;94;74;15;1;16;5
Flu (Gamgi);2013;Rotten;36;61;4;7;11;3
Flubber;1997;Rotten;24;33;8;26;34;8
Fluke;1995;Rotten;27;69;3;8;11;4
Flushed Away;2006;Certified-Fresh;73;65;101;37;138;42
Flutter;2015;Fresh;60;36;3;2;5;0
Fly Away;2011;Fresh;85;62;11;2;13;7
Fly Away Home;1996;Certified-Fresh;87;70;40;6;46;14
Fly Me to the Moon;2008;Rotten;20;24;17;67;84;31
Flyboys;2006;Rotten;33;67;42;87;129;32
Flying Down to Rio;1933;Fresh;83;49;10;2;12;4
Flying Leathernecks;1951;Fresh;75;64;6;2;8;2
The Flying Scotsman;2006;Rotten;50;51;27;27;54;23
Flypaper;2011;Rotten;17;42;3;15;18;11
FM;1900;Rotten;20;62;2;8;10;4
Focus;2015;Rotten;56;53;125;100;225;54
The Fog;2005;Rotten;4;19;3;67;70;17
Follow Me: The Yoni Netanyahu Story;2012;Rotten;50;76;7;7;14;8
Follow the Fleet;1936;Fresh;83;77;10;2;12;0
Followed;2020;Fresh;71;48;15;6;21;2
Following;1999;Fresh;81;85;25;6;31;3
Following Sean;2006;Fresh;87;73;20;3;23;9
Food Chains;2014;Fresh;91;85;10;1;11;5
Food, Inc.;2009;Certified-Fresh;95;86;108;6;114;37
Food of Love;2003;Rotten;46;38;13;15;28;11
A Fool There Was;1915;Fresh;83;53;5;1;6;0
Foolish;1999;Rotten;0;66;0;16;16;6
Fool's Gold;2008;Rotten;11;48;16;129;145;40
Fools Rush In;1997;Rotten;32;64;9;19;28;7
Foosballers;2020;Fresh;100;100;5;0;5;2
Footlight Parade;1933;Fresh;100;83;11;0;11;0
Footloose;2011;Fresh;69;61;119;54;173;46
Footnote;2012;Certified-Fresh;90;71;80;9;89;36
Footnotes (Sur quel pied danser);2017;Fresh;65;;11;6;17;7
Footprints;2011;Rotten;41;71;7;10;17;8
For Colored Girls;2010;Rotten;32;73;35;74;109;36
For a Few Dollars More (Per Qualche Dollaro in Piu);1965;Fresh;91;94;32;3;35;5
For a Good Time, Call...;2012;Rotten;57;53;62;47;109;37
For A Woman;2014;Fresh;90;58;9;1;10;7
For All Mankind;1989;Fresh;94;91;16;1;17;3
For Ellen;2012;Fresh;67;37;24;12;36;18
For Ever Mozart;1997;Rotten;50;57;5;5;10;2
For Greater Glory;2012;Rotten;20;77;10;39;49;19
For Keeps;1988;Rotten;17;71;2;10;12;2
For Love of the Game;1999;Rotten;46;75;43;51;94;29
For Love or Money;1993;Rotten;37;45;7;12;19;4
For Me and My Gal;1942;Fresh;100;83;9;0;9;0
For My Father (Sof Shavua B'Tel Aviv);2010;Rotten;40;81;4;6;10;5
For Pete's Sake;1974;Rotten;50;51;4;4;8;0
For Richer or Poorer;1997;Rotten;14;46;3;18;21;7
For Roseanna;1997;Rotten;38;82;3;5;8;5
For the Bible Tells Me So;2007;Certified-Fresh;98;90;50;1;51;20
For the Boys;1991;Rotten;43;75;6;8;14;4
For the Love of Money;2012;Rotten;0;49;0;7;7;5
For the Love of Spock;2016;Fresh;100;82;31;0;31;11
For Those In Peril;2014;Fresh;88;67;21;3;24;8
For Whom the Bell Tolls;1943;Fresh;71;69;10;4;14;0
For Your Eyes Only;1981;Fresh;71;64;37;15;51;10
The Forbidden Kingdom;2008;Fresh;64;60;83;47;130;32
Forbidden Planet;1956;Certified-Fresh;96;85;44;2;46;5
Forbidden World (Mutant);1982;Fresh;60;31;3;2;5;0
Force 10 From Navarone;1978;Rotten;59;56;10;7;17;2
Force Majeure;2014;Certified-Fresh;94;76;148;10;158;41
Force of Nature;2020;Rotten;9;20;3;32;35;9
Force of Nature: The David Suzuki Movie;2011;Fresh;84;86;16;3;19;7
Forces of Nature;1999;Rotten;45;35;30;36;66;21
Foreign Correspondent;1940;Fresh;95;81;37;2;39;4
Foreign Parts;2011;Fresh;100;67;5;0;5;3
Forever Mine;1999;Rotten;29;42;2;5;7;1
Forever My Girl;2018;Rotten;25;79;13;40;53;16
Foreverland;2013;Rotten;50;59;3;3;6;2
Forget Me Not;2011;Fresh;67;56;8;4;12;7
Forget Paris;1995;Rotten;50;56;17;17;34;10
Forgetting Sarah Marshall;2008;Certified-Fresh;83;76;155;31;186;45
Forgetting The Girl;2013;Fresh;75;59;6;2;8;4
Forgiving Dr. Mengele;2006;Fresh;91;74;21;2;23;11
The Forgotten;2004;Rotten;32;36;55;119;174;36
Forks Over Knives;2011;Rotten;59;79;22;15;37;18
Formosa Betrayed;2010;Rotten;34;55;10;19;29;17
The Formula;1980;Rotten;30;22;3;7;10;3
Forrest Gump;1994;Fresh;71;95;73;30;103;30
The Forsaken;2001;Rotten;7;41;4;50;54;14
Forsaken;2016;Rotten;42;87;19;26;45;14
Fort Apache;1948;Fresh;100;83;21;0;21;5
Fort Bliss;2014;Fresh;75;68;12;4;16;10
Fort McCoy;2014;Rotten;50;64;3;3;6;4
Fort Tilden;2015;Fresh;88;49;29;4;33;14
Fortress 2: Re-Entry;1900;Rotten;0;22;0;9;9;1
The Fortune;1975;Rotten;17;36;1;5;6;0
Found;2014;Fresh;67;48;4;2;6;2
Found Footage 3D;1900;Fresh;100;47;6;0;6;0
The Fountainhead;1949;Fresh;83;74;10;2;12;0
Four;2013;Fresh;67;67;4;2;6;2
Four Brothers;2005;Rotten;52;80;70;64;134;34
Four Christmases;2008;Rotten;25;47;36;109;145;41
The Four Feathers;2002;Rotten;41;65;62;88;150;34
Four for Texas;1963;Rotten;11;39;1;8;9;0
Four Hands (Die Vierhandige);2018;Fresh;83;29;10;2;12;1
Four Horsemen;2012;Fresh;71;78;5;2;7;4
Four Kids and It;2020;Rotten;50;19;20;20;40;10
Four Lions;2010;Certified-Fresh;82;80;113;24;137;36
Four Minutes;2007;Fresh;76;85;19;6;25;9
The Four Musketeers;1975;Fresh;76;75;16;5;21;2
Four Rooms;1996;Rotten;13;69;6;39;45;13
Four Weddings and a Funeral;1994;Certified-Fresh;96;74;66;3;69;17
The Fourth Kind;2009;Rotten;18;41;21;94;115;32
Fox and His Friends;1975;Fresh;85;88;17;3;20;4
The Fox and the Hound;1981;Fresh;70;78;19;8;27;4
The Fox and the Hound 2;2006;Rotten;20;46;2;8;10;1
Foxcatcher;2014;Certified-Fresh;87;66;217;32;249;58
Foxy Brown;1974;Fresh;60;66;12;8;20;3
FrackNation;2013;Rotten;50;73;3;3;6;4
Fracture;2007;Certified-Fresh;71;73;124;50;174;48
Fractured;1900;Rotten;59;50;17;12;29;4
Fragments;2008;Rotten;45;29;14;17;31;10
Frailty;2002;Certified-Fresh;74;78;112;40;152;39
Framing John DeLorean;2019;Certified-Fresh;89;71;42;5;47;11
Frances;1982;Fresh;66;77;19;10;29;6
Frances Ha;2013;Certified-Fresh;92;77;166;14;180;51
Francis;1950;Fresh;80;67;4;1;5;2
Francofonia;2016;Certified-Fresh;87;46;65;10;75;27
Frank;2014;Certified-Fresh;92;72;150;13;163;42
Frank & Jesse;1995;Rotten;20;54;1;4;5;0
Frank & Lola;2016;Fresh;69;42;29;13;42;12
Frank and Ollie;1997;Fresh;88;88;7;1;8;1
Frank Miller's Sin City: A Dame to Kill For;2014;Rotten;43;44;81;107;188;42
Frank Serpico;2017;Fresh;75;46;6;2;8;7
Frankenhooker;;Rotten;57;57;8;6;14;3
Frankenstein;1900;Fresh;100;35;10;0;10;1
Frankenstein and the Monster from Hell;2003;Rotten;57;48;4;3;7;0
Frankenstein Created Woman;1967;Fresh;62;56;8;5;13;0
Frankenstein Meets the Wolf Man;1943;Rotten;25;56;3;9;12;0
Frankenstein Must Be Destroyed;1969;Fresh;70;68;7;3;10;2
Frankenstein's Army;2013;Rotten;56;40;14;11;25;8
Frankenstein's Monster's Monster, Frankenstein;1900;Fresh;88;67;15;2;17;5
Frankenweenie;2012;Certified-Fresh;87;70;193;28;221;48
Frankie & Alice;2014;Rotten;21;59;7;26;33;13
Frankie and Johnny Are Married;2004;Fresh;67;41;14;7;21;10
Frankie Starlight;1995;Fresh;71;71;5;2;7;2
Frantz;2017;Certified-Fresh;91;84;126;12;138;36
Freak Show;2018;Rotten;52;69;22;20;42;15
Freakdog (Red Mist);2009;Rotten;6;16;1;15;16;6
Freakonomics;2010;Fresh;66;51;42;22;64;19
Freaks;1932;Certified-Fresh;95;88;52;3;55;9
Freaks;2019;Certified-Fresh;88;86;72;10;82;11
Freaky Friday;2003;Certified-Fresh;88;57;136;19;155;41
Fred Armisen: Standup For Drummers;1900;Fresh;67;30;4;2;6;3
Fred: The Movie;2010;Rotten;0;36;0;13;13;4
Fred Won't Move Out;2012;Fresh;71;7;5;2;7;6
Freddy Got Fingered;2001;Rotten;10;56;9;85;94;33
Freddy vs. Jason;2003;Rotten;41;50;67;95;162;35
Freddy's Dead: The Final Nightmare;1991;Rotten;19;33;6;25;31;5
Free Angela & All Political Prisoners;2013;Fresh;93;83;13;1;14;7
Free Birds;2013;Rotten;20;44;18;72;90;26
Free China: The Courage to Believe;2013;Fresh;100;86;7;0;7;3
Free Enterprise;1999;Fresh;83;79;20;4;24;7
Free Fire;2017;Fresh;69;52;162;72;234;44
Free Men;2012;Fresh;76;65;25;8;33;14
Free Money;1999;Rotten;29;26;2;5;7;1
Free Radicals;2004;Fresh;63;61;10;6;16;6
Free Ride;2014;Rotten;14;22;1;6;7;6
Free Samples;2013;Fresh;63;36;5;3;8;3
Free Solo;2018;Certified-Fresh;97;93;149;4;153;34
Free State of Jones;2016;Rotten;47;64;87;100;187;45
Free The Mind;2013;Fresh;75;59;9;3;12;8
Free the Nipple;2014;Rotten;18;31;2;9;11;6
Free to Run;2016;Rotten;57;38;4;3;7;3
Free Willy;1993;Fresh;68;50;21;10;31;11
Free Willy 2: The Adventure Home;1995;Rotten;50;42;13;13;26;9
Free Willy 3: The Rescue;1997;Rotten;44;44;7;9;16;2
Freebie and the Bean;1974;Rotten;25;65;3;9;12;4
Freedom;2015;Rotten;0;51;0;15;15;8
Freedom Writers;2007;Fresh;70;87;88;38;126;39
Freedomland;2006;Rotten;23;25;35;116;151;41
Freeheld;2015;Rotten;48;54;66;71;137;39
Freejack;1992;Rotten;18;25;3;14;17;2
Freestyle;2000;Fresh;89;86;16;2;18;7
Freetown;2015;Rotten;50;71;6;6;12;1
Freeway 2: Confessions of a Trickbaby (Freeway II: Confessions of a Trickbaby);1999;Rotten;30;64;3;7;10;2
Freeze Frame;2004;Fresh;71;60;5;2;7;2
Freezer;2014;Rotten;33;27;2;4;6;2
The French Connection;1971;Certified-Fresh;98;87;59;1;60;12
The French Connection II;1975;Fresh;76;62;19;6;25;1
The French Lieutenant's Woman;1981;Fresh;79;67;19;5;24;2
French Twist (Gazon maudit);1995;Rotten;55;62;6;5;11;5
Frenzy;1972;Certified-Fresh;90;77;38;4;42;6
Frequency;2000;Certified-Fresh;70;81;87;38;125;31
Fresh;1994;Certified-Fresh;88;92;35;5;40;17
Fresh;2009;Fresh;67;85;6;3;9;4
Fresh Dressed;2015;Fresh;91;56;31;3;34;17
Freshman Orientation;2007;Rotten;32;37;7;15;22;7
Frida;2002;Certified-Fresh;75;85;119;39;158;42
Friday;1995;Fresh;78;91;21;6;27;8
Friday the 13th - The Final Chapter;1984;Rotten;23;51;7;24;31;2
Friday After Next;2002;Rotten;26;75;19;53;72;26
Friday Night Lights;2004;Certified-Fresh;82;85;141;32;173;43
Friday the 13th;1980;Fresh;64;61;36;20;56;6
Friday the 13th Part 2;1981;Rotten;27;48;12;32;44;5
Friday the 13th Part 3;1982;Rotten;11;42;3;25;28;2
Friday the 13th, Part V - A New Beginning;1985;Rotten;14;26;3;18;21;0
Friday the 13th, Part VI - Jason Lives;1986;Rotten;50;52;14;14;28;1
Friday the 13th Part VII - The New Blood;1988;Rotten;35;37;8;15;23;1
Friday the 13th Part VIII - Jason Takes Manhattan;1989;Rotten;8;27;2;23;25;2
Friday the 13th;2009;Rotten;26;46;45;129;174;41
Fried Green Tomatoes;1991;Fresh;74;91;31;11;42;12
Friend Request;2017;Rotten;16;28;12;63;75;16
Friendly Persuasion;1956;Fresh;88;81;7;1;8;0
Friends With Benefits;2011;Fresh;69;65;116;53;169;51
Friends With Kids;2012;Fresh;67;49;102;50;152;49
Friends With Money;2006;Fresh;72;40;111;43;154;47
Fright Night;2011;Certified-Fresh;72;59;130;50;180;38
Fritz the Cat;1972;Rotten;57;59;12;9;21;3
Frogs;1972;Rotten;29;24;5;12;17;0
Frogs for Snakes;1999;Rotten;27;18;3;8;11;3
From Other Worlds;2004;Rotten;38;;5;8;13;6
From Time to Time;1900;Rotten;43;60;3;4;7;0
From Beijing with Love;1994;Rotten;50;87;3;3;6;0
From Beyond;1986;Fresh;78;70;14;4;18;1
From Beyond the Grave;1973;Rotten;40;62;2;3;5;1
From Dusk Till Dawn;1996;Fresh;62;76;31;19;50;12
From Dusk Till Dawn 2: Texas Blood Money;1999;Rotten;9;20;1;10;11;0
From Dusk Till Dawn 3: The Hangman's Daughter;2000;Rotten;22;23;2;7;9;0
From Hell;2001;Rotten;57;66;86;65;151;37
From Justin To Kelly;2003;Rotten;10;39;6;57;63;20
From Noon Till Three;1976;Rotten;40;61;2;3;5;1
From Nowhere;2017;Fresh;92;75;12;1;13;8
From Paris with Love;2010;Rotten;38;54;61;100;161;44
From Prada to Nada;2011;Rotten;20;41;4;16;20;10
From Russia With Love;1964;Certified-Fresh;95;84;57;3;60;10
From The Head;2013;Fresh;80;82;4;1;5;2
From the Hip;1987;Rotten;22;60;2;7;9;3
From the Land of the Moon (Mal de pierres);2017;Rotten;32;65;18;38;56;16
Aus dem Leben der Marionetten (From the Life of the Marionettes);1980;Fresh;67;76;8;4;12;2
From the Terrace;1960;Rotten;31;58;4;9;13;4
From Up On Poppy Hill;2013;Certified-Fresh;86;81;74;12;86;31
The Front;1976;Fresh;71;74;17;7;24;4
Front Cover;2016;Fresh;83;50;10;2;12;7
Frontera;2014;Rotten;54;59;13;11;24;12
Frontier(s);2007;Rotten;55;53;12;10;22;7
Frontrunners;2008;Fresh;85;59;23;4;27;14
Frost (The Last International Playboy);2009;Rotten;29;49;2;5;7;4
Frost/Nixon;2008;Certified-Fresh;93;88;237;19;256;58
Frozen;2013;Certified-Fresh;90;85;220;25;245;55
Frozen II;2019;Certified-Fresh;77;92;251;74;325;44
Frozen River;2008;Certified-Fresh;88;74;119;16;135;39
Fruitvale Station;2013;Certified-Fresh;94;87;200;12;212;62
Fubar: Balls to the Wall;1900;Fresh;90;73;9;1;10;2
The Fugitive Kind;1900;Rotten;53;64;8;7;15;0
Fugitive Pieces;2008;Fresh;68;64;52;24;76;39
Full Tilt Boogie;1997;Fresh;88;64;14;2;16;2
Full Battle Rattle;2008;Fresh;77;84;24;7;31;11
Full Contact;1992;Fresh;88;72;7;1;8;0
Full Frontal;2002;Rotten;39;27;56;87;143;39
Full Metal Jacket;1987;Certified-Fresh;92;94;76;7;83;15
The Full Monty;1997;Certified-Fresh;96;79;48;2;50;10
Les Nuits de la pleine lune (Full Moon in Paris);1984;Fresh;100;76;14;0;14;4
Fullmetal Alchemist: The Sacred Star of Milos;2012;Fresh;83;81;10;2;12;8
Fulltime Killer;2003;Rotten;59;77;20;14;34;12
Fun & Fancy Free;1947;Fresh;67;61;6;3;9;3
Fun in Acapulco;2000;Rotten;57;51;4;3;7;0
Fun Mom Dinner;2017;Rotten;32;35;9;19;28;9
Fun Size;2012;Rotten;25;47;18;55;73;22
Fun With Dick and Jane;2005;Rotten;28;49;38;96;134;34
Funeral in Berlin;1966;Fresh;67;73;6;3;9;0
Funeral Kings;2012;Fresh;90;62;9;1;10;3
Funny About Love;;Rotten;0;14;0;7;7;1
Funny Bones;1995;Fresh;61;82;11;7;18;3
Funny Face;1957;Fresh;87;81;33;5;38;8
Funny Girl;1968;Certified-Fresh;93;85;42;3;45;14
Funny Lady;1975;Rotten;33;55;4;8;12;1
Funny People;2009;Fresh;69;48;164;74;238;63
Funny Story;2019;Fresh;83;71;15;3;18;3
A Funny Thing Happened on the Way to the Forum;1966;Fresh;85;78;17;3;20;1
Fur: An Imaginary Portrait of Diane Arbus;2006;Rotten;32;63;36;75;111;43
Furious 7;2015;Certified-Fresh;82;82;222;50;272;54
Furlough;2018;Rotten;20;33;1;4;5;3
Fury;2014;Certified-Fresh;76;84;196;61;257;59
Futurama: The Beast With a Billion Backs;2008;Fresh;80;66;4;1;5;0
Futurama: Bender's Big Score;2007;Fresh;100;80;10;0;10;0
Future Weather;2013;Fresh;93;55;13;1;14;7
Future World;2018;Rotten;0;12;0;9;9;4
Futureworld;1976;Rotten;33;30;4;8;12;1
F/X;1986;Fresh;88;53;22;3;25;5
F/X 2: The Deadly Art of Illusion;1991;Rotten;38;35;6;10;16;3
Gabbeh;1997;Fresh;90;79;18;2;20;8
Gabrielle;2014;Fresh;88;76;23;3;26;10
Gacy;2003;Rotten;17;21;1;5;6;1
Gaga: Five Foot Two;2017;Fresh;72;80;28;11;39;18
Gags the Clown;1900;Rotten;43;43;3;4;7;0
Gainsbourg: A Heroic Life;2011;Certified-Fresh;73;68;60;22;82;29
Galaxina;1980;Rotten;17;24;1;5;6;0
Galaxy Quest;1999;Certified-Fresh;90;79;111;13;124;29
Galveston;2018;Fresh;73;55;38;14;52;12
Gambit;1900;Rotten;18;23;8;36;44;12
Game Change;1900;Fresh;68;76;28;13;41;23
Game Night;2018;Certified-Fresh;85;77;214;39;252;40
Game of Death;2020;Rotten;56;23;15;12;27;3
Game Over, Man!;2018;Rotten;19;46;3;13;16;6
Game 6;2005;Fresh;61;38;25;16;41;18
Gamer;2009;Rotten;30;39;24;57;81;16
Daikaiju Gamera (The Giant Monster Gamera);1965;Rotten;20;31;1;4;5;0
Gandhi;1982;Certified-Fresh;85;92;52;9;61;9
Gandhi, My Father;2007;Rotten;47;71;8;9;17;9
Gang Related;1997;Rotten;53;65;9;8;17;4
The Gang That Couldn't Shoot Straight;1971;Rotten;0;23;0;5;5;1
Gangs of New York;2002;Certified-Fresh;73;81;155;56;211;48
Gangster No. 1;2000;Fresh;71;77;37;15;52;13
Gangster Land (In the Absence of Good Men);2017;Rotten;0;31;0;5;5;3
Gangster Squad;2013;Rotten;31;57;64;142;205;47
Ganja & Hess;1973;Fresh;86;53;6;1;7;0
Garage Days;2003;Rotten;43;61;23;30;53;18
Garbo Talks;1984;Rotten;13;47;1;7;8;2
Garden Party;2008;Rotten;15;25;3;17;20;7
Garden State;2004;Certified-Fresh;86;88;166;26;192;42
Gardens of Stone;1987;Rotten;47;55;7;8;15;7
Gardens of the Night;2008;Rotten;57;66;8;6;14;6
Garfield - The Movie;2004;Rotten;14;37;20;118;138;36
Garfield: A Tail of Two Kitties;2006;Rotten;11;43;8;67;75;24
Gas Food Lodging;1992;Fresh;81;74;13;3;16;3
GasLand;2010;Certified-Fresh;98;85;40;1;41;10
Gaslight;1944;Fresh;87;90;27;4;31;6
Gaslight;1940;Fresh;100;75;6;0;6;0
The Gate;1987;Rotten;55;44;6;5;11;0
Gate of Hell (Jigokumon);1954;Fresh;100;77;9;0;9;2
Ragnarok;2014;Fresh;69;43;9;4;13;2
The Gates;2008;Fresh;86;60;6;1;7;4
Gates of Heaven;1980;Fresh;90;82;18;2;20;2
Gator;1976;Rotten;0;44;0;6;6;2
Gattaca;1997;Certified-Fresh;82;87;51;11;62;13
Gaudi Afternoon;2001;Rotten;29;45;5;12;17;6
Gauguin: Voyage to Tahiti;2018;Rotten;42;34;15;21;36;11
The Gauntlet;1977;Fresh;75;54;21;7;28;6
The Gay Divorcee;1934;Fresh;93;82;13;1;14;0
Gay Purr-ee;1962;Fresh;80;78;4;1;5;0
Gay Sex in the 70s;2005;Fresh;71;59;20;8;28;14
Gayby;2012;Fresh;90;55;18;2;20;9
G.B.F.;2014;Certified-Fresh;80;55;36;9;45;17
Gebo and The Shadow (Gebo et l'ombre);2014;Fresh;100;50;9;0;9;5
Gedo senki (Tales from Earthsea);2010;Rotten;43;46;17;23;40;18
Gemini;2018;Certified-Fresh;72;41;56;22;78;24
Gemini Man;2019;Rotten;26;83;81;225;306;45
Gemma Bovery;2015;Rotten;54;43;49;41;90;32
General Orders No. 9;2011;Fresh;62;49;8;5;13;7
General della Rovere (Il generale Della Rovere);1959;Fresh;100;86;8;0;8;2
General Education;2012;Rotten;0;38;0;15;15;8
General Idi Amin Dada: Autoportrait (A Self Portrait);1975;Fresh;82;78;14;3;17;4
The General's Daughter;1999;Rotten;21;46;19;70;89;25
Generation Iron;2013;Fresh;81;78;13;3;16;6
Generation Um...;2013;Rotten;0;22;0;15;15;9
Genghis Blues;2000;Fresh;75;91;9;3;12;4
Genius;2016;Rotten;53;46;58;51;109;38
Genius On Hold;2013;Fresh;83;50;5;1;6;3
Gentleman Jim;1942;Fresh;100;86;9;0;9;0
Gentleman's Agreement;1947;Certified-Fresh;76;78;34;11;45;11
Gentlemen Broncos;2009;Rotten;19;44;15;64;79;31
Gentlemen Prefer Blondes;1953;Certified-Fresh;98;83;43;1;44;12
Geography Club;2013;Fresh;67;53;8;4;12;7
George Harrison: Living In The Material World;1900;Fresh;86;93;32;5;37;20
George Lucas in Love;1900;Fresh;78;83;7;2;9;0
George Of The Jungle 2;2003;Rotten;17;20;1;5;6;0
Georgia Rule;2007;Rotten;18;52;21;96;117;34
Georgy Girl;1966;Fresh;91;70;10;1;11;0
Geostorm;2017;Rotten;17;35;15;75;90;13
Gerald's Game;2017;Certified-Fresh;91;71;69;7;76;9
Gerhard Richter Painting;2012;Fresh;89;73;25;3;28;19
Germinal;1994;Fresh;75;75;9;3;12;2
Guernica (Gernika);1900;Fresh;86;39;6;1;7;0
Geronimo - An American Legend;1993;Rotten;48;51;10;11;21;3
Gerontophilia;2015;Rotten;48;42;13;14;27;14
Gerry;2003;Fresh;61;61;61;39;100;30
Gerrymandering;2010;Rotten;40;46;8;12;20;11
Get a Job;2016;Rotten;5;21;1;21;22;12
Get Bruce;1999;Fresh;71;45;12;5;17;3
Get Gone;2020;Rotten;0;40;0;6;6;2
Get Hard;2015;Rotten;28;45;51;133;183;48
Get In;1900;Rotten;50;35;3;3;6;0
Get Low;2010;Certified-Fresh;85;75;123;22;145;36
Get Married If You Can;1900;Rotten;20;35;1;4;5;0
Get Me Roger Stone;2017;Fresh;88;83;29;4;33;13
Get on the Bus;1996;Certified-Fresh;89;71;39;5;44;14
Get On Up;2014;Certified-Fresh;80;68;136;34;170;51
Get Out;2017;Certified-Fresh;98;86;380;7;386;63
Get Out Your Handkerchiefs (Preparez vos mouchoirs);1978;Fresh;88;75;15;2;17;1
Get Real;1999;Certified-Fresh;79;84;37;10;47;15
Get Rich or Die Tryin';2005;Rotten;16;70;19;101;120;31
Get Santa;1900;Fresh;79;53;23;6;29;7
Get Shorty;1995;Certified-Fresh;88;70;49;7;56;18
Get Smart;2008;Rotten;50;67;112;110;222;49
Get the Gringo;1900;Certified-Fresh;82;68;46;10;56;6
Getaway;2013;Rotten;3;35;4;139;143;39
GETT: The Trial of Viviane Amsalem;2015;Certified-Fresh;100;81;79;0;78;25
Getting Even With Dad;1994;Rotten;3;25;1;29;30;13
Getting Straight;1970;Rotten;25;42;2;6;8;0
Ghajini;2008;Rotten;50;71;6;6;12;1
Ghidorah, the Three-Headed Monster (San daikaiju: Chikyu saidai no kessen);1964;Fresh;75;59;9;3;12;1
The Ghost and Mrs. Muir;1947;Fresh;100;88;17;0;17;1
The Ghost and the Darkness;1996;Rotten;49;75;24;25;49;10
Ghost Bird;2009;Fresh;91;73;10;1;11;5
Ghost Dad;;Rotten;6;32;2;29;31;9
Ghost Dog - The Way of the Samurai;2000;Certified-Fresh;82;86;79;17;96;27
Ghost in the Machine;1993;Rotten;11;23;1;8;9;1
Ghost in the Shell;1996;Certified-Fresh;96;89;54;2;56;9
Ghost in the Shell;2017;Rotten;43;51;127;166;293;47
Ghost in the Shell 2 - Innocence;2004;Fresh;64;80;63;36;99;28
Ghost Killers vs. Bloody Mary (Exterminadores do Alem Contra a Loira do Banheiro);1900;Rotten;50;73;3;3;6;0
Ghost Light;1900;Fresh;74;67;17;6;23;0
Ghost of Frankenstein;1942;Fresh;75;40;9;3;12;2
Ghost Rider;2007;Rotten;26;48;37;103;140;28
Ghost Rider: Spirit of Vengeance;2012;Rotten;18;31;20;94;114;23
Ghost Ship;2002;Rotten;16;37;20;109;129;33
Ghost Stories;2018;Certified-Fresh;84;58;108;20;128;22
Ghost Stories;1900;Rotten;33;17;3;6;9;1
Ghost Story;1981;Rotten;35;43;7;13;20;1
Ghost Team;2016;Rotten;11;31;1;8;9;3
Ghost Team One;2013;Rotten;36;68;4;7;11;5
Ghost World;2001;Certified-Fresh;93;84;149;12;161;40
Ghostbox Cowboy;2018;Fresh;91;50;10;1;11;5
Ghostbusters (1984 Original);1984;Certified-Fresh;97;88;71;2;73;14
Ghostbusters 2;1989;Rotten;54;61;21;18;39;7
Ghostbusters;2016;Certified-Fresh;74;50;284;101;384;61
Ghostlight;2004;Fresh;63;;5;3;8;5
Ghosts of Girlfriends Past;2009;Rotten;27;40;39;104;143;39
Ghosts of Mississippi;1996;Rotten;43;62;13;17;30;10
Ghosts of Sugar Land;1900;Fresh;100;55;6;0;6;1
Ghosts of the Abyss;2003;Certified-Fresh;80;67;82;20;102;30
Ghosts of War;2020;Rotten;38;44;15;25;40;5
Ghoul;2015;Rotten;25;24;2;6;8;2
Ghoulies II;1988;Rotten;0;29;0;6;6;0
G.I. Blues;1960;Rotten;0;70;0;5;5;0
G.I. Jane;1997;Rotten;51;53;18;17;35;7
G.I. Joe: Retaliation;2013;Rotten;28;48;50;127;177;41
G.I. Joe: The Rise of Cobra;2009;Rotten;34;50;57;111;168;38
Gia;1998;Fresh;92;82;12;1;13;0
Gianni e le donne (The Salt of Life);2012;Certified-Fresh;84;45;43;8;51;24
Giant;1956;Certified-Fresh;95;87;42;2;44;10
The Giant Gila Monster;1959;Rotten;22;21;2;7;9;0
Giant Little Ones;2019;Certified-Fresh;93;84;54;4;58;13
Gidget;1959;Rotten;50;86;5;5;10;0
Gifted;2017;Fresh;73;85;131;48;179;34
Gigante;2009;Fresh;94;61;15;1;16;8
Gigi;1958;Fresh;81;74;30;7;37;8
Gigli;2003;Rotten;6;13;12;175;187;50
Gilda;1946;Certified-Fresh;92;88;48;4;52;11
Gilles' Wife (La Femme de Gilles);2005;Fresh;82;72;18;4;22;12
Gimme Danger;2016;Certified-Fresh;94;70;103;6;109;30
Gimme Shelter;1970;Fresh;93;91;27;2;29;5
Gimme Shelter;2014;Rotten;29;63;22;55;77;31
Gimme The Loot;2013;Certified-Fresh;91;65;63;6;69;30
The Gingerdead Man;2005;Fresh;60;28;3;2;5;0
Ginger e Fred (Ginger and Fred);1986;Fresh;83;81;10;2;12;2
Ginger & Rosa;2013;Certified-Fresh;78;50;89;25;114;37
Ginger Snaps;2001;Certified-Fresh;89;78;51;6;57;13
Girl;2019;Certified-Fresh;85;72;51;9;60;16
Girl 27;2007;Fresh;86;69;6;1;7;3
Girl Crazy;1943;Fresh;100;75;6;0;6;0
La Fille Coupee en Deux (The Girl Cut in Two) (A Girl Cut in Two);2008;Certified-Fresh;74;37;64;23;87;29
Girl Flu.;1900;Fresh;86;64;6;1;7;2
La Fille de Monaco (The Girl from Monaco);2009;Rotten;47;28;25;28;53;22
Girl In Progress;2012;Rotten;33;53;15;31;46;19
Girl, Interrupted;1999;Rotten;53;84;61;54;115;31
Girl Model;2012;Fresh;92;55;33;3;36;14
Girl Most Likely;2013;Rotten;22;33;21;73;94;33
Girl On A Bicycle;2014;Rotten;8;54;1;11;12;7
Girl on the Third Floor;2019;Fresh;84;22;31;6;37;7
Girl Rising;2013;Fresh;89;82;8;1;9;4
The Girl Who Played with Fire (Flickan som lekte med elden);2010;Fresh;69;68;111;49;160;46
Girl With a Pearl Earring;2004;Fresh;72;68;129;49;178;43
Girl with Green Eyes;1964;Fresh;80;60;4;1;5;0
Red Riding Hood;2011;Rotten;10;39;21;187;208;48
Girlfight;2000;Certified-Fresh;88;75;84;12;96;33
Girlfriend;2011;Rotten;50;74;5;5;10;5
The Girlfriend Experience;2009;Fresh;67;35;93;46;139;43
Girlfriend's Day;1900;Rotten;43;37;3;4;7;0
Girlhood;2003;Fresh;94;73;31;2;33;11
Girlhood;2015;Certified-Fresh;96;72;76;3;79;24
Girls Against Boys;2013;Rotten;25;29;6;18;24;8
Girls Can't Swim;2002;Fresh;71;33;24;10;34;16
Girls Just Want to Have Fun;1985;Rotten;38;77;5;8;13;1
Girls of the Sun (Les filles du soleil);2019;Rotten;46;88;23;27;50;19
Girls Trip;2017;Certified-Fresh;91;78;156;15;171;42
Girls Will Be Girls;2003;Rotten;58;80;18;13;31;14
Girls with Balls;1900;Rotten;42;26;5;7;12;3
Girly;1900;Rotten;33;50;2;4;6;0
Giuliani Time;2006;Fresh;85;74;22;4;26;12
Give Me Liberty;2019;Fresh;89;73;32;4;36;13
Donne-moi la main (Give Me Your Hand);2009;Rotten;36;29;4;7;11;6
Give Up Tomorrow;1900;Fresh;100;91;5;0;5;1
Gladiator;2000;Certified-Fresh;77;87;153;46;199;49
Glass;2019;Rotten;37;67;141;245;386;50
Glass: A Portrait of Philip in Twelve Parts;2008;Fresh;84;79;26;5;31;13
Glass Chin;2015;Fresh;85;45;17;3;20;10
The Glass House;2001;Rotten;21;39;18;68;86;22
Glassland;2016;Certified-Fresh;84;44;42;8;50;18
Gleason;2016;Certified-Fresh;96;90;66;3;69;28
Glee: The 3D Concert Movie;2011;Fresh;60;64;54;36;90;35
Glen Campbell: I'll Be Me;2014;Fresh;100;88;33;0;33;15
Glen or Glenda?;1953;Rotten;35;33;8;15;23;3
Glengarry Glen Ross;1992;Certified-Fresh;95;88;52;3;55;9
The Glenn Miller Story;1953;Fresh;88;80;7;1;8;0
The Glimmer Man;1996;Rotten;12;38;3;23;26;11
Glitter;2001;Rotten;6;48;5;82;87;31
Gloria;2014;Certified-Fresh;99;64;127;1;128;39
Gloria;2015;Fresh;100;67;13;0;13;0
Gloria Bell;2019;Certified-Fresh;91;46;181;18;199;39
Glorious 39;2009;Rotten;46;42;11;13;24;7
GMO OMG;2013;Rotten;56;57;9;7;16;8
Gnomeo and Juliet;2011;Rotten;56;54;70;56;126;37
Go Back to China;2020;Fresh;81;71;22;5;26;7
Go For Sisters;2013;Fresh;74;53;40;14;54;19
Go Further;2004;Rotten;59;70;17;12;29;11
Go Karts (Go!);1900;Fresh;80;64;8;2;10;1
Go Tigers!;2001;Certified-Fresh;85;68;34;6;40;15
Goal II: Living the Dream;2007;Rotten;39;62;7;11;18;7
Goat;2016;Certified-Fresh;79;44;60;16;76;25
Goats;2012;Rotten;19;39;5;22;27;13
God Bless America;2012;Fresh;65;68;74;39;113;27
God Bless Ozzy Osbourne;2011;Fresh;67;80;4;2;6;1
God Bless the Broken Road;2018;Rotten;17;78;2;10;12;5
God Grew Tired Of Us;2007;Certified-Fresh;91;95;63;6;69;25
God Help the Girl;2014;Fresh;67;59;51;25;76;23
God Knows Where I Am;2017;Fresh;85;86;22;4;26;10
God Loves Uganda;2013;Fresh;100;77;29;0;29;10
God of War;2017;Fresh;80;53;8;2;10;5
God Said 'Ha!';1998;Fresh;86;73;19;3;22;5
God, Sex & Apple Pie;1999;Rotten;17;40;1;5;6;1
God Told Me To;1976;Fresh;73;52;8;3;11;1
The Godfather;1972;Certified-Fresh;98;98;97;2;99;24
The Godfather, Part II;1974;Certified-Fresh;98;97;81;2;83;17
The Godfather, Part III;;Fresh;68;78;42;20;62;12
Gods and Generals;2003;Rotten;8;64;10;111;121;34
Gods and Monsters;1998;Certified-Fresh;95;83;63;3;66;15
God's Horses;2014;Fresh;100;77;13;0;13;8
The Gods Must Be Crazy II;;Rotten;54;70;7;6;13;3
God's Not Dead;2014;Rotten;12;75;3;22;25;5
God's Not Dead 2;2016;Rotten;10;62;4;36;40;8
God's Not Dead: A Light in Darkness;2018;Rotten;10;54;2;18;20;8
Gods Of Egypt;2016;Rotten;16;37;30;162;192;37
Gods of the Plague (Gotter der Pest);1977;Fresh;80;45;4;1;5;0
God's Own Country;2017;Certified-Fresh;98;87;124;3;127;26
God's Pocket;2014;Rotten;37;32;36;62;97;37
Godsend;2003;Rotten;4;20;6;133;139;40
Godspeed;2010;Rotten;50;20;5;5;10;5
Godspell;1900;Fresh;64;71;9;5;14;1
Godzilla;1998;Rotten;15;28;12;67;79;12
Godzilla, Mothra and King Ghidorah: Giant Monsters All-Out Attack;2001;Fresh;63;78;10;6;16;1
Godzilla: Tokyo S.O.S.;2004;Fresh;80;72;4;1;5;1
Godzilla Vs Mechagodzilla II (Gojira VS Mekagojira);1993;Fresh;83;71;5;1;6;0
Godzilla vs. Megalon;1973;Rotten;38;34;3;5;8;0
Godzilla (Gojira);1954;Certified-Fresh;93;89;69;5;74;24
Godzilla 2000;2000;Rotten;57;54;39;30;69;25
Godzilla;2014;Certified-Fresh;76;66;245;79;323;63
Godzilla and Mothra: The Battle for Earth (Gojira vs. Mosura);1992;Fresh;75;60;6;2;8;0
Godzilla, King of the Monsters!;1956;Fresh;83;73;20;4;24;2
Godzilla: King of the Monsters;2019;Rotten;43;83;145;193;338;40
Godzilla Resurgence (Shin Godzilla);2016;Certified-Fresh;86;74;63;10;73;12
Godzilla Vs. Destoroyah;2000;Fresh;100;94;6;0;6;0
Godzilla vs. King Ghidorah;2003;Rotten;56;64;5;4;9;0
Godzilla Vs Mechagodzilla;1974;Fresh;71;62;5;2;7;0
Godzilla vs. Megaguirus;2000;Fresh;60;48;3;2;5;0
Godzilla vs. Space Godzilla (Gojira vs. Supesugojira);1994;Rotten;57;81;4;3;7;0
Godzilla's Revenge (All Monsters Attack);1971;Rotten;25;17;2;6;8;0
Goethe! (Young Goethe in Love);2011;Fresh;65;65;22;12;34;21
Gogol Bordello Non-Stop;2008;Fresh;88;87;7;1;8;5
Goin' South;1978;Fresh;71;50;10;4;14;3
Going Clear: Scientology and the Prison of Belief;2015;Certified-Fresh;95;90;87;5;92;30
Going Down In La-la Land;2012;Fresh;67;49;6;3;9;5
Going in Style;1900;Fresh;82;73;9;2;11;3
Going in Style;2017;Rotten;47;57;80;90;170;32
Going My Way;1944;Fresh;81;75;25;6;31;7
Going Places (Les valseuses);1974;Fresh;73;86;8;3;11;1
Going Shopping;2005;Rotten;40;40;12;18;30;16
Going Under;2006;Rotten;17;50;1;5;6;4
Gold;2017;Rotten;42;45;78;107;185;48
Gold Diggers of 1933;1933;Fresh;100;86;10;0;10;1
Gold Diggers of 1935;1935;Fresh;100;70;5;0;5;0
Gold Star;2017;Fresh;88;64;7;1;8;1
Elizabeth: The Golden Age;2007;Rotten;34;59;57;109;166;50
The Golden Bowl;2000;Rotten;53;39;46;40;86;29
Golden Boy;1900;Fresh;67;;4;2;6;0
The Golden Child;1986;Rotten;26;47;5;14;19;2
Golden Door (Nuovomondo);2007;Fresh;72;69;63;24;87;36
Golden Exits;2018;Fresh;67;38;34;17;51;20
Golden Kingdom;2016;Fresh;100;70;7;0;7;2
The Golden Voyage of Sinbad;1974;Fresh;75;64;12;4;16;4
GoldenEye;1995;Certified-Fresh;78;83;62;17;79;26
Goldfinger;1964;Certified-Fresh;99;89;67;1;68;11
Goldie;2020;Fresh;95;60;21;1;22;8
The Golem (Der Golem, wie er in die Welt kam);1900;Fresh;100;72;30;0;30;8
Golmaal Returns;2008;Rotten;0;33;0;6;6;1
Golmaal 3;2010;Rotten;38;50;3;5;8;1
Gomorrah (Gomorra);2008;Certified-Fresh;92;70;142;13;155;46
Gone;2012;Rotten;12;42;8;61;69;16
Gone Baby Gone;2007;Certified-Fresh;94;86;170;10;180;42
Gone Doggy Gone;2015;Fresh;71;87;5;2;7;3
Gone Fishin';1997;Rotten;4;37;1;26;27;10
Gone Girl;2014;Certified-Fresh;87;87;312;46;358;66
Gone With the Wind;1939;Certified-Fresh;91;92;93;9;102;28
Gonjiam: Haunted Asylum;2018;Fresh;91;71;10;1;11;0
Gonzo: The Life and Work of Hunter S. Thompson;2008;Certified-Fresh;87;82;85;13;98;33
Gooby;2009;Rotten;20;22;1;4;5;1
Good Advice;2001;Rotten;29;49;2;5;7;0
Good Boys;2019;Certified-Fresh;80;86;194;48;242;42
Good Burger;1997;Rotten;32;63;12;26;38;15
Good Bye, Lenin!;2004;Certified-Fresh;90;93;97;11;108;31
A Good Day to Be Black & Sexy;2008;Fresh;80;51;4;1;5;3
Good Dick;2008;Rotten;50;51;21;21;42;17
The Good Earth;1937;Fresh;95;76;18;1;19;4
Good for Nothing;2012;Rotten;53;50;9;8;17;5
Good Fortune;2017;Fresh;78;96;7;2;9;3
The Good German;2007;Rotten;34;33;51;101;152;46
The Good Guy;2009;Rotten;35;30;9;17;26;12
Good Hair;2009;Certified-Fresh;95;69;79;4;83;34
Good Kids;2016;Rotten;33;41;2;4;6;1
Good Kill;2015;Certified-Fresh;75;49;93;31;124;39
Good Luck Chuck;2007;Rotten;5;57;6;111;117;32
A Good Man in Africa;1994;Rotten;10;27;1;9;10;3
Good Morning (Ohayo);1959;Fresh;88;88;15;2;17;4
Good Morning, Vietnam;1987;Certified-Fresh;90;82;38;4;42;5
The Good Mother (The Price of Passion);1988;Rotten;50;29;6;6;12;6
Good Neighbor Sam;1964;Fresh;80;63;4;1;5;2
Good Neighbors;2011;Fresh;67;35;20;10;30;11
Good News;1947;Fresh;100;79;5;0;5;1
The Good Night;2007;Rotten;31;33;13;29;42;18
Good Ol' Freda;2013;Fresh;85;78;29;5;34;16
Good People;2014;Rotten;12;22;4;29;33;10
Good Sam;1900;Rotten;50;66;3;3;6;0
The Good Shepherd;2006;Rotten;55;51;94;77;171;50
The Good Son;1993;Rotten;26;54;7;20;27;9
Good Time;2017;Certified-Fresh;92;81;218;20;238;46
Good Will Hunting;1997;Certified-Fresh;97;94;77;2;79;21
A Good Woman;2006;Rotten;37;49;31;52;83;30
A Good Year;2006;Rotten;25;65;34;100;134;43
Goodbye Charlie;1964;Rotten;50;69;4;4;8;3
Goodbye Christopher Robin;2017;Fresh;63;71;112;65;177;36
Goodbye, Columbus;1969;Fresh;91;49;10;1;11;0
Goodbye Lover;1998;Rotten;29;38;10;24;34;10
Goodbye Solo;2009;Certified-Fresh;94;82;101;7;108;40
Goodbye to All That;2014;Fresh;62;31;13;8;21;11
Goodbye World;2014;Rotten;27;32;7;19;26;11
Goodnight Mommy (Ich seh, Ich seh);2015;Certified-Fresh;85;65;127;22;149;28
The Goods: Live Hard, Sell Hard;2009;Rotten;27;37;28;74;102;29
A Goofy Movie;1995;Rotten;58;70;15;11;26;6
Google Me;2007;Fresh;67;46;8;4;12;0
Gook;2017;Certified-Fresh;94;84;51;3;54;18
Goon;2012;Certified-Fresh;81;71;86;20;106;31
Goon: Last of the Enforcers;2017;Rotten;43;41;26;35;61;12
The Goonies;1985;Certified-Fresh;76;91;45;14;59;11
Goosebumps;2015;Certified-Fresh;78;62;127;36;163;36
Goosebumps 2: Haunted Halloween;2018;Rotten;47;37;45;50;95;17
Gordy;1995;Rotten;26;24;5;14;19;8
Gore Vidal: The United States Of Amnesia;2014;Fresh;83;84;25;5;30;13
Gored;1900;Fresh;80;46;8;2;10;3
Gori Tere Pyaar Mein;2013;Rotten;44;26;4;5;9;3
Gorillas in the Mist: The Story of Dian Fossey;1988;Fresh;83;74;15;3;18;2
Gorky Park;1983;Fresh;75;60;18;6;24;5
Gosford Park;2001;Certified-Fresh;86;78;138;22;160;36
The Gospel;2005;Rotten;32;75;12;25;37;13
Il Vangelo Secondo Matteo (The Gospel According to St. Matthew);1964;Fresh;91;86;32;3;35;8
Gospel Hill;2008;Rotten;33;36;2;4;6;3
Gossip;2000;Rotten;29;47;19;47;66;20
Gothic;2002;Rotten;50;49;6;6;12;0
Gothika;2003;Rotten;15;45;25;144;169;39
Gottfried Helnwein and the Dreaming Child;2012;Rotten;0;44;0;6;6;4
Gotti;2018;Rotten;0;46;0;58;58;15
The Governess;1998;Fresh;65;50;22;12;34;7
Goya's Ghosts;2007;Rotten;30;57;26;61;87;38
Grabbers;2013;Fresh;72;51;23;9;32;9
Grace Is Gone;2007;Fresh;62;60;46;28;74;27
Grace of My Heart;1996;Fresh;75;80;18;6;24;6
Grace Unplugged;2013;Rotten;50;78;4;4;8;3
Graceland;2013;Fresh;85;71;22;4;26;10
Gracie;2007;Fresh;61;58;57;36;93;36
The Graduate;1967;Certified-Fresh;87;90;71;11;82;20
Graduation;2007;Rotten;0;63;0;6;6;2
Graduation Day (Dia de Graduacion);1981;Rotten;57;17;4;3;7;0
Graffiti Bridge;;Rotten;19;40;5;22;27;10
Gran Torino;2009;Certified-Fresh;81;90;189;45;234;57
Grand Canyon Adventure: River at Risk;2008;Fresh;78;60;7;2;9;3
Grand Hotel;1932;Certified-Fresh;86;77;36;6;42;10
Grand Piano;2014;Certified-Fresh;79;47;57;15;72;16
Grand Prix;1966;Fresh;100;88;11;0;11;0
Grand Theft Parsons;2004;Rotten;46;52;13;15;28;9
Grandma;2015;Certified-Fresh;91;67;158;15;173;45
Grandma's Boy;2006;Rotten;16;85;10;53;63;17
The Grapes of Wrath;1940;Certified-Fresh;100;88;48;0;48;7
Grass;2000;Fresh;75;77;15;5;20;5
The Grass Harp;1996;Rotten;50;56;7;7;14;5
The Grass Is Greener;1960;Fresh;88;64;7;1;8;0
Grass Is Greener;1900;Fresh;100;;7;0;7;0
Grassroots;2012;Rotten;50;44;15;15;30;11
Grateful Dawg;2000;Fresh;70;81;30;13;43;22
Grave Encounters;2011;Fresh;67;49;10;5;15;3
Grave Encounters 2;2012;Rotten;20;27;2;8;10;2
Grave of the Fireflies (Hotaru no haka);1988;Certified-Fresh;100;95;40;0;40;7
The Gravedancers;2006;Fresh;100;45;7;0;7;0
Gravity;2013;Certified-Fresh;96;80;339;15;354;64
Gravy;2015;Rotten;30;43;3;7;10;3
Gray Lady Down;1978;Fresh;63;35;5;3;8;0
Gray's Anatomy;1997;Rotten;55;74;11;9;20;4
Grease;1978;Certified-Fresh;75;87;55;18;73;23
Grease 2;1982;Rotten;36;53;13;23;36;9
Grease: Live!;1900;Certified-Fresh;92;69;33;3;36;17
Greaser's Palace;1972;Rotten;50;61;3;3;6;2
A Great Day in Harlem;1995;Fresh;89;71;17;2;19;9
The Great Debaters;2007;Certified-Fresh;79;86;104;27;131;42
The Great Dictator;1940;Certified-Fresh;93;95;40;3;43;10
Great Expectations;1947;Fresh;100;88;28;0;28;6
Great Expectations;2013;Fresh;68;49;54;26;80;27
The Great Gabbo;1929;Fresh;67;52;4;2;6;0
The Great Lie;1941;Fresh;60;71;3;2;5;0
The Great Muppet Caper;1981;Fresh;76;78;16;5;21;5
The Great New Wonderful;2006;Fresh;73;45;30;11;41;15
The Great Outdoors;1988;Rotten;40;70;6;9;15;0
The Great Raid;2005;Rotten;38;70;46;76;122;30
The Great Santini;1979;Fresh;95;75;18;1;19;1
The Great Waldo Pepper;1975;Fresh;67;57;6;3;9;1
The Great White Hype;1996;Rotten;45;34;10;12;22;6
Great World of Sound;2007;Certified-Fresh;81;72;35;8;43;15
The Great Ziegfeld;1936;Fresh;62;50;21;13;34;7
Greater;2016;Fresh;67;85;10;5;15;2
The Greatest Game Ever Played;2005;Fresh;63;82;70;42;112;29
The Greatest Show on Earth;1952;Rotten;42;54;13;18;31;8
The Greatest Story Ever Told;1965;Rotten;41;64;9;13;22;4
Greed;2020;Rotten;47;33;67;75;142;32
Greedy;1994;Rotten;32;47;6;13;19;3
Greedy Lying Bastards;2013;Fresh;68;54;25;12;37;16
Green Book;2018;Certified-Fresh;77;91;274;80;354;49
Green Card;;Fresh;60;50;18;12;30;11
Green Dragon;2001;Fresh;61;52;17;11;28;9
Green for Danger;1947;Fresh;73;84;11;4;15;4
The Green Hornet;2011;Rotten;45;43;106;132;238;55
Green Lantern;2011;Rotten;26;45;64;181;245;51
Green Lantern: First Flight;2009;Rotten;50;70;3;3;6;0
The Green Mile;1999;Certified-Fresh;78;94;105;29;134;35
The Green Pastures;1936;Fresh;76;85;13;4;17;4
Green Room;2016;Certified-Fresh;91;75;215;22;237;48
The Green Slime;1969;Rotten;17;41;2;10;12;0
Green Street Hooligans;2005;Rotten;47;87;30;34;64;21
Greenberg;2010;Certified-Fresh;76;42;133;41;174;45
Greener Grass;2019;Certified-Fresh;81;56;56;13;69;13
Greenfingers;2001;Rotten;46;66;32;37;69;28
Greenlight;2020;Fresh;71;70;5;2;7;0
Greenwich Village: Music That Defined a Generation;2013;Fresh;71;44;5;2;7;4
Greetings From Tim Buckley;2013;Fresh;72;46;23;9;32;16
Gregory Crewdson: Brief Encounters;2012;Fresh;94;83;17;1;18;9
Gregory's Girl;2019;Fresh;95;81;19;1;20;7
Gremlins;1984;Certified-Fresh;85;78;60;11;71;12
Gremlins 2: The New Batch;;Fresh;71;57;46;19;65;17
Greta;2019;Fresh;60;42;163;107;270;42
Gretchen;1900;Fresh;83;44;5;1;6;0
Grey Gardens;1975;Fresh;94;85;31;2;33;10
Grey Gardens;2009;Fresh;88;78;28;4;32;18
Grey Owl;1999;Rotten;17;56;2;10;12;2
Greyfriars Bobby;1961;Fresh;100;79;5;0;5;1
Greystoke: The Legend of Tarzan, Lord of the Apes;1984;Fresh;73;60;11;4;15;1
Gridiron Gang;2006;Rotten;42;81;43;59;102;29
Il Grido (The Cry);1957;Fresh;75;81;9;3;12;4
Griff the Invisible;2011;Fresh;63;52;36;21;57;21
The Grifters;;Certified-Fresh;91;70;39;4;43;11
Grigris;2013;Fresh;67;32;10;5;15;6
Gringo;2018;Rotten;40;38;52;79;131;27
Gringo Trails;2014;Fresh;71;70;5;2;7;3
Touchez Pas au Grisbi (Hands Off the Loot);1954;Fresh;100;86;24;0;24;9
Grizzly Man;2005;Certified-Fresh;92;85;132;11;143;44
Le fils de l'epicier (The Grocer's Son);2008;Certified-Fresh;90;75;54;6;60;24
The Groomsmen;2006;Rotten;52;44;17;16;33;15
Groove;2000;Rotten;57;80;29;22;51;15
Gross Anatomy;1989;Rotten;30;53;3;7;10;1
Grosse Pointe Blank;1997;Certified-Fresh;80;87;57;14;71;21
Ground Control;1998;Rotten;40;35;2;3;5;1
Groundhog Day;1993;Certified-Fresh;96;88;80;3;83;19
Growing Up Smith (Good Ol' Boy);2017;Fresh;73;81;8;3;11;4
Grown Up Movie Star;2009;Fresh;80;73;4;1;5;2
Grown Ups;2010;Rotten;11;62;18;150;168;41
Grown Ups 2;2013;Rotten;8;53;9;105;114;31
The Grudge 2;2006;Rotten;11;40;8;68;76;21
Grudge Match;2013;Rotten;31;46;44;98;141;33
Grumpier Old Men;1995;Rotten;17;62;3;15;18;5
Grumpy Cat's Worst Christmas Ever;1900;Rotten;27;39;3;8;11;6
Grumpy Old Men;1993;Fresh;63;74;27;16;43;9
In Bloom;2014;Certified-Fresh;92;76;46;4;50;25
GTFO: Get the F&#% Out;1900;Fresh;100;32;5;0;5;1
Guardians of the Galaxy;2014;Certified-Fresh;91;92;300;28;328;59
Guardians of the Galaxy Vol. 2;2017;Certified-Fresh;85;87;351;64;415;56
Guarding Tess;1994;Rotten;57;48;20;15;35;9
Gueros;2015;Certified-Fresh;92;79;49;4;53;14
Guerrilla: The Taking of Patty Hearst;2004;Certified-Fresh;89;83;42;5;47;16
Guess Who;2005;Rotten;42;49;63;88;151;38
Guess Who's Coming to Dinner;1967;Fresh;70;85;26;11;37;6
Guest Artist;2020;Fresh;63;40;5;3;8;4
Guest of Cindy Sherman;2008;Fresh;71;64;17;7;24;10
Guest of Honour;2020;Rotten;41;67;26;38;64;14
Guidance;2015;Fresh;88;56;14;2;16;9
The Guilty;2000;Rotten;40;42;2;3;5;1
Guilty;1900;Fresh;60;22;3;2;5;0
Guilty as Sin;1993;Rotten;38;34;6;10;16;4
Guilty by Suspicion;1991;Fresh;65;54;11;6;17;3
Guilty Of Romance;2013;Fresh;67;60;12;6;18;4
Gulliver's Travels;2010;Rotten;20;27;24;96;120;39
The Gumball Rally;1976;Rotten;30;65;3;7;10;4
Gumby: The Movie;1995;Rotten;20;63;1;4;5;0
Gumshoe;1971;Fresh;100;56;6;0;6;1
Gun Hill Road;2011;Fresh;65;68;20;11;31;13
Gun Shy;2000;Rotten;26;36;11;32;43;11
Gun Shy;2017;Rotten;0;37;0;10;10;5
Guncrazy;1992;Fresh;63;40;5;3;8;1
Gundala;1900;Fresh;83;77;5;1;6;1
Gunfight at the O.K. Corral;1957;Fresh;82;69;9;2;11;0
Gunga Din;1939;Fresh;92;74;24;2;26;2
Gunless;2011;Rotten;40;64;2;3;5;2
Gunnin' for That #1 Spot;2008;Certified-Fresh;74;66;31;11;42;21
Guns Akimbo;2020;Rotten;52;40;35;32;67;7
The Guns of Navarone;1961;Fresh;92;86;22;2;24;0
Guru;2007;Fresh;83;84;10;2;12;6
Gut;2012;Rotten;50;25;5;5;10;3
Guy and Madeline on a Park Bench;2010;Fresh;91;47;21;2;23;10
Guy X;2005;Rotten;42;22;5;7;12;4
Guys and Balls;2006;Rotten;38;71;5;8;13;6
Guys and Dolls;1955;Fresh;91;83;29;3;32;9
Guzaarish;2010;Fresh;67;72;6;3;9;3
Gwen;2019;Fresh;73;78;45;18;62;7
Gymkata;1900;Rotten;17;40;2;10;12;2
Gypsy 83;2001;Rotten;54;78;14;12;26;12
When the Road Bends: Tales of a Gypsy Caravan;2007;Certified-Fresh;86;82;43;7;50;24
H;2002;Fresh;80;52;4;1;5;0
H2: Halloween II;2009;Rotten;21;45;17;63;80;15
Ha-shoter (Policeman);2014;Fresh;61;47;11;7;18;9
Habermann;2011;Rotten;40;77;2;3;5;4
Habit;1997;Fresh;74;62;14;5;19;6
Hachi: A Dog's Tale;2009;Fresh;64;84;18;10;28;9
Hackers;1995;Rotten;33;68;15;30;45;16
Hacksaw Ridge;2016;Certified-Fresh;84;91;235;43;277;54
Hagazussa: A Heathen's Curse (Hagazussa);2019;Fresh;96;50;26;1;27;4
Haiku Tunnel;2001;Fresh;60;76;28;19;47;20
Hail, Caesar!;2016;Certified-Fresh;85;44;305;53;358;60
Je Vous Salue, Marie (Hail Mary);1985;Fresh;70;63;7;3;10;3
Hail the Conquering Hero;1944;Fresh;95;85;19;1;20;4
Hair;1979;Fresh;88;88;21;3;24;2
Hair High;2004;Fresh;75;73;15;5;20;8
HairBrained;2014;Rotten;22;25;4;14;18;6
Hairspray;2007;Certified-Fresh;91;84;202;19;221;52
Hale County This Morning, This Evening;2018;Certified-Fresh;97;39;67;2;69;18
Half Light;2005;Rotten;25;46;2;6;8;0
Half a Sixpence;1967;Rotten;29;75;2;5;7;2
Half Baked;1998;Rotten;29;81;7;17;24;2
Half Magic;2018;Rotten;55;58;16;13;29;5
Half Nelson;2006;Certified-Fresh;90;83;142;15;157;43
Half of a Yellow Sun;2014;Rotten;51;36;27;26;53;21
Half Past Dead;2002;Rotten;3;37;3;85;88;31
Hall Pass;2011;Rotten;33;40;59;118;177;52
The Hallelujah Trail;1965;Rotten;40;66;2;3;5;0
Hallowed Ground;2019;Rotten;0;;0;6;6;1
Halloween;2007;Rotten;27;59;32;86;118;23
Halloween;2018;Certified-Fresh;79;70;293;78;371;44
Halloween 4: The Return of Michael Myers;1988;Rotten;29;53;8;20;28;5
Halloween 5: The Revenge of Michael Myers;1989;Rotten;13;37;3;21;24;2
Halloween H20;1998;Rotten;53;49;32;28;60;11
Halloween II;1981;Rotten;32;63;13;28;41;6
Halloween III: Season of the Witch;1982;Rotten;41;27;11;16;27;3
Halloween: Resurrection;2002;Rotten;12;25;8;59;67;16
Halloween - The Curse of Michael Myers (Halloween 6);1995;Rotten;9;37;3;32;35;8
Halloweentown;1998;Fresh;80;72;4;1;5;1
Halls of Montezuma;1950;Fresh;88;48;7;1;8;1
Hamburger Hill;1987;Fresh;100;72;12;0;12;4
Hamlet;1900;Fresh;100;91;6;0;6;0
Hamlet 2;2008;Fresh;62;56;90;55;145;40
Hammer;1900;Fresh;79;76;23;6;29;4
Hammer Of The Gods;2013;Rotten;29;69;6;15;21;3
Hammett;1982;Fresh;75;62;9;3;12;0
Hampstead;2019;Rotten;43;41;26;34;60;15
Hancock;2008;Rotten;41;59;93;133;226;50
The Handmaid's Tale;;Rotten;32;43;6;13;19;3
Hands of Stone;2016;Rotten;45;52;49;59;108;31
Handsome Harry;2010;Fresh;81;56;21;5;26;10
Hang 'em High;1968;Fresh;92;73;12;1;13;1
Hangar 10;1900;Rotten;14;17;1;6;7;2
Hangin' with the Homeboys;1991;Fresh;83;68;5;1;6;3
Hanging Up;2000;Rotten;12;34;10;75;85;25
Hangman;1900;Fresh;100;33;6;0;6;0
Hangman;2017;Rotten;4;30;1;22;23;7
Hangmen Also Die;1943;Fresh;85;68;11;2;13;5
Hanky Panky;1982;Rotten;33;30;3;6;9;1
Hanna;2011;Fresh;71;66;164;67;231;52
Hannah Montana/Miley Cyrus: Best of Both Worlds Concert Tour;2008;Fresh;71;70;32;13;45;14
Hannah and Her Sisters;1986;Certified-Fresh;91;90;51;5;56;15
Hannah Arendt;2013;Certified-Fresh;88;75;63;9;72;25
Hannah Free;2009;Rotten;20;47;2;8;10;5
Hannah Gadsby: Nanette;2018;Certified-Fresh;100;25;48;0;48;20
Hannah Montana: The Movie;2009;Rotten;43;67;58;76;134;42
Hannah Takes the Stairs;2007;Rotten;59;45;27;19;46;23
Hannibal Buress: Comedy Camisado;1900;Fresh;100;53;7;0;7;3
Hannibal Rising;2007;Rotten;16;55;23;124;147;40
Hanover Street;1979;Rotten;57;41;4;3;7;0
Hans Christian Andersen;1952;Fresh;83;75;5;1;6;1
Hansel and Gretel Get Baked;2013;Fresh;71;69;5;2;7;1
Hansel and Gretel: Witch Hunters;2013;Rotten;16;53;23;121;144;26
The Happiest Millionaire;1967;Rotten;50;82;3;3;6;1
Happily N'ever After;2006;Rotten;4;34;3;77;80;27
The Happiness of the Katakuris;2001;Fresh;68;82;21;10;31;9
Happy Accidents;2001;Fresh;70;75;44;19;63;20
Happy Anniversary;2018;Fresh;83;52;5;1;6;0
Happy as Lazzaro (Lazzaro felice);1900;Certified-Fresh;91;81;79;8;87;21
Happy Birthday to Me;1981;Rotten;27;42;3;8;11;0
Happy Campers;2001;Rotten;57;62;4;3;7;0
Happy Christmas;2014;Certified-Fresh;76;37;59;19;78;31
Happy Death Day;2017;Fresh;71;66;110;45;155;23
Happy Death Day 2U;2019;Fresh;71;58;144;60;204;29
Happy Endings;2005;Rotten;55;63;59;49;108;35
Happy Feet;2006;Certified-Fresh;76;70;128;40;168;45
Happy Feet Two;2011;Rotten;45;60;55;66;121;35
Happy Gilmore;1996;Fresh;61;85;33;21;54;13
Happy, Happy;2011;Certified-Fresh;85;59;41;7;48;22
Happy Happy Joy Joy: The Ren & Stimpy Story;1900;Fresh;78;100;18;5;23;7
Happy Here and Now;2002;Rotten;48;41;10;11;21;9
Happy People: A Year in the Taiga;2013;Certified-Fresh;88;77;43;6;49;21
Happy, Texas;1999;Certified-Fresh;81;55;43;10;53;11
Happy Valley;2014;Fresh;89;70;31;4;35;15
HappyThankYouMorePlease;2011;Rotten;42;60;22;31;53;18
Hara-Kiri: Death of a Samurai;2012;Certified-Fresh;76;75;32;10;42;15
Harakiri;1962;Fresh;100;97;8;0;8;2
Harbinger Down;2015;Rotten;43;19;3;4;7;1
Hard Breakers;2011;Rotten;14;9;1;6;7;0
Hard Candy;2006;Fresh;67;78;98;49;147;40
Hard Core Logo;1998;Fresh;69;89;9;4;13;4
Hard Eight;1996;Certified-Fresh;80;83;37;9;46;13
Hard Kill;2020;Rotten;0;71;0;17;17;3
Hard Rain;1997;Rotten;30;34;13;31;44;12
Hard Sell;2016;Rotten;33;61;3;6;9;1
Hard Target;1993;Rotten;57;49;20;15;35;10
Hard Ticket to Hawaii;1900;Rotten;14;45;1;6;7;0
Hard to be a God;2015;Certified-Fresh;95;66;41;2;43;12
Hard to Kill;;Rotten;38;47;5;8;13;2
The Hard Way;1991;Fresh;77;52;17;5;22;3
The Hard Word;2003;Rotten;39;40;32;50;82;28
Hardball;2001;Rotten;41;70;46;67;113;34
Hardcore Henry;2016;Rotten;51;54;73;71;144;33
The Harder They Come;1973;Fresh;91;82;31;3;34;8
Hardware;;Rotten;50;52;6;6;12;2
Hardware Wars;2009;Fresh;83;68;5;1;6;0
Hari Kondabolu: Warn Your Relatives;1900;Fresh;100;53;7;0;7;3
Harlem Aria;1999;Rotten;10;50;1;9;10;5
Harlem Nights;1989;Rotten;21;80;7;27;34;14
Harley Davidson and the Marlboro Man;1991;Rotten;21;65;4;15;19;2
Harmonium (Fuchi ni tatsu);2017;Fresh;100;80;38;0;38;14
Harmontown;2014;Fresh;76;79;19;6;25;12
Harold & Kumar Escape from Guantanamo Bay;2008;Rotten;52;60;71;65;136;32
Harold & Kumar Go to White Castle;2004;Fresh;74;80;109;39;148;34
Harold And Lillian: A Hollywood Love Story;2017;Fresh;97;88;32;1;33;11
Harold and Maude;1971;Certified-Fresh;85;93;39;7;46;6
Harold's Going Stiff;1900;Fresh;100;59;6;0;6;1
Harper (The Moving Target);1966;Fresh;100;74;18;0;18;4
Harpoon;2019;Certified-Fresh;97;58;57;2;59;6
Harrison's Flowers;2002;Rotten;49;76;42;44;86;28
Harry and the Hendersons;1987;Rotten;43;54;9;12;21;0
Harry and Walter Go to New York;1976;Rotten;56;31;5;4;9;2
Harry Benson: Shoot First;2016;Fresh;85;46;23;4;27;10
Harry Brown;2010;Fresh;63;75;80;47;127;43
Harry Dean Stanton: Partly Fiction;2013;Fresh;92;76;24;2;26;9
Harry Potter and the Chamber of Secrets;2002;Certified-Fresh;82;80;197;42;239;54
Harry Potter and the Deathly Hallows - Part 1;2010;Certified-Fresh;77;85;220;66;286;59
Harry Potter and the Deathly Hallows - Part 2;2011;Certified-Fresh;96;89;317;13;330;63
Harry Potter and the Goblet of Fire;2005;Certified-Fresh;88;74;224;31;255;53
Harry Potter and the Half-Blood Prince;2009;Certified-Fresh;84;78;233;46;279;63
Harry Potter and the Order of the Phoenix;2007;Certified-Fresh;78;81;198;57;255;55
Harry Potter and the Prisoner of Azkaban;2004;Certified-Fresh;90;86;234;25;259;56
Harry Potter and the Sorcerer's Stone;2001;Certified-Fresh;81;82;163;38;201;47
Harsh Times;2006;Rotten;48;55;48;51;99;35
Hart's War;2002;Rotten;59;48;73;50;123;36
Harvard Beats Yale 29-29;2008;Fresh;92;76;35;3;38;19
Harvard Man;2002;Rotten;33;33;12;24;36;14
Harvest;2011;Fresh;73;66;8;3;11;3
Harvey;1950;Fresh;85;93;23;4;27;5
The Harvey Girls;1946;Fresh;100;82;10;0;10;0
Hasan Minhaj: Homecoming King;1900;Fresh;78;86;7;2;9;3
Ha-Sodot (The Secrets);2007;Fresh;67;84;10;5;15;12
Hatari!;1962;Fresh;63;77;15;9;24;5
Hatchet;2006;Rotten;55;45;27;22;49;16
Hatchet for the Honeymoon (Il rosso segno della follia);1970;Rotten;57;49;4;3;7;0
Hatchet II;2010;Rotten;42;35;15;21;36;15
Hatchet III;2013;Rotten;57;39;13;10;23;7
Hate Crime;2005;Rotten;6;60;1;17;18;8
Hateship Loveship;2014;Rotten;50;36;27;27;54;22
Hating Breitbart;2012;Rotten;0;92;0;9;9;5
Haunt;2014;Rotten;39;30;7;11;18;7
Haunt;2019;Fresh;70;100;32;14;46;5
Dark House;2014;Rotten;9;23;1;10;11;5
The Haunted Mansion;2003;Rotten;14;30;19;121;140;35
The Haunted Palace;1963;Fresh;75;66;6;2;8;0
The Haunted World of El Superbeasto;2009;Rotten;40;48;2;3;5;0
Haunter;2013;Rotten;56;42;20;16;36;13
Haunters: The Art of the Scare;1900;Fresh;100;81;9;0;9;0
The Haunting of Molly Hartley;2008;Rotten;2;18;1;40;41;10
House (Hausu);1977;Fresh;90;80;28;3;31;7
Hav Plenty;1998;Rotten;36;84;8;14;22;7
Hava Nagila: The Movie;2013;Fresh;90;67;26;3;29;12
Havana Motor Club;2016;Fresh;88;39;7;1;8;4
Have a Good Trip: Adventures in Psychedelics;1900;Rotten;58;72;15;11;26;10
Havoc;2005;Rotten;45;36;5;6;11;2
Hawking;2013;Fresh;85;72;23;4;27;12
Haxan (Haxan: Witchcraft Through the Ages) (The Witches);1929;Fresh;88;81;20;2;17;4
Haywire;2012;Certified-Fresh;80;41;156;38;194;47
He Got Game;1998;Certified-Fresh;81;83;51;12;63;20
He Knows You're Alone;1980;Rotten;22;31;2;7;9;1
He Loves Me, He Loves Me Not;2002;Fresh;71;84;52;21;73;27
He Named Me Malala;2015;Fresh;72;72;97;38;135;35
He Said, She Said;1991;Rotten;33;34;5;10;15;3
He Walked by Night;1948;Fresh;86;60;6;1;7;0
He Was a Quiet Man;2007;Fresh;80;62;16;4;20;8
Head Above Water;1996;Rotten;40;44;6;9;15;5
Head Count;2019;Fresh;68;45;13;6;19;3
Head of State;2003;Rotten;30;47;36;84;120;28
Head On;1999;Fresh;63;68;15;9;24;10
Headhunters;2012;Certified-Fresh;93;85;93;7;100;32
Headshot;2012;Fresh;71;48;10;4;14;5
Headshot;2017;Fresh;73;57;36;13;49;9
Headspace;2005;Rotten;50;20;4;4;8;3
Heal the Living (Reparer les vivants);2017;Certified-Fresh;92;67;54;5;59;15
Hear My Song;1991;Fresh;90;78;27;3;30;12
Hear No Evil;1993;Rotten;11;35;1;8;9;1
Hearing Is Believing;2017;Fresh;60;92;3;2;5;2
Heart of Glass (Herz aus Glas);1976;Fresh;92;72;11;1;12;3
Heart Condition;;Rotten;0;34;0;8;8;2
The Heart Is a Lonely Hunter;1968;Fresh;100;85;9;0;9;1
Heart of a Dog;2015;Certified-Fresh;96;64;86;4;90;26
Neil Young: Heart of Gold;2006;Certified-Fresh;90;79;88;10;98;39
Question humaine, La, (Heartbeat Detector);2007;Fresh;80;48;20;5;25;12
Heartbeeps;1981;Rotten;0;23;0;6;6;0
Heartbreak Ridge;1986;Fresh;73;74;19;7;26;9
Heartburn;1986;Rotten;45;47;9;11;20;4
Heartless;2010;Certified-Fresh;78;47;31;9;40;14
Heartlock;2019;Rotten;40;67;2;3;5;4
Hearts and Minds;1975;Certified-Fresh;90;91;36;4;40;12
Hearts Beat Loud;2018;Certified-Fresh;92;73;142;13;155;29
Hearts in Atlantis;2001;Rotten;49;64;67;70;137;33
Hearts of Darkness: A Filmmaker's Apocalypse;1991;Fresh;100;94;27;0;27;8
Hearts of Fire;1900;Rotten;40;35;2;3;5;2
Hearts Of The West (Hollywood Cowboy);1975;Fresh;88;43;7;1;8;1
Heartstone (Hjartasteinn);2017;Fresh;84;77;21;4;25;4
Wild Card;2015;Rotten;32;29;18;38;56;18
Heat and Dust;1983;Fresh;85;56;11;2;13;3
Heathers;1988;Certified-Fresh;93;83;53;4;57;12
Heatstroke;2014;Rotten;9;20;1;10;11;0
Heaven;2002;Fresh;74;76;65;23;88;29
Heaven;1999;Fresh;60;58;3;2;5;0
Heaven Can Wait;1943;Fresh;85;75;11;2;13;2
Heaven Help Us;1985;Rotten;33;74;2;4;6;2
Heaven Is for Real;2014;Rotten;51;66;45;44;89;26
Heaven Knows Mr. Allison;1957;Fresh;88;81;7;1;8;0
Heaven Knows What;2015;Certified-Fresh;87;66;62;9;71;26
Heavenly Creatures;1994;Certified-Fresh;92;83;47;4;51;13
Heaven's Gate;1980;Rotten;58;54;26;19;45;14
Heaven's Prisoners;1996;Rotten;16;31;3;16;19;5
Heavy;1996;Fresh;86;68;24;4;28;6
Heavy Metal 2000;2000;Rotten;10;36;1;9;10;1
Heavy Metal in Baghdad;2008;Fresh;83;86;20;4;24;12
Heavy Traffic;1973;Fresh;89;75;16;2;18;5
Heavy Trip (Hevi reissu);2018;Fresh;94;85;29;2;31;6
Heavyweights;1995;Rotten;29;77;2;5;7;0
The Hebrew Hammer;2003;Rotten;46;64;11;13;24;11
Hector And The Search For Happiness;2014;Rotten;37;61;32;54;86;27
Hedwig and the Angry Inch;2001;Certified-Fresh;92;93;106;9;115;33
Heidi Fleiss: Hollywood Madam;1995;Fresh;75;47;6;2;8;6
Heights;2005;Fresh;64;74;67;38;105;31
Heima (Sigur Ros: Heima);2007;Fresh;90;96;9;1;10;6
Heimat Is a Space in Time (Heimat ist ein Raum aus Zeit);2020;Fresh;100;;18;0;18;8
Heist;2015;Rotten;29;41;8;20;28;11
Held Up;2000;Rotten;17;42;5;25;30;8
Helena From The Wedding;2010;Rotten;50;25;5;5;10;5
Heleno;2012;Rotten;46;55;6;7;13;6
Heli;2014;Rotten;59;62;26;18;44;21
Helicopter Mom;2015;Rotten;29;80;2;5;7;2
Hell & Back;2015;Rotten;0;34;0;5;5;0
Hell and Back Again;2011;Fresh;100;69;30;0;30;14
Hell Baby;2013;Rotten;31;27;12;27;39;13
Hell Comes to Frogtown;1987;Rotten;56;47;5;4;9;0
Hell Fest;2018;Rotten;40;41;26;39;65;9
Hell House;2002;Fresh;94;66;32;2;34;6
Hell House LLC III: Lake of Fire;1900;Rotten;14;48;1;6;7;0
Hell Is for Heroes;1962;Fresh;83;74;5;1;6;0
Hell Night;1981;Rotten;56;45;5;4;9;1
Hell on the Border;2019;Rotten;40;33;2;3;5;0
Hell or High Water;2016;Certified-Fresh;97;88;272;8;280;54
Hell to Eternity;1960;Fresh;83;50;5;1;6;2
Hell Up in Harlem;1973;Rotten;22;50;2;7;9;0
Hellbenders;2013;Rotten;33;22;3;6;9;3
Hellbound?;2012;Fresh;75;78;6;2;8;5
Hellbound: Hellraiser II;1988;Rotten;50;58;15;15;30;6
Hellboy;2004;Certified-Fresh;81;66;165;38;203;43
Hellboy;2019;Rotten;18;49;38;177;215;40
Hellboy II: The Golden Army (Hellboy 2);2008;Certified-Fresh;86;71;214;35;249;56
Hellion;2014;Fresh;60;46;30;20;50;18
Hellions;2015;Rotten;27;16;8;22;30;10
Hello Again;1987;Rotten;11;50;2;17;19;5
Hello, Dolly!;1969;Rotten;43;76;13;17;30;5
Hello Herman;2012;Rotten;20;74;2;8;10;4
Hello I Must Be Going;2012;Certified-Fresh;75;55;39;13;52;25
Hello Lonesome;2011;Fresh;73;59;11;4;15;7
Hello Mary Lou: Prom Night II;1987;Rotten;53;37;9;8;17;4
Hello, My Name is Doris;2016;Certified-Fresh;85;76;107;19;126;28
Hellraiser;1987;Fresh;72;72;33;13;46;5
Hellraiser - Bloodline;1996;Rotten;27;37;4;11;15;1
Hellraiser: Deader;2005;Rotten;14;26;1;6;7;0
Hellraiser: Hellseeker;2002;Rotten;0;33;0;8;8;0
Hellraiser: Hellworld;2005;Rotten;17;22;1;5;6;0
Hellraiser III: Hell on Earth;1992;Rotten;39;35;7;11;18;5
Hellraiser: Judgment;1900;Rotten;50;26;4;4;8;0
Helter Skelter;1976;Fresh;100;74;12;0;12;0
Helvetica;2007;Fresh;88;80;15;2;17;10
Hemingway & Gellhorn;1900;Rotten;49;41;24;25;49;24
Henri Langlois: The Phantom of the Cinematheque;2004;Fresh;93;91;13;1;14;8
Henry: Portrait of a Serial Killer;1986;Certified-Fresh;87;71;54;8;62;17
Henry Fool;1998;Fresh;89;82;25;3;28;4
Henry Poole Is Here;2008;Rotten;40;52;40;60;100;33
Henry V (The Chronicle History of King Henry the Fift with His Battell Fought at Agincourt in France);1946;Fresh;100;75;28;0;28;10
Henry's Crime;2011;Rotten;42;25;23;32;55;24
Her;2013;Certified-Fresh;95;82;263;15;278;53
Her Alibi;1989;Rotten;17;44;4;19;23;6
Herb & Dorothy;2008;Fresh;96;82;27;1;28;15
Wild Grass (Les Herbes Folles);2010;Fresh;68;37;62;29;91;32
Herbie: Fully Loaded;2005;Rotten;40;38;58;86;144;35
Herbie Goes Bananas;1980;Rotten;40;37;2;3;5;2
Herbie Goes to Monte Carlo;1977;Fresh;60;57;6;4;10;1
Herbie Hancock: Possibilities;2006;Rotten;30;59;3;7;10;6
Herbie Rides Again;1974;Fresh;80;53;4;1;5;0
Hercules;1997;Certified-Fresh;84;76;46;9;55;15
Hercules in New York;1975;Rotten;17;27;1;5;6;0
Hercules in the Haunted World;1961;Rotten;57;54;4;3;7;0
Hercules;2014;Rotten;58;48;69;51;119;30
Here;2012;Fresh;71;49;10;4;14;9
Here and There;2010;Fresh;67;67;8;4;12;6
Here Comes Mr. Jordan;1941;Fresh;100;83;20;0;20;0
Here Comes the Boom;2012;Rotten;41;65;39;57;96;25
Here Comes the Devil;2013;Rotten;46;31;12;14;26;8
Here Comes the Groom;1951;Fresh;60;72;3;2;5;1
Here on Earth;2000;Rotten;17;61;12;57;69;26
Hereafter;2010;Rotten;47;38;110;125;235;51
Hereditary;2018;Certified-Fresh;89;67;330;41;371;53
Herman's House;2013;Fresh;88;72;14;2;16;9
Hermia & Helena;2017;Fresh;85;33;22;4;26;9
Hero;2004;Certified-Fresh;95;87;197;11;208;47
Hero and the Terror;1988;Rotten;0;37;0;6;6;1
Heroin(e);1900;Fresh;100;90;10;0;10;3
Herschell Gordon Lewis: The Godfather of Gore;1900;Fresh;60;55;3;2;5;1
He's Just Not That Into You;2009;Rotten;42;59;70;98;168;51
He's Way More Famous Than You;2013;Rotten;40;45;4;6;10;7
Hesher;2011;Rotten;55;61;42;34;76;29
Hester Street;1975;Fresh;71;62;12;5;17;6
Hexed;1900;Rotten;9;36;1;10;11;3
Hey Arnold! The Movie;2002;Rotten;29;36;23;55;78;25
Hey Bartender;2013;Fresh;65;63;13;7;20;9
Hey, Boo: Harper Lee and 'To Kill a Mockingbird';2011;Fresh;78;81;25;7;32;14
Hey Happy!;2001;Rotten;38;50;5;8;13;4
Hey Hey It's Esther Blueburger;2008;Rotten;50;55;3;3;6;2
H.H. Holmes - America's First Serial Killer;2004;Fresh;75;43;6;2;8;0
Hick;2012;Rotten;5;36;1;21;22;9
Hickey & Boggs;2000;Fresh;67;57;4;2;6;2
Hickok;2017;Rotten;57;18;4;3;7;4
Hidalgo;2004;Rotten;46;64;75;89;164;39
The Hidden;1987;Fresh;75;72;21;7;28;6
Hidden;2015;;;;4;1;;0
The Hidden Blade;2006;Fresh;84;84;27;5;32;10
Hidden Figures;2017;Certified-Fresh;93;93;292;22;314;45
Hide;2008;Fresh;83;51;10;2;12;5
Hide Away (A Year in Mooring);2012;Rotten;42;36;5;7;12;8
Hideous Kinky;1998;Fresh;65;60;34;18;52;12
Hiding Out;1987;Rotten;33;70;2;4;6;1
High Tension (Switchblade Romance);2005;Rotten;41;67;54;79;133;28
High and Low (Tengoku to jigoku);1963;Fresh;95;95;19;1;20;3
The High and the Mighty;1954;Rotten;33;59;3;6;9;0
High Anxiety;1977;Fresh;72;67;21;8;29;1
High Art;1998;Fresh;73;77;33;12;45;7
High Crimes;2002;Rotten;31;50;41;92;133;35
High Flying Bird;1900;Certified-Fresh;92;50;119;11;130;29
High Ground;2012;Fresh;100;74;8;0;8;5
High Heels and Lowlifes;2001;Rotten;20;49;6;24;30;7
High Life;2019;Certified-Fresh;82;41;187;42;229;38
High Plains Drifter;1973;Fresh;92;86;24;2;26;4
High-Rise;2016;Fresh;60;36;130;87;217;35
High School High;1996;Rotten;19;37;3;13;16;4
High School Musical;2006;Fresh;63;74;12;7;19;3
High School Musical 2;2007;Fresh;82;72;18;4;22;11
High Sierra;1941;Fresh;90;78;18;2;20;0
High Society;1956;Fresh;82;83;14;3;17;3
High Spirits;1988;Rotten;27;59;4;11;15;0
High Strung;2016;Fresh;75;63;6;2;8;4
High Strung Free Dance;2019;Rotten;50;85;3;3;6;3
Higher Ground;2011;Certified-Fresh;82;62;76;17;93;32
Higher Learning;1994;Rotten;45;74;18;22;40;13
Highlander;1986;Fresh;69;79;25;11;36;5
Highlander 2: The Quickening;1991;Rotten;0;23;0;24;24;5
Highlander III: The Sorcerer (Highlander: The Final Dimension);1993;Rotten;5;28;1;19;20;6
Highlander: Endgame;2000;Rotten;11;38;6;48;54;14
Highwater;2010;Rotten;43;74;6;8;14;8
Hilary and Jackie;1998;Certified-Fresh;88;83;51;7;58;19
Hi-Life;1998;Fresh;83;23;5;1;6;2
Hillary's America: The Secret History of the Democratic Party;2016;Rotten;4;80;1;27;28;12
The Hills Have Eyes;2006;Rotten;52;58;74;68;142;34
The Hills Have Eyes 2;2007;Rotten;12;40;8;60;68;20
The Hills Have Eyes, Part 2;1985;Rotten;0;19;0;7;7;1
Hillsong - Let Hope Rise;2016;Fresh;60;78;6;4;10;4
Himalaya (L'Enfance d'un Chef) (Caravan);1999;Certified-Fresh;87;91;47;7;54;21
Himizu;2013;Fresh;95;72;21;1;22;6
The Hip Hop Project;2006;Rotten;59;67;23;16;39;18
Hipsters;2011;Fresh;80;90;20;5;25;13
Hiroshima Mon Amour;1960;Fresh;97;89;36;1;37;6
The Golden Compass;2007;Rotten;42;51;83;114;197;49
His Girl Friday;1940;Certified-Fresh;98;90;61;1;62;8
Historias que so existem quando lembradas (Found Memories);2012;Fresh;91;73;10;1;11;5
The History Boys;2006;Fresh;66;70;69;36;105;42
History of the World---Part I;1981;Rotten;58;81;18;13;31;3
A History of Violence;2005;Certified-Fresh;87;76;188;28;216;47
Hit & Run;2012;Rotten;48;49;65;71;136;39
Hit and Runway;1999;Rotten;32;17;11;23;34;13
Hit By Lightning;2014;Rotten;11;19;1;8;9;5
Hit So Hard;2012;Fresh;66;72;25;13;38;17
Hitch;2005;Fresh;69;62;129;59;188;39
Hitchcock;2012;Fresh;60;60;129;87;216;50
Hitchcock/Truffaut;2015;Certified-Fresh;96;76;113;5;118;33
The Hitcher;2007;Rotten;19;52;21;87;108;23
The Hitchhiker's Guide to the Galaxy;2005;Fresh;60;65;120;80;200;40
Hitler: The Last Ten Days;1973;Rotten;33;48;2;4;6;3
Hitler's Children;2012;Fresh;81;71;13;3;16;8
Hitman;2007;Rotten;15;57;16;89;105;31
Hitman: Agent 47;2015;Rotten;9;40;11;118;129;31
The Hobbit;1978;Fresh;69;65;11;5;16;0
Hobo With a Shotgun;2011;Fresh;66;57;78;41;119;28
Hockney;2016;Certified-Fresh;85;67;40;7;47;18
Hocus Pocus;1993;Rotten;37;71;20;34;54;15
Hoffa;1992;Rotten;52;59;13;12;25;5
Hold the Dark;1900;Fresh;71;31;59;24;83;15
Holding The Man;1900;Fresh;81;81;21;5;26;7
Holding Trevor;2007;Rotten;25;30;2;6;8;4
Hal i mitt hjarta, Ett (A Hole In My Heart);2004;Rotten;44;36;8;10;18;9
Holes;2003;Certified-Fresh;78;76;108;31;139;35
Holiday;1938;Fresh;100;89;26;0;26;3
Holiday Hell;1900;Rotten;20;17;1;4;5;1
Holiday in the Wild;1900;Rotten;38;47;3;5;8;1
Holiday Inn;1942;Fresh;100;86;25;0;25;5
Holidays;2016;Rotten;52;24;15;14;29;5
Hollow;2012;Rotten;20;65;3;12;15;4
Hollow Man;2000;Rotten;27;28;32;86;118;31
Hollow Man 2;2006;Rotten;20;16;1;4;5;1
Holly;2007;Fresh;65;64;15;8;23;12
Hollywood Ending;2002;Rotten;46;49;62;72;134;39
Hollywood Homicide;2003;Rotten;30;27;49;114;163;39
The Hollywood Knights;1980;Rotten;14;70;1;6;7;2
Hollywood Shuffle;1982;Fresh;88;80;22;3;25;6
Hollywood to Dollywood;2012;Fresh;67;57;4;2;6;4
Hollywoodland;2006;Fresh;68;48;127;59;186;43
Holmes and Watson;2018;Rotten;10;26;8;70;78;17
Holy Ghost People;2014;Rotten;43;27;3;4;7;3
Holy Man;1998;Rotten;12;24;6;44;50;14
Holy Motors;2012;Certified-Fresh;92;71;177;15;192;48
The Holy Mountain;1973;Fresh;83;89;20;4;24;9
Holy Rollers;2010;Rotten;52;33;47;43;90;32
Holy Smoke;2000;Rotten;45;47;37;45;82;25
Hombre;1967;Fresh;93;80;14;1;15;3
Home Page;1900;Fresh;86;;12;2;14;1
Home;2013;Fresh;88;82;7;1;8;5
Home;2015;Rotten;51;64;70;67;137;34
Home Again;2017;Rotten;32;44;44;94;138;35
Home Alone;;Fresh;65;80;35;19;54;14
Home Alone 2: Lost in New York;1992;Rotten;33;61;18;36;54;14
Home Alone 3;1997;Rotten;29;27;7;17;24;7
A Home at the End of the World;2004;Rotten;50;67;59;58;117;35
Home Fries;1998;Rotten;31;33;11;25;36;7
Home from the Hill;1960;Fresh;90;91;9;1;10;1
Home of the Brave;2006;Rotten;23;46;13;44;57;20
Home on the Range;2004;Rotten;53;29;68;61;129;34
Home Room;2003;Rotten;55;78;12;10;22;9
Home Run;2013;Rotten;50;81;6;6;12;3
Home Sweet Hell;2015;Rotten;5;26;1;20;20;10
Homecoming: A Film by Beyonce;1900;Certified-Fresh;98;87;54;1;55;22
Homefront;2013;Rotten;43;61;50;65;115;38
Homegrown;1998;Rotten;44;50;8;10;18;6
Homer & Eddie;1989;Rotten;0;35;0;7;7;0
Homeward Bound II - Lost in San Francisco;1996;Rotten;53;44;9;8;17;7
Homeward Bound - The Incredible Journey;1993;Fresh;87;71;26;4;30;11
Homicidal;1961;Fresh;78;65;7;2;9;0
Hondo;1953;Fresh;86;74;6;1;7;0
Hondros;2018;Fresh;100;84;10;0;10;4
Honey;2003;Rotten;21;71;24;92;116;35
Honey 2;1900;Rotten;10;53;2;19;21;6
Honey, I Blew Up the Kid;1992;Rotten;40;24;8;12;20;3
Honey, I Shrunk the Kids;1989;Fresh;76;54;26;8;34;5
Honey, We Shrunk Ourselves!;1997;Rotten;25;27;2;6;8;0
Honeydripper;2007;Fresh;69;57;59;27;86;32
Honeyglue;2016;Rotten;36;69;4;7;11;5
Honeymoon;2014;Certified-Fresh;75;44;43;14;57;10
Honeymoon in Vegas;1992;Fresh;63;35;20;12;32;4
The Honeymoon Killers;1970;Fresh;95;69;18;1;19;3
Honkytonk Man;1982;Fresh;93;64;13;1;14;5
Honor Flight;2012;Fresh;80;93;4;1;5;3
Honra e Liberdade;2005;Rotten;40;47;2;3;5;2
Hoodwinked Too! Hood vs Evil;2011;Rotten;11;35;7;58;65;25
Hook;1991;Rotten;29;76;19;46;65;14
Hooked;2018;Rotten;20;29;1;4;5;1
Hooking Up;2020;Rotten;30;49;7;16;23;6
Hoop Dreams;1994;Certified-Fresh;98;93;58;1;59;16
Hoosiers;1986;Certified-Fresh;89;88;40;5;45;10
Hoot;2006;Rotten;26;54;26;73;99;31
Hop;2011;Rotten;24;53;34;105;139;30
Hope Floats;1998;Rotten;26;72;9;25;34;9
Hope Springs;2003;Rotten;23;27;3;10;13;3
Hope Springs;2012;Certified-Fresh;75;55;131;43;174;51
Hope Springs Eternal;2018;Fresh;88;32;7;1;8;1
Hopscotch;1980;Fresh;73;77;11;4;15;1
Hornblower: The Examination for Lieutenant (Horatio Hornblower: The Fire Ship);1998;Fresh;80;89;4;1;5;0
Horns;2014;Rotten;41;49;51;73;124;38
Horrible Bosses;2011;Fresh;69;70;153;68;221;52
Horrible Bosses 2;2014;Rotten;34;47;54;104;157;36
Horrid Henry: The Movie;2013;Rotten;9;39;2;20;22;6
#Horror;2015;Rotten;46;9;6;7;13;5
Horror Express;1974;Fresh;75;52;9;3;12;1
Horror Hotel;1961;Fresh;71;67;5;2;7;0
Horror of Dracula;1958;Certified-Fresh;90;80;36;4;40;8
Outside the Law (Hors-la-loi);2010;Certified-Fresh;76;65;31;10;41;20
Horse Girl;2020;Fresh;70;48;39;17;56;15
The Horse Soldiers;1959;Fresh;91;75;10;1;11;0
The Horse Whisperer;1998;Fresh;74;72;42;15;57;14
Horsemen;2009;Rotten;33;25;2;4;6;1
The Horse's Mouth;1958;Fresh;88;77;15;2;17;0
Dr. Seuss' Horton Hears a Who!;2008;Certified-Fresh;79;73;107;28;135;36
The Hospital;1971;Fresh;100;73;11;0;11;1
Hospitality;2018;Rotten;20;44;1;4;5;1
Hostel;2006;Fresh;61;53;66;43;109;19
Hostel Part II;2007;Rotten;44;39;49;63;112;29
Hostel: Part III;1900;Fresh;67;19;4;2;6;0
Hostile;1900;Fresh;60;50;3;2;5;0
Hostile Border (Pocha: Manifest Destiny);2016;Fresh;67;55;4;2;6;2
Hostiles;2018;Fresh;70;75;155;65;220;42
Hot Air;2019;Rotten;18;68;3;14;17;4
The Hot Chick;2002;Rotten;22;59;18;65;83;24
Hot Fuzz;2007;Certified-Fresh;91;89;186;18;204;53
Hot Rod;2007;Rotten;39;64;46;72;118;32
Hot Shots! Part Deux;1993;Rotten;57;63;17;13;30;8
Hot Summer Nights;2018;Rotten;43;58;17;23;40;17
Hot to Trot;1900;Rotten;0;40;0;16;16;6
Hot Tub Time Machine;2010;Fresh;64;56;133;76;209;49
Hot Tub Time Machine 2;2015;Rotten;13;26;14;93;107;32
Hotel;2003;Rotten;41;31;11;16;27;12
Hotel Artemis;2018;Rotten;58;35;103;74;177;36
Hotel de Love;1996;Rotten;22;54;2;7;9;4
Hotel for Dogs;2009;Rotten;46;54;56;66;122;35
Hotel Mumbai;2019;Certified-Fresh;76;86;163;51;214;35
The Hotel New Hampshire;1984;Fresh;71;51;10;4;14;0
Hotel Rwanda;2004;Certified-Fresh;91;94;176;18;194;44
Hotel Transylvania;2012;Rotten;45;72;65;80;145;35
Hotel Transylvania 2;2015;Rotten;56;64;60;49;108;26
Hotel Transylvania 3: Summer Vacation;2018;Fresh;62;48;73;45;118;25
H.O.T.S.;1979;Rotten;29;21;2;5;7;0
The Hottie and the Nottie;2008;Rotten;6;31;4;64;68;29
Hounds of Love;2017;Certified-Fresh;88;69;86;12;98;21
Hour of the Gun;1967;Fresh;86;49;6;1;7;1
Hour of the Wolf (Vargtimmen);1968;Fresh;92;86;22;2;24;4
The Hours;2002;Certified-Fresh;80;84;155;39;194;42
Hours;2013;Fresh;61;61;20;13;33;11
House II: The Second Story;1987;Rotten;8;42;1;12;13;0
House at the End of the Street;2012;Rotten;13;41;9;58;67;14
The House Bunny;2008;Rotten;44;50;54;70;124;35
House By the River;1950;Fresh;62;70;8;5;13;4
House In The Alley;2013;Rotten;25;67;2;6;8;6
House of 1000 Corpses;2003;Rotten;20;65;17;68;85;15
House Of Boys;2011;Rotten;50;48;4;4;8;3
House of Cardin;2020;Fresh;92;;11;1;12;3
House of Cards;1992;Rotten;56;69;5;4;9;2
House of D;2004;Rotten;10;73;10;92;102;31
House of Dark Shadows;1970;Rotten;43;70;3;4;7;1
House of Dracula;1945;Rotten;56;29;5;4;9;1
Lisa And The Devil (Lisa e il diavolo) (The Devil in the House of Exorcism);1973;Fresh;62;50;8;5;13;0
House of Flying Daggers;2004;Certified-Fresh;87;82;151;22;173;43
House of Fools;2003;Rotten;41;82;20;29;49;20
House of Frankenstein;1944;Rotten;55;47;6;5;11;0
House of Games;1987;Fresh;96;79;26;1;27;1
House of Hummingbird (Beolsae);2020;Certified-Fresh;100;64;43;0;43;7
House of Pleasures;2011;Fresh;83;62;24;5;29;16
House of Sand and Fog;2003;Certified-Fresh;74;83;135;47;182;39
House of Wax;2005;Rotten;26;42;41;117;158;32
The House of Yes;1997;Fresh;62;77;24;15;39;12
The House on 92nd Street;1945;Rotten;50;52;3;3;6;0
The House on Carroll Street;1988;Fresh;67;28;4;2;6;1
The House on Sorority Row;1983;Rotten;50;34;5;5;10;0
House On Willow Street;2017;Rotten;55;80;6;5;11;1
House Party;;Fresh;93;82;26;2;28;8
House Party 2;1991;Rotten;21;65;3;11;14;3
House Party 3;1994;Rotten;0;67;0;9;9;1
The House That Dripped Blood;1971;Fresh;86;57;12;2;14;2
Houseboat;1958;Fresh;64;72;7;4;11;0
Housebound;2014;Certified-Fresh;95;73;40;2;42;10
Houseguest;1995;Rotten;14;55;3;18;21;6
Housesitter;1992;Rotten;40;47;8;12;20;3
Hover;2018;Rotten;20;38;1;4;5;3
How Do You Know;2010;Rotten;31;24;47;104;151;48
How Green Was My Valley;1941;Certified-Fresh;89;81;42;5;47;9
How High;2001;Rotten;26;79;15;42;57;20
How I Ended This Summer;2010;Certified-Fresh;79;67;34;9;43;17
How I Live Now;2013;Fresh;66;55;72;37;109;35
How It Ends;2018;Rotten;17;16;3;15;18;2
How Murray Saved Christmas;1900;Rotten;50;60;3;3;6;4
How She Move;2008;Fresh;66;51;52;27;79;28
How Stella Got Her Groove Back;1998;Rotten;50;66;25;25;50;13
How Sweet It Is;2013;Rotten;0;62;0;6;6;5
Dr. Seuss' How the Grinch Stole Christmas;2000;Rotten;49;56;70;72;142;33
How the West Was Won;1963;Fresh;86;74;19;3;22;3
How to Be a Latin Lover;2017;Rotten;39;61;12;19;31;8
How to Be a Player;1997;Rotten;11;76;1;8;9;1
How To Be Single;2016;Rotten;47;47;74;83;156;37
How to Build a Girl;2020;Certified-Fresh;79;58;102;27;129;22
How To Change The World;2015;Fresh;95;87;20;1;21;10
How to Cook Your Life;2007;Fresh;72;46;18;7;25;9
How to Deal;2003;Rotten;27;64;26;71;97;34
How To Die In Oregon;2011;Fresh;100;94;10;0;10;1
How to Eat Fried Worms;2006;Fresh;60;47;45;30;75;29
How to Eat Your Watermelon in White Company (And Enjoy It);2005;Fresh;92;85;11;1;12;6
How to Live Forever;2011;Fresh;60;51;12;8;20;12
How to Lose a Guy in 10 Days;2003;Rotten;42;77;63;87;150;36
How to Lose Friends & Alienate People;2008;Rotten;37;42;41;71;112;37
How to Make an American Quilt;1995;Fresh;61;63;20;13;33;12
How To Make Money Selling Drugs;2013;Fresh;77;91;30;9;39;20
How to Marry a Millionaire;1953;Fresh;84;78;21;4;25;5
How to Murder Your Wife;1965;Fresh;64;64;9;5;14;3
How to Rob a Bank;2007;Rotten;29;42;4;10;14;6
How to Smell a Rose: A Visit with Ricky Leacock at his Farm in Normandy;2015;Fresh;100;50;7;0;7;4
How to Steal a Million;1966;Fresh;100;88;8;0;8;0
How to Succeed in Business Without Really Trying;1967;Fresh;92;82;11;1;12;0
How to Survive a Plague;2012;Certified-Fresh;98;82;78;2;80;36
How to Talk to Girls at Parties;2018;Rotten;48;39;45;49;94;25
How to Train Your Dragon;2010;Certified-Fresh;99;91;207;3;210;48
How to Train Your Dragon 2;2014;Certified-Fresh;91;90;170;16;186;45
How to Train Your Dragon: The Hidden World;2019;Certified-Fresh;90;86;238;25;263;36
Howard the Duck;1986;Rotten;14;38;7;43;50;12
Howard Zinn: You Can't Be Neutral on a Moving Train;2004;Fresh;97;84;29;1;30;13
Howards End;1992;Certified-Fresh;94;82;62;4;66;19
The Howling;1981;Fresh;69;58;25;11;36;1
Howling II;1985;Rotten;25;14;3;9;12;1
Howling III: The Marsupials;1987;Rotten;17;16;2;10;12;0
Howling: Reborn;1900;Rotten;20;20;1;4;5;0
Howl's Moving Castle;2005;Certified-Fresh;87;93;157;24;181;51
Hubble 3D;2010;Certified-Fresh;88;86;37;5;42;14
Hudson Hawk;1991;Rotten;30;56;11;26;37;6
The Hudsucker Proxy;1994;Rotten;59;79;26;18;44;12
Hugh Hefner: Playboy, Activist and Rebel;2010;Fresh;60;69;26;17;43;20
Hugo;2011;Certified-Fresh;93;78;211;16;227;49
Hulk;2003;Fresh;62;29;146;90;236;48
HULK VS.;2009;Fresh;100;67;7;0;7;0
Human Capital;2015;Certified-Fresh;81;77;54;13;67;21
Human Capital;2020;Fresh;68;29;42;20;62;9
The Human Centipede (First Sequence);2010;Rotten;49;25;47;49;96;18
Human Flow;2017;Certified-Fresh;91;81;107;11;118;31
The Human Stain;2003;Rotten;42;49;65;90;155;41
Human Traffic;2000;Rotten;59;89;17;12;29;9
Humanoids From the Deep;1980;Rotten;55;41;6;5;11;0
Humboldt County;2008;Fresh;60;59;12;8;20;8
Hummus! The Movie;1900;Fresh;88;;7;1;8;0
Humoresque;1946;Fresh;67;71;4;2;6;0
Humpday;2009;Certified-Fresh;79;51;109;29;138;42
Hunger;2008;Certified-Fresh;90;83;115;13;128;38
Hungry Hearts;2015;Fresh;63;56;24;14;38;16
Hunky Dory;2013;Rotten;54;49;25;21;46;17
The Hunt for Red October;;Certified-Fresh;89;88;63;8;71;17
Hunt for the Wilderpeople;2016;Certified-Fresh;96;91;191;7;198;37
Hunter Gatherer;2016;Fresh;96;59;23;1;24;10
Hunter Killer;2018;Rotten;36;69;40;70;110;25
Hunting Elephants;2015;Rotten;36;61;5;9;14;7
Hurricane Streets;1997;Fresh;88;78;14;2;16;2
Hurry Sundown;1967;Rotten;22;27;2;7;9;5
Husbands;1970;Fresh;64;80;21;12;33;8
Hush;1900;Certified-Fresh;93;73;37;3;40;5
Hush...Hush, Sweet Charlotte;1964;Fresh;82;85;23;5;28;4
Hustle & Flow;2005;Certified-Fresh;83;83;132;28;160;42
The Hustler;1961;Certified-Fresh;98;93;43;1;44;9
Hustlers;2013;Rotten;18;36;3;14;17;7
Hustlers;2019;Certified-Fresh;87;65;297;43;339;40
Hwal (The Bow);2007;Fresh;86;78;6;1;7;1
Hybrid;2001;Fresh;88;;14;2;16;2
Hyde Park on Hudson;2012;Rotten;37;31;66;112;178;47
Hyena Road;2016;Rotten;55;59;12;10;22;9
Hyenes (Hyenas);1992;Fresh;88;70;7;1;8;2
Hype!;1996;Fresh;92;87;24;2;26;14
Hysteria;2012;Rotten;59;54;79;55;134;37
I Knew It Was You: Rediscovering John Cazale;2009;Fresh;80;85;4;1;5;0
I Want Candy;2007;Rotten;56;38;5;4;9;3
I Am a Fugitive From a Chain Gang;1932;Fresh;96;91;24;1;25;3
I Am A Sex Addict;2006;Fresh;63;57;20;12;32;14
I Am Ali;2014;Fresh;64;59;16;9;25;12
I Am Big Bird: The Caroll Spinney Story;2015;Certified-Fresh;84;79;61;12;73;28
I Am Bolt;1900;Fresh;85;61;11;2;13;4
I Am Bruce Lee;2012;Fresh;75;78;9;3;12;4
I Am Chris Farley;2015;Fresh;71;77;22;9;31;12
I Am David;2004;Rotten;39;84;13;20;33;10
I Am Divine;2013;Certified-Fresh;96;83;51;2;53;17
I Am Happiness on Earth;2014;Rotten;29;17;2;5;7;3
I Am Heath Ledger;2017;Fresh;86;84;25;4;29;9
I Am Jonas (Jonas);1900;Fresh;100;83;5;0;5;0
I Am Legend;2007;Fresh;68;68;146;69;215;57
I Am Love;2010;Certified-Fresh;81;68;108;25;133;39
I Am Michael;2017;Fresh;64;37;23;13;36;14
I Am Mother;1900;Certified-Fresh;91;74;67;7;74;15
I Am Not a Serial Killer;2016;Certified-Fresh;93;61;53;4;57;10
I Am Not An Easy Man (Je ne suis pas un homme facile);2018;Fresh;80;72;4;1;5;0
I Am Not Your Negro;2017;Certified-Fresh;99;83;203;3;206;39
I Am Number Four;2011;Rotten;33;57;55;113;168;37
I Am Richard Pryor;1900;Fresh;88;;7;1;8;2
I Am Sam;2001;Rotten;35;87;51;94;145;39
I Am the Pretty Thing That Lives in the House;2016;Rotten;58;24;11;8;19;5
I Am Thor;2015;Fresh;91;70;10;1;11;3
I Am Trying to Break Your Heart;2002;Certified-Fresh;88;90;53;7;60;22
I Am Vengeance;2018;Rotten;38;30;3;5;8;1
I Am Vengeance: Retaliation;1900;Rotten;44;25;4;5;9;2
I Am Woman;2020;Fresh;65;76;47;25;72;21
I Am Wrath;2016;Rotten;11;33;1;8;9;3
I Bury the Living;1900;Fresh;64;49;7;4;11;0
I Can Do Bad All By Myself;2009;Fresh;61;81;28;18;46;14
I Can Only Imagine;2018;Fresh;63;91;20;12;32;6
I Can See You;2008;Fresh;100;44;5;0;5;4
I Capture the Castle;2003;Certified-Fresh;79;76;66;18;84;29
I Come in Peace;1900;Rotten;33;45;9;18;27;5
I Confess;1952;Fresh;83;76;24;5;29;6
I, Daniel Blake;2017;Certified-Fresh;92;85;167;15;182;32
I Declare War;2013;Fresh;73;53;30;11;41;15
I Do (Prete-moi ta main);1900;Rotten;53;72;8;7;15;7
I Do;2013;Rotten;17;55;2;10;12;6
I don't feel at home in this world anymore.;2017;Certified-Fresh;89;76;58;7;65;12
I Don't Know How She Does It;2011;Rotten;17;32;19;94;113;41
De eso no se habla (I Don't Want to Talk About It);1993;Fresh;80;83;4;1;5;1
I Dreamed of Africa;2000;Rotten;10;56;10;91;101;35
I Feel Pretty;2018;Rotten;35;35;80;146;226;48
I, Frankenstein;2014;Rotten;5;38;5;99;104;18
I Give It a Year;2013;Rotten;51;38;42;40;82;22
I Got The Hook-Up;1998;Rotten;17;64;2;10;12;2
I Hate Kids;2019;Rotten;22;82;2;7;9;4
I Hate Valentine's Day;2009;Rotten;19;28;5;22;27;17
I Have Never Forgotten You: The Life And Legacy Of Simon Wiesenthal;2007;Fresh;80;87;20;5;25;15
I Heart Huckabees;2004;Fresh;63;75;122;72;194;46
I Hope They Serve Beer in Hell;2009;Rotten;20;42;7;28;35;16
The I Inside;2005;Rotten;43;43;3;4;7;0
I Kill Giants;2018;Certified-Fresh;77;75;48;14;62;13
I Killed My Mother;2013;Fresh;83;81;19;4;23;6
I Know What You Did Last Summer;1997;Rotten;43;40;29;39;68;18
I Know Where I'm Going!;1947;Fresh;100;82;12;0;12;1
I Know Who Killed Me;2007;Rotten;9;26;7;70;77;18
I Like It Like That;1994;Fresh;80;91;8;2;10;4
I Lost My Body;2019;Certified-Fresh;96;84;78;3;81;12
I Love Trouble;1994;Rotten;22;33;10;36;46;15
I Love You Again;1940;Fresh;100;82;6;0;6;1
I Love You, Alice B. Toklas;1968;Rotten;14;56;1;6;7;2
I Love You, I Love You Not;1997;Rotten;40;40;2;3;5;0
I Love You, Man;2009;Certified-Fresh;83;74;173;35;208;50
I Love You Phillip Morris;2010;Certified-Fresh;71;61;111;46;157;43
I Love You, Stupid (Te quiero, Imbecil);1900;Fresh;63;58;5;3;8;0
I Love You to Death;;Rotten;56;63;14;11;25;7
I Married a Monster from Outer Space;1958;Fresh;86;57;12;2;14;0
I Married a Strange Person;1998;Fresh;73;88;8;3;11;2
I Married a Witch;1942;Fresh;95;69;21;1;22;4
I Melt with You;2011;Rotten;16;43;7;38;45;12
I Now Pronounce You Chuck & Larry;2007;Rotten;15;69;24;140;164;46
I.O.U.S.A.;2008;Certified-Fresh;88;86;57;8;65;26
I Origins;2014;Rotten;52;69;55;50;105;41
I, Pastafari: A Flying Spaghetti Monster Story;2020;Fresh;75;85;6;2;8;2
I Remember Mama;1948;Fresh;100;83;18;0;18;4
I Remember Me;2001;Fresh;83;80;10;2;12;6
I Remember You (Eg Man Big);2017;Fresh;86;54;6;1;7;4
I, Robot;2004;Rotten;56;70;127;98;225;49
I Saw the Light;2016;Rotten;18;36;28;127;155;40
I See You;2019;Certified-Fresh;78;75;31;9;40;7
I Served the King of England;2008;Certified-Fresh;80;81;70;18;88;36
I Smile Back;2015;Rotten;50;43;35;35;70;27
I Spit on Your Grave (Day of the Woman);1978;Rotten;51;40;18;17;35;1
I Spit on Your Grave 2;2013;Rotten;0;30;0;8;8;2
I Spit On Your Grave;2010;Rotten;32;47;20;43;63;16
I Spy;2002;Rotten;16;33;21;113;134;35
I Still Believe;2020;Rotten;51;98;23;22;45;10
I Still Know What You Did Last Summer;1998;Rotten;7;29;4;53;57;13
I Still See You;2018;Rotten;8;55;1;12;13;5
I Think I Love My Wife;2007;Rotten;19;41;22;93;115;40
I Think We're Alone Now;2018;;;;25;15;;10
I, Tonya;2018;Certified-Fresh;89;88;337;40;377;54
I Trapped The Devil;2019;Fresh;75;40;27;9;36;4
I Used To Be Darker;2013;Fresh;81;43;17;4;21;12
I Used to Go Here;1900;Certified-Fresh;85;51;60;11;71;12
I Vitelloni;1953;Fresh;100;90;25;0;25;11
I Walked With a Zombie;1943;Fresh;93;73;28;4;27;5
I Want to Live!;1958;Fresh;93;83;14;1;15;1
I Want Your Money;2010;Rotten;13;68;1;7;8;1
I Was a Male War Bride;1949;Fresh;76;72;13;4;17;3
I Was a Teenage Zombie;1987;Rotten;20;34;1;4;5;0
I Went Down;1998;Fresh;84;87;16;3;19;4
I Will Follow;2011;Fresh;82;66;9;2;11;8
I Will Follow You Into The Dark;2013;Rotten;20;21;2;8;10;6
I Will Make You Mine;1900;Fresh;100;100;19;0;19;7
I Wish;2012;Certified-Fresh;93;84;71;5;75;28
Ibiza;2018;Fresh;67;39;16;8;24;9
iBoy;2017;Fresh;69;39;9;4;13;3
Icarus;2017;Certified-Fresh;94;94;44;3;47;18
Ice Age;2002;Certified-Fresh;77;82;129;38;167;38
Ice Age 2: The Meltdown;2006;Rotten;56;71;82;64;146;34
Ice Age: Collision Course;2016;Rotten;18;39;21;97;118;31
Ice Age: Continental Drift;2012;Rotten;37;62;50;85;135;33
Ice Castles;1978;Rotten;44;69;4;5;9;1
Ice From the Sun;1999;Rotten;33;34;2;4;6;2
The Ice Harvest;2005;Rotten;47;43;63;71;134;33
Ice on Fire;2019;Fresh;90;75;9;1;10;3
The Ice Pirates;1984;Rotten;9;49;1;10;11;0
Ice Princess;2005;Rotten;52;58;56;52;108;32
Ice Station Zebra;1968;Rotten;47;58;7;8;15;2
The Ice Storm;1997;Certified-Fresh;85;82;58;10;68;16
Iceberg Slim: Portrait Of A Pimp;2013;Fresh;64;64;9;5;14;7
Ichi the Killer (Koroshiya 1);2001;Fresh;65;82;26;14;40;12
Ida;2014;Certified-Fresh;96;79;156;7;162;48
Identity;2003;Fresh;62;75;107;66;173;37
Identity Thief;2013;Rotten;19;53;34;143;175;46
Idiocracy;2006;Certified-Fresh;76;60;37;12;49;9
Idiots and Angels;2010;Fresh;93;76;14;1;15;8
Idiot's Delight;1939;Rotten;40;45;2;3;5;0
Idle Hands;1999;Rotten;15;58;8;47;55;18
Idlewild;2006;Rotten;47;66;61;70;131;41
If....;1968;Certified-Fresh;91;87;43;4;47;10
If a Tree Falls: A Story of the Earth Liberation Front;2011;Fresh;88;75;28;4;32;14
If I Stay;2014;Rotten;35;61;49;91;140;39
If I Want To Whistle, I Whistle;2011;Fresh;68;55;15;7;22;6
If I Were You;2012;Rotten;13;51;2;13;15;9
If Lucy Fell;1996;Rotten;18;52;5;23;28;11
If the Dancer Dances;2019;Fresh;93;93;14;1;15;4
If You Build It;2014;Fresh;78;88;21;6;27;10
If You Don't, I Will;2014;Fresh;72;36;13;5;18;9
Igby Goes Down;2002;Certified-Fresh;76;80;102;33;135;38
Ikiru;1956;Certified-Fresh;98;97;43;1;44;12
Il Divo;2009;Certified-Fresh;92;80;46;4;50;20
Il Futuro;2013;Fresh;80;50;12;3;15;6
I'll Always Know What You Did Last Summer;2006;Rotten;0;21;0;6;6;0
I'll Be There;2003;Rotten;50;56;3;3;6;2
I'll Do Anything;1994;Fresh;61;42;11;7;18;4
I'll Follow You Down;2014;Rotten;33;35;3;6;9;3
I'll See You in My Dreams;2015;Certified-Fresh;93;68;85;6;91;34
I'll See You In My Dreams;1900;Fresh;67;33;4;2;6;2
I'll Sleep When I'm Dead;2004;Rotten;44;35;40;50;90;31
I'll Take You There;1900;Rotten;43;36;3;4;7;0
I'll Take Your Dead;2019;Fresh;67;50;10;5;15;1
Illegal;2011;Fresh;70;60;7;3;10;3
Illegal Tender;2007;Rotten;15;67;7;41;48;20
Illtown;1997;Rotten;50;54;6;6;12;2
Illuminata;1999;Rotten;40;67;10;15;25;9
The Illusionist;2006;Certified-Fresh;74;83;143;51;194;49
The Illustrated Man;1969;Rotten;43;39;6;8;14;1
Ilo Ilo;2014;Certified-Fresh;100;78;45;0;45;17
Happily Ever After;2005;Rotten;57;71;24;18;42;20
Ilya and Emilia Kabakov: Enter Here;2013;Fresh;78;;7;2;9;4
I'm All Right Jack;1960;Fresh;88;77;7;1;8;0
I'm Dancing as Fast as I Can;1982;Rotten;33;50;2;4;6;1
I'm Gonna Git You Sucka;1988;Fresh;64;70;18;10;28;6
I'm In Love With A Church Girl;2013;Rotten;11;63;2;17;19;9
I'm Losing You;1999;Rotten;40;27;2;3;5;0
I'm Not Ashamed;2016;Rotten;20;82;2;8;10;2
I'm Not Rappaport;1996;Rotten;38;60;6;10;16;4
I'm Not There;2007;Certified-Fresh;77;69;125;37;162;52
I'm So Excited!;2013;Rotten;49;37;64;67;131;40
I'm Still Here;2010;Rotten;53;38;70;61;131;38
I'm Through with White Girls (The Inevitable Undoing of Jay Brooks);2007;Fresh;60;63;3;2;5;2
Images;1972;Fresh;71;71;10;4;14;7
Imaginary Crimes;1994;Fresh;60;63;6;4;10;4
Blush (Imaginary Order);1900;Fresh;73;;8;3;11;3
Imagine: John Lennon;1988;Fresh;92;91;12;1;13;1
Imagine Me & You;2006;Rotten;34;74;33;65;98;29
Imagining Argentina;2004;Rotten;31;71;4;9;13;6
Africa: The Serengeti;1994;Fresh;100;70;5;0;5;0
Cirque du Soleil: Journey of Man;2000;Rotten;45;70;5;6;11;1
Imitation Girl;2018;Fresh;89;44;8;1;9;0
The Immaculate Conception of Little Dizzle;1900;Fresh;89;71;8;1;9;5
Immediate Family;1989;Rotten;50;55;6;6;12;1
Immigration Tango;2011;Rotten;7;18;1;13;14;11
Immoral Tales;1900;Rotten;56;40;5;4;9;1
Immortal;1900;Fresh;88;97;7;1;8;0
Immortal Beloved;1994;Rotten;55;86;30;25;55;15
Immortality;2000;Rotten;47;53;9;10;19;5
Immortals;2011;Rotten;46;48;60;71;131;27
Imperial Dreams;1900;Fresh;92;83;11;1;12;3
Imperium;2016;Certified-Fresh;85;64;61;11;72;24
The Importance of Being Earnest;2002;Rotten;57;72;66;50;116;39
Impossible Monsters;2020;Rotten;50;93;3;3;6;2
Impostor;2002;Rotten;24;41;23;73;96;29
Impractical Jokers: The Movie;2020;Rotten;35;76;9;17;26;5
Imprisoned;2019;Rotten;0;;0;8;8;3
Impromptu;1991;Fresh;76;72;13;4;17;7
In the Name of the King: A Dungeon Siege Tale;2006;Rotten;4;23;2;50;52;10
In A Better World;2011;Certified-Fresh;78;86;95;27;122;39
In a Lonely Place;1950;Certified-Fresh;98;90;46;1;47;8
In a Relationship;2018;Fresh;60;45;9;6;15;5
In a Valley of Violence;2016;Certified-Fresh;77;51;53;16;69;15
In a World...;2013;Certified-Fresh;92;71;119;10;129;39
In America;2003;Certified-Fresh;89;91;158;19;177;45
In & Out;1997;Fresh;71;52;36;15;51;13
In Another Country;2013;Fresh;82;48;23;5;28;13
In Between Days;2007;Fresh;86;55;25;4;29;13
In Bruges;2008;Certified-Fresh;84;87;166;32;198;50
In Country;1989;Fresh;68;37;19;9;28;11
In Darkness;2012;Certified-Fresh;88;80;98;13;111;35
In Darkness;2018;Rotten;47;35;15;17;32;9
In Dreams;1999;Rotten;24;40;12;38;50;12
In Dubious Battle;2017;Rotten;30;38;7;16;23;10
In Fabric;2019;Certified-Fresh;92;47;141;13;154;25
In Fear;2014;Certified-Fresh;81;41;47;11;58;16
In God's Hands;1998;Rotten;0;79;0;6;6;0
In Good Company;2004;Certified-Fresh;83;54;142;30;172;42
In Harm's Way;1965;Rotten;38;81;5;8;13;2
In Her Shoes;2005;Certified-Fresh;75;66;123;41;164;45
In Like Flint;1967;Fresh;67;51;12;6;18;1
In My Country;2005;Rotten;23;57;19;63;82;28
In My Father's House;2015;Fresh;92;41;12;1;13;7
In My Sleep;2010;Rotten;13;33;2;14;16;7
In Old Arizona;1928;Rotten;56;38;5;4;9;2
In Old Chicago;1937;Fresh;67;52;8;4;12;4
In Our Nature;2012;Rotten;47;36;9;10;19;9
In Search of Beethoven;2009;Certified-Fresh;93;79;38;3;41;20
In Search of Blind Joe Death: The Saga of John Fahey;2013;Fresh;100;;6;0;6;3
In Search Of Chopin;1900;Fresh;80;67;4;1;5;3
In Search of Greatness;2018;Fresh;92;83;24;2;26;8
In Search of Haydn;2012;Fresh;75;;9;3;12;6
In Search of Memory (Auf der Suche nach dem Gedachtnis);2009;Fresh;89;71;8;1;9;4
In Search of Mozart;2007;Fresh;81;65;26;6;32;12
In Secret;2014;Rotten;41;34;36;52;88;32
In the Aisles (In den Gangen);2019;Fresh;90;69;35;4;39;11
In the Army Now;1994;Rotten;6;44;2;30;32;10
In the Bedroom;2001;Certified-Fresh;93;81;129;9;138;32
In the Blood;2014;Rotten;37;38;15;26;41;15
In the Company of Men;1997;Certified-Fresh;89;80;48;6;54;15
In The Courtyard;2015;Fresh;71;47;5;2;7;2
In the Cut;2003;Rotten;32;34;56;117;173;51
In the Electric Mist;2009;Rotten;58;34;7;5;12;1
In the Fade (Aus dem Nichts);2017;Certified-Fresh;77;71;114;35;149;33
In the Family;2012;Fresh;97;75;28;1;29;11
In the Good Old Summertime;1949;Fresh;64;80;7;4;11;3
In the Heart of the Sea;2015;Rotten;43;53;101;136;237;52
In the Heat of the Night;1967;Certified-Fresh;95;92;52;3;55;11
In the Intense Now (No Intenso Agora);2018;Fresh;83;40;15;3;18;5
In the Land of Blood and Honey;2011;Rotten;57;47;47;35;82;39
In the Land of Women;2007;Rotten;44;52;51;66;117;39
In the Line of Fire;1993;Certified-Fresh;96;79;65;3;68;20
In the Loop;2009;Certified-Fresh;94;82;166;11;177;49
In the Mirror of Maya Deren;2003;Fresh;95;88;19;1;20;7
In the Mix;2005;Rotten;13;50;5;34;39;14
In the Mouth of Madness;1995;Rotten;59;73;27;19;46;11
In the Name of My Daughter;2015;Rotten;52;43;25;23;48;21
In the Name of the Father;1993;Certified-Fresh;94;95;47;3;50;17
In the Pit;2007;Fresh;73;69;16;6;22;12
In the Realm of the Senses;1976;Fresh;86;65;31;5;36;7
In the Shadow of the Moon;2007;Certified-Fresh;95;91;107;6;113;48
In the Shadow of the Moon;1900;Rotten;58;36;30;22;52;8
In the Tall Grass;1900;Rotten;36;33;26;46;72;10
In the Valley of Elah;2007;Fresh;74;77;120;43;163;45
In Their Skin;2012;Rotten;45;16;5;6;11;3
In Time;2011;Rotten;37;51;63;109;172;50
In un altro paese;2005;Fresh;77;89;17;5;22;13
In Which We Serve;1942;Fresh;89;76;16;2;18;4
In Your Eyes;1900;Fresh;61;68;11;7;18;4
InAPPropriate Comedy;2013;Rotten;0;23;0;5;5;2
Inbred;2011;Rotten;25;29;3;9;12;4
Incarnate;2016;Rotten;17;23;6;29;35;6
Incendiary;2009;Rotten;20;34;5;20;25;9
Incendies;2011;Certified-Fresh;93;92;112;9;121;40
Inception;2010;Certified-Fresh;87;91;310;47;357;65
Inch'Allah;2013;Rotten;53;62;9;8;17;8
Incident at Oglala;1992;Fresh;100;84;21;0;21;8
Incident at Loch Ness;2004;Fresh;63;66;30;18;48;17
Incident In a Ghost Land (Ghostland);2018;Rotten;56;56;15;12;27;4
Incognito;1998;Rotten;33;61;3;6;9;0
Inconceivable;2017;Rotten;31;62;4;9;13;2
An Inconvenient Truth;2006;Certified-Fresh;93;79;154;12;166;42
The Incredible Hulk Returns;1988;Rotten;50;40;3;3;6;1
The Incredible Journey;1963;Fresh;89;76;8;1;9;0
The Incredible Shrinking Man;1957;Fresh;92;82;24;2;26;4
The Incredibles;2004;Certified-Fresh;97;75;241;7;248;48
Incredibles 2;2018;Certified-Fresh;93;84;353;26;379;55
Indecent Proposal;1993;Rotten;35;47;16;30;46;5
Independence Day: Resurgence;2016;Rotten;30;30;67;159;226;37
India - Kingdom of the Tiger;2002;Fresh;80;64;4;1;5;1
The Indian in the Cupboard;1995;Fresh;73;40;16;6;22;3
Indiana Jones and the Kingdom of the Crystal Skull;2008;Certified-Fresh;78;54;215;59;274;53
Indiana Jones and the Last Crusade;1989;Certified-Fresh;88;94;63;9;72;15
Indiana Jones and the Temple of Doom;1984;Certified-Fresh;84;81;58;11;69;10
Indie Game: The Movie;2012;Fresh;94;91;29;2;31;10
Indignation;2016;Certified-Fresh;81;74;109;25;134;39
Indigo Children;2014;Rotten;20;65;1;4;5;3
Indiscretion of an American Wife (Stazione Termini);1953;Rotten;38;39;5;8;13;2
Indivisible;2018;Fresh;74;86;14;5;19;5
Indochine;1992;Fresh;72;84;13;5;18;2
Inequality For All;2013;Certified-Fresh;90;88;56;6;62;31
Inescapable;2013;Rotten;17;26;4;19;23;11
Infamous;2006;Fresh;74;69;114;41;155;47
Infamous;2020;Rotten;21;51;6;23;29;7
Clandestine Childhood;2013;Rotten;40;69;4;6;10;8
Infernal Affairs (Mou gaan dou);2002;Certified-Fresh;94;95;59;4;63;23
Infernal Affairs II;2003;Fresh;75;83;6;2;8;3
Inferno;1980;Fresh;64;59;9;5;14;1
Inferno;2016;Rotten;23;36;58;192;250;50
Infini;2015;Rotten;31;34;5;11;16;6
Infinitely Polar Bear;2015;Certified-Fresh;82;71;98;22;120;39
Informant;2013;Fresh;89;62;17;2;19;12
Infra-Man (Zhong guo chao ren);2001;Fresh;100;75;6;0;6;1
Inglourious Basterds;2009;Certified-Fresh;89;88;292;37;329;65
Ingrid Goes West;2017;Certified-Fresh;86;71;165;27;192;41
Inhale;2010;Rotten;38;46;9;15;24;11
Inherent Vice;2015;Fresh;74;52;183;65;248;55
Inherit the Viper;2020;Rotten;45;50;9;11;20;7
Initial D;2005;Rotten;33;72;2;4;6;4
Inkheart;2009;Rotten;39;45;56;88;144;41
The Inkwell;1994;Rotten;25;83;2;6;8;3
The In-Laws;2003;Rotten;33;40;45;91;136;38
Inmate #1: The Rise of Danny Trejo;1900;Fresh;100;100;32;0;32;6
The Inn of the Sixth Happiness;1958;Fresh;100;84;5;0;5;0
Inner Demons;2014;Fresh;64;33;7;4;11;5
Innerspace;1987;Certified-Fresh;82;65;36;8;44;9
Innocence;2014;Rotten;19;33;5;21;26;11
Innocent Blood;1992;Rotten;39;44;9;14;23;6
An Innocent Man;1989;Rotten;38;47;3;5;8;1
Inserts;1975;Fresh;64;56;7;4;11;2
Insiang;1976;Fresh;100;96;9;0;9;2
Inside (A l'interieur);2007;Fresh;85;75;11;2;13;2
Inside;2018;Rotten;32;22;6;13;19;4
Inside Daisy Clover;1966;Rotten;33;52;5;10;15;6
Inside Deep Throat;2005;Certified-Fresh;82;67;100;22;122;43
Inside Game;2019;Rotten;38;73;3;5;8;1
Inside Job;2010;Certified-Fresh;98;91;144;3;147;37
Inside Lehman Brothers;1900;Fresh;86;;6;1;7;2
Inside Llewyn Davis;2013;Certified-Fresh;92;74;260;23;282;57
Inside Man;2006;Certified-Fresh;86;85;179;28;207;49
Inside Out;2015;Certified-Fresh;98;89;364;7;370;61
Inside Out;2011;Rotten;25;22;3;9;12;7
Inside the Rain;2020;Fresh;86;71;18;3;21;4
The Insider;1999;Certified-Fresh;96;90;132;5;137;34
Insidious;2011;Fresh;66;62;116;60;176;37
Insidious: Chapter 2;2013;Rotten;39;57;50;78;128;32
Insidious: Chapter 3;2015;Rotten;57;51;74;55;129;30
Insidious: The Last Key;2018;Rotten;33;51;37;74;111;21
Insomnia;1998;Fresh;97;77;37;1;38;7
Inspector Gadget;1999;Rotten;21;18;13;50;63;21
Inspector Gadget 2;2003;Rotten;40;21;2;3;5;0
The Inspector General;1949;Fresh;90;80;9;1;10;2
Instant Family;2018;Certified-Fresh;80;82;122;30;152;27
Mesrine: Killer Instinct (Mesrine: L'instinct de mort);2010;Certified-Fresh;82;84;58;13;71;25
Insurgent;2015;Rotten;28;58;58;147;205;50
Intacto;2002;Fresh;72;82;52;20;72;23
Intensive Care;1900;Fresh;80;14;4;1;5;0
Interiors;1978;Fresh;79;79;11;3;14;1
Intermission;2003;Fresh;73;75;70;26;96;29
Intern;2000;Rotten;38;28;3;5;8;4
Internal Affairs;;Fresh;88;59;23;3;26;8
The International;2009;Rotten;58;37;122;89;211;56
International Falls;2020;Fresh;100;77;11;0;11;1
The Interpreter;2005;Rotten;57;54;111;84;195;47
Intersection;1994;Rotten;9;40;3;29;32;12
Interstellar;2014;Certified-Fresh;72;86;263;101;364;62
Interview with the Assassin;2002;Fresh;66;56;38;20;58;19
Interview with the Vampire;1994;Fresh;63;86;34;20;54;12
Intimate Enemies;2007;Rotten;57;65;8;6;14;8
Historias minimas (Intimate Stories);2005;Fresh;88;85;23;3;26;13
Intimate Strangers;2003;Certified-Fresh;86;69;89;15;104;37
Into Great Silence;2007;Certified-Fresh;88;80;58;8;66;22
Into Temptation;2009;Fresh;80;71;4;1;5;2
Into The Abyss;2011;Certified-Fresh;92;76;106;9;115;33
Into The Arms Of Strangers: Stories Of The Kindertransport;2000;Fresh;91;87;32;3;35;12
Into the Ashes;2019;Rotten;26;31;5;14;19;5
Into the Blue;2005;Rotten;21;57;26;99;125;35
Into the Blue 2: The Reef;2009;Rotten;17;18;1;5;6;1
Into The Forest;2016;Certified-Fresh;76;43;39;12;51;15
Into the Inferno;2016;Certified-Fresh;92;73;45;4;49;12
Into the Night;1985;Rotten;38;49;9;15;24;6
Into The Storm;2014;Rotten;21;42;33;124;157;38
Into the White;2013;Rotten;45;67;5;6;11;4
Into the Wild;2007;Certified-Fresh;83;89;164;34;198;56
Into the Woods;2014;Fresh;71;49;158;64;221;50
Intolerable Cruelty;2003;Certified-Fresh;75;48;140;46;186;45
Intrigo: Dear Agnes;2020;Rotten;40;;2;3;5;2
Intrigo: Death of an Author;2020;Rotten;10;50;1;9;10;4
Introducing the Dwights;2007;Rotten;52;50;45;42;87;35
The Intruder;1900;Rotten;57;22;4;3;7;2
Intruder;2016;Rotten;23;25;3;10;13;3
Intruders;2012;Rotten;32;23;23;50;73;20
Intruders;2016;Rotten;48;31;11;12;23;7
Invader Zim: Enter the Florpus;1900;Fresh;100;92;21;0;21;2
The Invasion;2007;Rotten;19;40;31;133;164;39
Invasion of the Bee Girls;1973;Rotten;50;33;4;4;8;1
Invasion Planet Earth;1900;Rotten;0;43;0;6;6;2
Inventing the Abbotts;1997;Rotten;31;52;8;18;26;8
The Invention of Lying;2009;Rotten;56;39;105;83;188;48
Investigation of a Citizen Above Suspicion;1970;Fresh;100;95;13;0;13;5
Invictus;2009;Certified-Fresh;77;75;187;57;244;56
Invincible;2006;Fresh;72;73;98;38;136;35
The Invisible Circus;2001;Rotten;22;44;14;49;63;21
Invisible Essence: The Little Prince;1900;Fresh;100;;5;0;5;1
Io;1900;Rotten;31;;8;18;26;5
Io sono Li (Shun Li and the Poet);2013;Fresh;95;79;18;1;19;7
Ip Man;2010;Fresh;85;93;23;4;27;9
Ip Man 2: Legend of the Grandmaster;2011;Fresh;96;84;27;1;28;6
Ip Man 3;2016;Certified-Fresh;76;72;39;12;51;17
Ip Man 4: The Finale;2019;Fresh;87;95;27;4;31;10
Ip Man: The Final Fight;2013;Fresh;67;55;12;6;18;9
I.Q.;1994;Rotten;44;47;11;14;25;5
Ira and Abby;2006;Fresh;68;62;30;14;44;16
Iraq for Sale: The War Profiteers;2006;Fresh;100;85;19;0;19;8
Iraq in Fragments;2006;Certified-Fresh;91;79;59;6;65;30
Irene in Time;2009;Rotten;29;48;5;12;17;9
Iris;2015;Certified-Fresh;98;80;97;2;99;28
Irma La Douce;1963;Fresh;75;79;15;5;20;4
Iron Eagle;1986;Rotten;20;56;1;4;5;1
Iron Fists and Kung Fu Kicks;1900;Fresh;86;67;6;1;7;1
The Iron Giant;1999;Certified-Fresh;96;90;137;6;143;41
Iron Island;2006;Fresh;97;85;30;1;31;14
Iron Man;2008;Certified-Fresh;94;91;261;18;279;58
Iron Man 2;2010;Certified-Fresh;72;71;217;83;300;55
Iron Man 3;2013;Certified-Fresh;79;78;257;67;324;57
The Iron Mask;1929;Fresh;100;77;5;0;5;1
Iron Sky;2012;Rotten;40;37;17;26;43;6
Iron Sky: The Coming Race;2019;Rotten;29;31;2;5;7;1
Ironclad;2011;Rotten;42;41;23;32;55;22
Ironclad: Battle for Blood;2014;Rotten;17;9;2;10;12;3
Ironweed;1987;Rotten;58;59;14;10;24;9
Irrational Man;2015;Rotten;47;46;94;107;201;46
Irreplaceable You;2018;Rotten;32;59;6;13;19;6
Irresistible;1900;Rotten;20;32;2;8;10;3
Irresistible;2020;Rotten;40;66;86;130;216;38
Irreversible;2002;Rotten;57;80;70;52;122;34
Is Paris Burning? (Paris brule-t-il?);1966;Fresh;71;72;5;2;7;0
Is That a Gun in Your Pocket?;2016;Rotten;0;92;0;11;11;6
Is the Man Who Is Tall Happy?: An Animated Conversation with Noam Chomsky;2013;Fresh;92;68;35;3;38;15
Is Anybody There?;2009;Fresh;65;55;76;41;117;39
Isabelle;2019;Rotten;8;27;1;12;13;4
Ishtar;1987;Rotten;37;39;20;34;54;12
Island Of Lemurs: Madagascar;2014;Fresh;81;65;29;7;36;12
Isle of Dogs;2018;Certified-Fresh;90;87;321;37;358;50
Isle of the Dead;1945;Fresh;88;51;14;2;16;2
Ismael's Ghosts (Les fantomes d'Ismael);2018;Rotten;50;23;39;39;78;26
Isn't It Romantic;2019;Fresh;70;47;123;52;175;32
Isn't She Great;2000;Rotten;25;38;15;46;61;24
Isolation;2006;Fresh;64;35;7;4;11;1
It Came from Outer Space;1953;Fresh;79;54;22;6;28;4
I.T.;2016;Rotten;9;25;4;39;43;10
It;2017;Certified-Fresh;85;84;323;55;377;53
It Came from Beneath the Sea;1955;Rotten;56;39;5;4;9;0
It Came from Kuchar;2010;Fresh;89;76;16;2;18;8
It Came from the Desert;1900;Fresh;60;29;3;2;5;0
It Chapter Two;2019;Fresh;63;78;233;134;367;45
It Comes At Night;2017;Certified-Fresh;87;44;219;32;250;49
It Felt Like Love;2014;Fresh;84;43;21;4;25;15
It Follows;2015;Certified-Fresh;95;66;247;12;259;50
It Had to Be You;2016;Fresh;60;41;3;2;5;4
It Happened at the World's Fair;1963;Rotten;17;59;1;5;6;0
It Happened in Brooklyn;1947;Fresh;83;44;5;1;6;1
It Happened in L.A.;2017;Fresh;69;69;11;5;16;7
It Happened One Night;1934;Certified-Fresh;98;93;59;1;60;15
It Lives Again;1900;Rotten;50;28;8;8;16;3
It Might Get Loud;2009;Certified-Fresh;79;85;91;24;115;38
It Runs in the Family;2003;Rotten;29;28;29;70;99;32
It Should Happen to You;1954;Fresh;100;76;12;0;12;2
It Stains the Sands Red;2017;Fresh;67;38;10;5;15;3
It Started As a Joke;1900;Fresh;100;83;10;0;10;1
It Started in Naples;1960;Rotten;0;56;0;6;6;0
It! The Terror From Beyond Space;1958;Fresh;69;45;11;5;16;0
The Italian;2007;Certified-Fresh;91;70;85;8;93;34
Italian for Beginners;2001;Certified-Fresh;88;79;76;10;86;30
The Italian Job;2003;Fresh;73;80;133;50;183;46
Ithaca;2016;Rotten;22;31;4;14;18;8
It's Kind of a Funny Story;2010;Rotten;57;66;77;58;135;36
It's Pat;1994;Rotten;0;28;0;11;11;2
It's a Disaster;2013;Certified-Fresh;79;60;39;10;48;17
It's a Mad, Mad, Mad, Mad World;1963;Fresh;70;83;26;11;37;4
It's a Very Merry Muppet Christmas Movie;2002;Fresh;82;51;9;2;11;0
It's a Wonderful Life;1946;Certified-Fresh;94;95;77;5;82;16
It's Alive III: Island of the Alive;1900;Rotten;50;17;5;5;10;0
It's All Gone Pete Tong;2004;Certified-Fresh;76;88;54;17;71;23
It's All True;1993;Fresh;83;68;19;4;23;7
It's Always Fair Weather;1955;Fresh;88;75;7;1;8;0
It's Better to Jump;2013;Fresh;75;70;6;2;8;5
It's Not Yet Dark;2017;Fresh;95;62;19;1;20;9
It's the Great Pumpkin, Charlie Brown;1966;Fresh;94;85;16;1;17;0
It's the Rage;2000;Rotten;27;44;3;8;11;1
Itsy Bitsy;2019;Fresh;60;28;6;4;10;2
Itzhak;2018;Certified-Fresh;90;84;36;4;40;14
Ivan the Terrible, Part I (Ivan Grozniy);1944;Fresh;100;91;17;0;17;2
Ivan's Childhood (Ivanovo detstvo);1962;Fresh;100;93;24;0;24;6
I've Got Issues;1900;Rotten;57;;4;3;7;1
I've Loved You So Long;2008;Certified-Fresh;88;85;112;15;127;46
Ivory Tower;2014;Certified-Fresh;83;78;43;9;52;17
Ixcanul;2016;Fresh;97;75;36;1;37;13
J. Edgar;1900;Rotten;43;44;106;139;245;53
Ja zuster, nee zuster (Yes Nurse! No Nurse!);2004;Rotten;47;75;8;9;17;9
Jab Tak Hai Jaan;2012;Fresh;89;67;16;2;18;5
Jabberwocky;1977;Rotten;50;47;9;9;18;0
Jack and Diane;2012;Rotten;12;20;3;23;26;12
Jack and Jill;2011;Rotten;3;36;3;113;116;31
Jack and Jill vs. the World;2008;Rotten;25;30;2;6;8;2
Jack Brooks: Monster Slayer;2007;Fresh;61;51;20;13;33;7
The Jack Bull;1999;Fresh;80;73;4;1;5;0
Jack Goes Boating;2010;Fresh;68;48;74;35;109;29
Jack Goes Home;2016;Rotten;25;31;3;9;12;3
Jack Ketchum's The Girl Next Door;2007;Fresh;67;61;10;5;15;3
Jack of the Red Hearts;2015;Rotten;54;62;7;6;13;4
Jack Reacher;2012;Fresh;64;67;115;66;181;48
Jack Reacher: Never Go Back;1900;Rotten;37;42;89;149;238;44
Jack Ryan: Shadow Recruit;2014;Rotten;54;53;100;85;185;43
Jack the Giant Killer;1962;Fresh;75;61;6;2;8;2
Jack the Giant Slayer;2013;Rotten;52;55;108;99;207;41
The Jackal;1997;Rotten;23;52;7;23;30;7
Jackals;2017;Rotten;44;21;7;9;16;4
Jackass 3;2010;Fresh;65;69;73;39;112;31
Jackass 3.5;1900;Fresh;60;57;3;2;5;0
Jackass: Number Two;2006;Fresh;63;80;65;38;103;30
Jackass Presents: Bad Grandpa;2013;Fresh;61;60;68;44;112;30
Jackass - The Movie;2002;Rotten;48;75;47;50;97;23
Jackboots on Whitehall;2010;Rotten;44;26;8;10;18;2
The Jacket;2005;Rotten;44;73;72;91;163;36
Jackie;2016;Certified-Fresh;87;60;304;44;348;58
Jackie & Ryan;2015;Fresh;64;40;14;8;22;10
Jackie Brown;1997;Certified-Fresh;87;85;73;11;84;20
Jackie Chan: The Myth;2005;Rotten;20;55;1;4;5;1
Jackie Chan's First Strike;1996;Rotten;57;56;13;10;23;6
The Jackie Robinson Story;1950;Fresh;63;52;5;3;8;2
Jacknife;1989;Fresh;64;47;9;5;14;1
Jacob's Ladder;;Fresh;73;84;48;18;66;16
Jacob's Ladder;2019;Rotten;4;39;1;22;23;7
Jade;1995;Rotten;14;27;4;25;29;8
Jafar Panahi's Taxi;2015;Certified-Fresh;96;79;102;4;105;28
Jaffa;2009;Rotten;50;61;3;3;6;2
Jagged Edge;1985;Fresh;81;58;25;6;31;7
Jail Bait;1954;Rotten;29;20;2;5;7;1
Jailbait;2004;Rotten;17;51;3;15;18;7
Jailhouse Rock;1957;Fresh;80;72;12;3;15;0
Jake Speed;1986;Rotten;20;45;1;4;5;0
Jake Squared;2014;Rotten;22;37;2;7;9;6
Jakob the Liar;1999;Rotten;29;63;21;51;72;23
Jalsaghar (The Music Room);1958;Fresh;100;92;23;0;23;6
James and the Giant Peach;1996;Certified-Fresh;91;66;67;7;74;22
James VS His Future Self;1900;Fresh;100;54;16;0;16;2
James White;2015;Certified-Fresh;92;70;69;6;75;27
Jamesy Boy;2014;Rotten;26;58;5;14;19;5
Jamie Marks Is Dead;2014;Rotten;59;45;10;7;17;7
Jandek on Corwood;2004;Fresh;89;73;8;1;9;6
Jane Austen's Emma;1996;Fresh;88;73;7;1;8;5
Jane Eyre;2011;Certified-Fresh;84;76;141;26;167;47
Jane Got a Gun;2016;Rotten;43;37;34;46;80;18
Jane Wants a Boyfriend;2016;Rotten;38;64;3;5;8;5
Jane White is Sick and Twisted;2002;Fresh;71;38;5;2;7;0
Jane's Journey;2011;Rotten;42;79;5;7;12;6
Janie Jones;2011;Rotten;56;52;18;14;32;16
Janis: Little Girl Blue;2015;Certified-Fresh;94;77;74;5;79;28
Jannat 2;2012;Rotten;0;45;0;6;6;1
The January Man;1989;Rotten;25;28;4;12;16;1
Japanese Story;2003;Fresh;68;69;63;29;92;36
Japon;2003;Fresh;81;73;22;5;27;10
Jason Becker: Not Dead Yet;1900;Fresh;83;88;20;4;24;13
Jason Bourne;2016;Rotten;54;55;174;148;322;57
Jason Goes to Hell - The Final Friday;1993;Rotten;22;24;4;14;18;2
Jason X;2002;Rotten;20;25;21;86;107;23
Jason's Lyric;1994;Fresh;61;91;14;9;23;9
Jauja;2015;Certified-Fresh;88;50;60;8;68;22
Java Heat;1900;Rotten;7;28;1;13;14;8
Jawbreaker;1999;Rotten;11;55;7;55;62;18
Jaws;1975;Certified-Fresh;98;90;86;2;88;21
Jaws 2;1978;Rotten;58;38;18;13;31;5
Jaws 3;1983;Rotten;12;17;4;29;33;4
Jaws: The Revenge;1987;Rotten;0;15;0;38;38;13
Jay & Silent Bob Reboot;2019;Fresh;66;93;25;13;38;4
Jay and Silent Bob Strike Back;2001;Rotten;52;75;80;73;153;35
Jayne Mansfield's Car;2013;Rotten;35;40;13;24;37;15
Jazz on a Summer's Day;2020;Fresh;100;81;29;0;29;7
JCVD (Van Dammage);2008;Certified-Fresh;84;74;91;17;108;39
J.D.'s Revenge;1976;Rotten;57;60;4;3;7;2
Jean-Michel Basquiat: The Radiant Child;2010;Fresh;86;87;31;5;36;11
Jeanne Dielman, 23 Quai du Commerce, 1080 Bruxelles;1975;Fresh;96;82;25;1;26;6
Jeepers Creepers;2001;Rotten;46;48;53;61;114;28
Jeepers Creepers 2;2003;Rotten;24;37;31;96;127;29
Jeepers Creepers 3;2017;Rotten;17;32;1;5;6;0
Jeff Who Lives at Home;2012;Certified-Fresh;77;62;109;33;142;35
Jefferson in Paris;1995;Rotten;31;34;5;11;16;5
Jeffrey;1995;Fresh;68;68;19;9;28;9
I am Yours;1900;Fresh;100;52;9;0;9;4
Jellyfish Eyes;2015;Rotten;29;43;4;10;14;5
Jem and the Holograms;2015;Rotten;22;40;17;62;79;22
Jen Kirkman: I'm Gonna Die Alone (And I Feel Fine);1900;Fresh;100;;8;0;8;2
Jennifer 8;1992;Rotten;37;36;7;12;19;3
Jennifer's Body;2009;Rotten;45;34;91;111;202;45
Jenny Slate: Stage Fright;1900;Fresh;100;48;14;0;14;5
Jenny's Wedding;2015;Rotten;25;34;4;12;16;9
Jeremiah Johnson;1972;Fresh;95;89;19;1;20;4
Jerichow;2008;Fresh;89;58;32;4;36;13
The Jerk;1979;Fresh;81;84;30;7;37;7
The Jerky Boys;1995;Rotten;17;50;2;10;12;1
Jerry and Tom;1998;Fresh;75;71;6;2;8;1
Jerry Before Seinfeld;1900;Fresh;95;75;18;1;19;10
Jerry Seinfeld: 23 Hours to Kill;1900;Fresh;75;51;12;4;16;8
Jersey Boys;2014;Rotten;51;62;113;107;220;57
Jersey Girl;2004;Rotten;42;48;75;102;177;41
Jersey Shore Massacre;2014;Rotten;17;8;2;10;12;6
Jerusalem;2013;Fresh;89;81;8;1;9;5
Gangster's Paradise: Jerusalema;2010;Fresh;76;78;16;5;21;9
Jess + Moss;2012;Fresh;80;68;4;1;5;2
Jessabelle;2014;Rotten;28;30;10;26;36;13
Jesus;2017;Fresh;79;60;11;3;14;5
Jesus Camp;2006;Certified-Fresh;87;80;91;14;105;30
Jesus Christ Vampire Hunter;2001;Fresh;80;59;8;2;10;0
Jesus Henry Christ;2012;Rotten;23;47;5;17;22;12
Jesus Shows You the Way to the Highway;1900;Fresh;92;83;12;1;13;1
Jesus' Son;1999;Certified-Fresh;80;83;41;10;51;11
Jesus, You Know;2003;Fresh;75;67;6;2;8;4
Jet Lag;2003;Rotten;57;54;39;30;69;28
The Jewel of the Nile;1985;Rotten;48;37;12;13;25;3
Jews And Baseball: An American Love Story;2010;Fresh;67;63;8;4;12;6
Jewtopia;2013;Rotten;18;26;2;9;11;4
Jexi;2019;Rotten;17;71;5;25;30;11
Jhoom Barabar Jhoom;2007;Rotten;46;39;6;7;13;4
Jianyu (Reign of Assassins);2010;Fresh;70;73;7;3;10;1
Stray Dogs;2014;Fresh;86;53;31;5;36;13
Jig;2011;Fresh;63;71;26;15;41;18
Jigsaw;1900;Rotten;33;89;29;60;89;14
Jim & Andy: The Great Beyond - Featuring a Very Special, Contractually Obligated Mention of Tony Clifton;2017;Certified-Fresh;94;88;45;3;48;16
Jim Gaffigan: Cinco;1900;Fresh;83;;5;1;6;2
Jim Gaffigan: Noble Ape;2018;Fresh;100;89;8;0;8;5
Jim Gaffigan: Obsessed;1900;Fresh;100;;5;0;5;3
Jim Gaffigan: Quality Time;1900;Fresh;100;;6;0;6;2
Jim: The James Foley Story;2016;Fresh;91;74;20;2;22;14
Jimi: All Is by My Side;2014;Fresh;67;36;56;27;83;33
Jimmy and Judy;2006;Rotten;50;68;4;4;8;3
Jimmy Hollywood;1994;Rotten;22;27;5;18;23;5
Jimmy Neutron - Boy Genius;1900;Certified-Fresh;74;53;56;20;76;20
Jimmy P.;2014;Rotten;52;39;17;16;33;14
Jin-Roh: The Wolf Brigade;1998;Rotten;55;78;12;10;22;7
Jindabyne;2006;Fresh;65;49;65;35;100;35
Police Story: Lockdown;2015;Rotten;14;33;1;6;7;3
Jingle All the Way;1996;Rotten;15;38;7;39;46;9
Jingle Bell Rocks;2014;Fresh;100;76;7;0;7;2
Jinn;2014;Rotten;18;31;2;9;11;6
Jinn;2018;Fresh;91;84;20;2;22;6
Jiro Dreams of Sushi;2012;Certified-Fresh;99;92;93;1;94;33
Jo Jo Dancer, Your Life Is Calling;1986;Rotten;55;80;6;5;11;1
Joan Rivers: A Piece Of Work;2010;Certified-Fresh;92;82;100;9;109;37
Joan Didion: The Center Will Not Hold;2017;Fresh;89;80;31;4;35;14
Desert Flower;2011;Rotten;50;72;9;9;18;8
Jobriath A.D.;2014;Fresh;67;58;10;5;15;8
Jobs;2013;Rotten;28;40;37;97;134;38
Jodhaa Akbar;2008;Fresh;75;78;12;4;16;6
Jodorowsky's Dune;2014;Certified-Fresh;97;89;116;3;119;36
Joe;1970;Fresh;82;64;9;2;11;1
Joe;2014;Certified-Fresh;85;68;113;20;133;44
Joe Dirt;2001;Rotten;10;63;8;69;77;25
Joe Dirt 2: Beautiful Loser;2015;Rotten;10;21;1;9;10;2
Joe Kidd;1972;Fresh;88;54;7;1;8;1
Joe Somebody;2001;Rotten;21;27;18;68;86;24
Joe Strummer: The Future Is Unwritten;2007;Certified-Fresh;89;87;56;7;63;27
Joe the King;1999;Fresh;67;72;18;9;27;5
Joe Versus the Volcano;;Fresh;61;54;19;12;31;4
Joe's Apartment;1996;Rotten;19;42;5;22;27;9
Joffrey: Mavericks of American Dance;2012;Rotten;55;50;6;5;11;6
John Carpenter's Ghosts of Mars;2001;Rotten;21;24;23;84;107;25
John Carpenter's Vampires;1998;Rotten;40;47;20;30;50;8
John Carter;2012;Rotten;52;60;123;113;236;49
John Dies at the End;2013;Fresh;60;54;53;36;89;27
John Doe: Vigilante;2014;Rotten;40;46;2;3;5;3
John Henry;2020;Rotten;0;23;0;20;20;5
John Leguizamo's Latin History for Morons;1900;Fresh;100;77;7;0;7;1
John Lewis: Good Trouble;2020;Certified-Fresh;96;73;64;3;67;17
It's About You;2012;Rotten;57;40;8;6;14;9
John Mulaney & The Sack Lunch Bunch;2019;Certified-Fresh;96;77;25;1;26;12
John Mulaney: Kid Gorgeous at Radio City;2018;Certified-Fresh;100;89;20;0;20;12
John Mulaney: The Comeback Kid;2015;Fresh;100;96;8;0;8;2
John Q;2002;Rotten;23;78;30;101;131;36
Rambo (Rambo IV);2008;Rotten;38;69;57;95;152;36
John Tucker Must Die;2006;Rotten;27;69;26;69;95;32
This Filthy World;2006;Fresh;91;85;21;2;23;10
John Wick;2014;Certified-Fresh;87;81;186;29;215;44
John Wick: Chapter 2;2017;Certified-Fresh;89;85;244;30;274;46
John Wick: Chapter 3 - Parabellum;2019;Certified-Fresh;90;86;307;36;343;44
Johnny Got His Gun;2008;Rotten;21;62;3;11;14;9
Johnny Be Good;1988;Rotten;0;30;0;15;15;5
Johnny English;2003;Rotten;33;50;40;81;121;35
Johnny English Reborn;2011;Rotten;38;45;35;57;92;28
Johnny English Strikes Again;1900;Rotten;37;49;40;69;109;24
Johnny Frank Garrett's Last Word;1900;Rotten;50;38;3;3;6;0
Johnny Got His Gun;1971;Fresh;67;87;14;7;21;5
Johnny Guitar;1954;Certified-Fresh;93;85;42;3;45;12
Johnny Handsome;1989;Fresh;62;46;8;5;13;1
Johnny Mnemonic;1995;Rotten;12;31;4;29;33;6
Johnny Suede;1991;Rotten;33;47;4;8;12;0
Johns;1997;Rotten;54;58;7;6;13;2
Johnson Family Vacation;2004;Rotten;6;44;5;85;90;32
Johnstown Flood;2003;Fresh;73;60;8;3;11;0
Joker;2019;Fresh;68;88;393;182;574;56
Joker 3D;2012;Rotten;0;21;0;6;6;2
Jolene;2008;Rotten;48;43;10;11;21;9
Le Joli Mai;1963;Fresh;94;92;15;1;16;3
Jonah - A VeggieTales Movie;2002;Fresh;66;74;37;19;56;19
Jonah Hex;2010;Rotten;12;20;18;133;151;37
Jonas Brothers: The 3D Concert Experience;2009;Rotten;23;79;18;59;77;29
Jonathan;2018;Fresh;63;56;17;10;27;7
Jonathan Livingston Seagull;1973;Rotten;8;61;1;12;13;3
The Joneses;2010;Fresh;63;47;81;48;129;36
Joseph and the Amazing Technicolor Dreamcoat;2000;Fresh;86;81;6;1;7;0
Josh and S.A.M.;1900;Rotten;25;48;2;6;8;2
Joshua;2007;Fresh;62;40;62;38;100;33
Joshua Tree, 1951: A Portrait of James Dean;1900;Fresh;60;60;3;2;5;2
Joshy;2016;Fresh;81;54;21;5;26;10
Josie;2018;Rotten;13;33;1;7;8;2
Josie and the Pussycats;2001;Rotten;53;52;65;58;123;34
Joueuse (Queen to Play);2011;Fresh;71;72;29;12;41;19
Journey to Italy (Viaggio in Italia) (Strangers) (The Lonely Woman);1900;Fresh;95;76;21;1;22;8
The Journey of August King;1996;Rotten;57;69;4;3;7;2
Journey of Hope;1991;Fresh;83;84;5;1;6;3
The Journey of Natty Gann;1985;Fresh;91;78;29;3;32;12
Journey to the Center of the Earth;1959;Fresh;83;69;25;5;30;2
Journey to the Center of the Earth;2008;Fresh;61;51;98;62;160;38
Journey 2: The Mysterious Island;2012;Rotten;45;59;59;73;132;35
Journey To The West;2014;Fresh;94;69;33;2;34;10
Journey to the West: The Demons Strike Back;2017;Rotten;58;49;7;5;12;5
Journey's End;2018;Certified-Fresh;92;72;93;8;101;28
Joy;2015;Fresh;61;57;161;106;266;50
The Joy Luck Club;1993;Fresh;86;89;31;5;36;7
The Joy of Life;2005;Fresh;92;43;12;1;13;4
Joy Ride;2001;;;;84;30;;32
Joy Ride 3: Road Kill;1900;Fresh;60;25;3;2;5;0
Joyeux Noel (Merry Christmas);2006;Certified-Fresh;74;89;83;29;112;38
Joyful Noise;2012;Rotten;32;65;41;88;129;43
JSA: Joint Security Area (Gongdong gyeongbi guyeok JSA);1900;Fresh;81;91;13;3;16;3
J.T. LeRoy;2019;Rotten;55;42;46;37;83;22
Ju Dou;;Fresh;100;89;18;0;18;6
Juan of the Dead;2012;Fresh;82;64;18;4;22;5
Juanita;1900;Fresh;81;65;13;3;16;5
Jubal;1956;Fresh;100;79;10;0;10;2
Judd Apatow: The Return;1900;Fresh;86;51;6;1;7;3
Jude;1996;Fresh;81;73;30;7;37;13
Judge Dredd;1995;Rotten;20;30;11;43;54;11
Judgment Day;1999;Rotten;40;15;2;3;5;0
Judgment Night;1993;Rotten;35;55;7;13;20;5
Judy;2019;Certified-Fresh;82;85;267;60;327;43
Judy & Punch;2020;Certified-Fresh;77;60;105;31;136;19
Judy Moody and the NOT Bummer Summer;2011;Rotten;21;41;17;65;82;30
Jug Face;2013;Fresh;76;36;16;6;21;7
Juggernaut;2018;Rotten;57;60;4;3;7;4
Juice;1992;Fresh;79;90;19;5;24;7
Jules and Jim;1962;Certified-Fresh;93;89;39;3;42;7
Julian Schnabel: A Private Portrait;2017;Rotten;50;;7;7;14;7
Julie & Julia;2009;Certified-Fresh;77;70;174;52;226;61
Julien Donkey-Boy;1999;Rotten;28;71;10;26;36;8
Juliet, Naked;2018;Certified-Fresh;83;74;136;28;164;34
Juliet of the Spirits (Giulietta degli Spiriti);1965;Fresh;79;85;22;6;28;10
Julieta;2016;Certified-Fresh;83;74;165;33;198;33
Jumanji: The Next Level;2019;Fresh;72;87;173;67;240;34
Jumanji: Welcome to the Jungle;2017;Certified-Fresh;76;87;177;55;232;41
Jump In!;2007;Fresh;63;61;5;3;8;2
Jump Shot: The Kenny Sailors Story;2020;Fresh;100;98;14;0;14;1
Jump Tomorrow;2001;Certified-Fresh;81;88;44;10;54;21
Jumper;2008;Rotten;15;44;25;143;168;42
Jumpin' Jack Flash;1986;Rotten;29;58;6;15;21;2
Jumping the Broom;2011;Rotten;58;58;49;36;85;30
Junebug;2005;Certified-Fresh;86;73;117;19;136;35
Jungfrukallan (The Virgin Spring);1960;Fresh;87;92;20;3;23;3
Jungle;2017;Fresh;60;59;32;21;53;12
Jungle 2 Jungle;1997;Rotten;19;33;8;34;42;16
The Jungle Book 2;2003;Rotten;18;30;17;75;92;27
Juno;2007;Certified-Fresh;94;88;203;13;216;43
Jupiter Ascending;2015;Rotten;27;38;73;196;269;52
Jupiter's Wife;1900;Fresh;80;84;4;1;5;2
Jurassic Park;1993;Certified-Fresh;91;91;117;11;128;34
Jurassic Park III;2001;Rotten;49;36;91;95;186;42
Jurassic World;2015;Fresh;70;78;247;104;351;55
Jurassic World: Fallen Kingdom;2018;Rotten;47;48;199;223;422;59
The Juror;1996;Rotten;18;31;4;18;22;7
Jury Duty;1995;Rotten;0;26;0;12;12;3
Karlighed pa Film (Just Another Love Story);2007;Fresh;74;82;34;12;46;20
Just 45 Minutes From Broadway;2012;Rotten;18;71;2;9;11;7
Just a Kiss;2002;Rotten;18;29;11;49;60;22
Just Another Girl on the I.R.T.;1993;Fresh;67;84;16;8;24;11
Just Before I Go;1900;Rotten;10;59;1;9;10;5
Just Between Friends;1986;Rotten;33;52;2;4;6;1
Just Buried;2007;Rotten;33;36;3;6;9;4
Just Cause;1995;Rotten;26;46;8;23;31;9
Just Charlie;2018;Fresh;100;82;7;0;7;0
Just Do It: A Tale of Modern-day Outlaws;2011;Fresh;77;36;10;3;13;6
Just Friends;1900;Rotten;43;71;46;62;108;31
Just Getting Started;2017;Rotten;4;10;1;22;23;10
Just Go with It;2011;Rotten;19;59;27;112;139;37
Just Like A Woman;2013;Rotten;13;33;2;13;15;9
Just Like Heaven;2005;Rotten;55;75;83;68;151;32
Just Looking;1900;Rotten;45;64;10;12;22;5
Just Married;1900;Rotten;20;47;21;84;105;29
Just Mercy;2020;Certified-Fresh;84;99;243;46;289;47
Just My Luck;2006;Rotten;14;48;15;96;111;35
Just One of the Guys;1985;Rotten;45;65;5;6;11;2
Just Visiting;2001;Rotten;33;53;26;53;79;26
Just Wright;2010;Rotten;46;61;50;59;109;31
Just Write;1997;Rotten;57;55;4;3;7;0
Justice;2004;Fresh;67;;6;3;9;5
Seeking Justice;2012;Rotten;28;39;22;57;79;24
Justice League;2017;Rotten;40;71;158;237;395;53
Justice League Dark;1900;Fresh;78;69;7;2;9;0
Justice League Dark: Apokolips War;1900;Fresh;100;91;17;0;17;0
Justice League: Gods and Monsters;1900;Fresh;88;71;7;1;8;0
Justice League: Throne Of Atlantis;1900;Rotten;57;63;4;3;7;0
Justice League vs the Fatal Five;1900;Fresh;100;61;8;0;8;0
Justice League: War;1900;Rotten;50;79;3;3;6;1
Justin and the Knights of Valour;1900;Rotten;13;35;2;13;15;1
Justin Bieber: Never Say Never;2011;Fresh;65;65;70;37;107;36
Justin Bieber's Believe;2013;Rotten;53;59;8;7;15;10
Justin Timberlake + The Tennessee Kids;1900;Fresh;100;73;14;0;14;6
Juwanna Mann;2002;Rotten;10;39;8;75;83;29
K-19: The Widowmaker;2002;Fresh;61;52;104;67;171;38
K2;1992;Rotten;29;49;4;10;14;3
K-9;1989;Rotten;22;44;2;7;9;1
K-9: P.I.;2002;Rotten;0;37;0;6;6;0
K-11;2013;Rotten;20;43;3;12;15;5
Kabhi Alvida Naa Kehna;2006;Rotten;58;68;7;5;12;4
Kabhi Khushi Kabhie Gham;2001;Fresh;100;88;8;0;8;3
Kabluey;2007;Fresh;84;65;31;6;37;13
Kaboom;2011;Fresh;60;41;63;42;105;36
Kadosh;2000;Fresh;89;71;16;2;18;3
Kaena: The Prophecy;2004;Rotten;7;44;2;28;30;12
Kagemusha;1980;Fresh;88;92;21;3;24;5
Kalamity;2010;Rotten;0;31;0;17;17;8
Kaleidoscope;2017;Fresh;64;42;14;8;22;10
Kalifornia;1993;Rotten;59;64;19;13;32;4
Kama Sutra: A Tale of Love;1996;Rotten;40;71;8;12;20;6
Kamp Katrina;2007;Fresh;82;55;9;2;11;7
Kampai! For the Love of Sake;2016;Rotten;33;43;3;6;9;4
Kangaroo Jack;2003;Rotten;8;29;9;107;116;32
Kansas City;1996;Fresh;62;43;23;14;37;11
Kansas City Confidential (The Secret Four);1952;Fresh;85;76;11;2;13;0
Kapo;1959;Fresh;60;88;3;2;5;1
The Karate Kid;1984;Certified-Fresh;89;82;39;5;44;6
The Karate Kid;2010;Fresh;66;67;138;71;209;44
The Karate Kid Part II;1986;Rotten;45;51;14;17;31;5
Men at Work;2006;Fresh;100;81;5;0;5;2
Karl Marx City;2017;Fresh;96;71;25;1;26;8
Kart Racer;2002;Rotten;40;60;2;3;5;2
Karthik Calling Karthik (K.C.K.);2010;Fresh;80;49;4;1;5;2
Kassim the Dream;2009;Rotten;54;89;7;6;13;7
Kat and the Band;1900;Fresh;60;;3;2;5;1
Kate & Leopold;2001;Rotten;50;62;65;64;129;34
Katie Says Goodbye;2019;Rotten;42;74;8;11;19;5
Katt Williams: Great America;1900;Fresh;80;62;4;1;5;1
Katy Perry: Part of Me;2012;Certified-Fresh;76;72;68;22;90;32
Kazaam;1996;Rotten;5;20;2;35;37;14
Keane;2005;Certified-Fresh;81;70;50;12;62;24
Keanu;2016;Certified-Fresh;77;55;137;40;177;38
Kedi;2017;Certified-Fresh;98;85;125;3;128;26
Kedma;2003;Rotten;31;59;4;9;13;2
The Keep;1983;Rotten;40;43;6;9;15;0
Keep Your Right Up (Soigne ta droite);2001;Rotten;33;19;2;4;6;3
Keep On Keepin' On;2014;Certified-Fresh;98;88;42;1;43;22
Keep the Lights On;2012;Certified-Fresh;89;63;59;7;66;31
Keep the River on Your Right;2000;Certified-Fresh;78;50;40;11;51;19
Keeping the Faith;1900;Fresh;69;59;82;36;118;28
Keeping Up With The Joneses;2016;Rotten;20;37;24;98;122;32
Keeping Up With The Steins;2006;Rotten;37;38;30;52;82;29
Kelly & Cal;2014;Fresh;71;53;25;10;35;15
Kelly's Heroes;1970;Fresh;78;88;18;5;23;3
Ken Jeong: You Complete Me, Ho;1900;Rotten;38;;3;5;8;1
The Kennel Murder Case;1933;Fresh;83;67;5;1;6;0
Kenny Chesney: Summer In 3d;2010;Rotten;57;73;4;3;7;5
The Kentuckian;1955;Rotten;14;45;1;6;7;3
The Kentucky Fried Movie;1977;Fresh;81;66;25;6;31;4
Kepler's Dream;2017;Rotten;56;78;5;4;9;4
Kes;1969;Fresh;100;91;32;0;32;11
Kettle of Fish;2006;Rotten;18;23;2;9;11;7
Kevin Hart: Irresponsible;1900;Fresh;100;;6;0;6;1
Kevin Hart: Laugh At My Pain;1900;Fresh;71;84;5;2;7;2
Kevin Hart: Let Me Explain;2013;Fresh;61;72;27;17;44;19
Kevin Hart: What Now?;2016;Fresh;76;58;45;14;59;23
Kevin Hart's Guide to Black History;1900;Fresh;80;67;4;1;5;1
Key Largo;1948;Fresh;97;88;34;1;35;4
Keyhole;2012;Fresh;68;39;28;13;41;20
Khakee (The Uniform);2004;Fresh;100;78;6;0;6;1
Khartoum;1966;Fresh;100;65;10;0;10;0
Khatta Meetha;2010;Rotten;17;33;1;5;6;2
Khodorkovsky;2011;Fresh;90;71;26;3;29;13
Khumba;2013;Rotten;44;43;8;10;18;8
Khyi rgan (Old Dog);1900;Fresh;100;;7;0;7;3
Kick-Ass 2;2013;Rotten;32;57;67;143;210;45
Kickboxer 2: The Road Back;;Rotten;20;31;1;4;5;2
Kickboxer: Retaliation;2018;Fresh;92;69;12;1;13;5
Kickboxer: Vengeance;2016;Rotten;39;43;13;20;33;8
Kicking & Screaming;2005;Rotten;41;43;59;84;143;36
Kicking It;2008;Rotten;53;71;8;7;15;7
Kicks;2016;Fresh;87;73;33;5;38;12
Kid Cannabis;2014;Fresh;71;64;5;2;7;4
A Kid in King Arthur's Court;1995;Rotten;5;27;1;20;21;8
The Kid Stays in the Picture;2002;Certified-Fresh;91;80;102;10;112;32
Kidnap;2017;Rotten;36;50;33;59;92;23
Kidnapped;2011;Rotten;44;49;11;14;25;7
Kidnapping Mr. Heineken;2015;Rotten;19;24;12;51;62;23
Kids for Cash;2014;Fresh;92;73;33;3;36;17
Kika;1900;Fresh;60;71;9;6;15;6
Kiki;2017;Fresh;82;52;23;5;28;10
Kiki's Delivery Service;1989;Certified-Fresh;98;88;40;1;41;6
Kikujiro;1900;Fresh;61;92;31;20;51;12
Kilimanjaro: To The Roof of Africa;2002;Fresh;90;39;9;1;10;1
Kill Bill: Volume 1;2003;Certified-Fresh;85;81;201;36;237;46
Kill Bill: Volume 2;2004;Certified-Fresh;84;89;203;39;242;51
Kill Command;2016;Fresh;75;45;9;3;12;1
Kill List;1900;Certified-Fresh;78;58;74;21;95;29
Kill Me Three Times;2015;Rotten;16;30;9;47;55;18
Kill Order;2018;Rotten;25;45;2;6;8;0
Kill Ratio;2016;Rotten;0;18;0;5;5;1
Kill Switch;2017;Rotten;9;20;2;20;22;5
Kill the Irishman;2011;Fresh;62;67;32;20;52;17
Kill the Messenger;2014;Certified-Fresh;77;69;99;29;128;42
Kill the Monsters;1900;Fresh;100;;6;0;6;1
Kill the Poor;2006;Rotten;25;33;2;6;8;6
Kill Your Darlings;2013;Certified-Fresh;77;60;115;35;150;39
Kill Your Friends;2016;Rotten;23;33;14;46;60;16
Kill Zone 2 (Saat po long 2);2016;Fresh;100;64;22;0;22;8
Killer Bees;2018;Fresh;80;80;4;1;5;3
Killer Elite;2011;Rotten;27;42;34;92;126;33
The Killer Is Loose;1956;Fresh;60;37;3;2;5;0
Killer Joe;2012;Certified-Fresh;79;61;135;35;170;47
Killer Kate!;2018;Fresh;71;57;5;2;7;2
Killer Klowns from Outer Space;1988;Fresh;75;59;18;6;24;0
Killer Me;2001;Rotten;50;;3;3;6;0
The Killer Shrews;1959;Rotten;50;24;5;5;10;0
Killerman;2019;Rotten;26;63;5;14;19;7
Killers;2010;Rotten;10;41;11;97;108;25
Killers;2015;Fresh;73;65;11;4;15;6
Killers Anonymous;2019;Rotten;0;17;0;9;9;5
Killer's Kiss;1955;Fresh;86;58;18;3;21;4
The Killing;1956;Certified-Fresh;98;92;40;1;41;8
Killing Bono;2011;Rotten;56;47;24;19;43;18
The Killing Fields;1984;Certified-Fresh;93;92;40;3;43;8
Killing for Love (Das Versprechen);2017;Fresh;100;77;9;0;9;3
Killing Ground;2017;Certified-Fresh;75;45;52;17;69;13
Killing Gunther;2017;Rotten;48;28;11;12;23;6
Killing Jesus;1900;Rotten;43;29;3;4;7;3
Killing Kennedy;1900;Rotten;56;42;10;8;18;9
Killing Me Softly;2003;Rotten;0;41;0;23;23;6
The Killing of a Chinese Bookie;1976;Fresh;79;83;22;6;28;7
Killing Season;2013;Rotten;10;29;2;18;20;9
Killing Them Safely (Tom Swift And His Electric Rifle);2015;Fresh;91;53;10;1;11;6
Killing Them Softly;2012;Certified-Fresh;73;44;168;61;229;57
Killing Zoe;1994;Rotten;36;64;10;18;28;4
Killshot;2008;Rotten;33;28;2;4;6;1
Kim;1951;Fresh;78;57;7;2;9;1
Kin;1900;Rotten;34;54;31;61;92;16
Kind Hearts and Coronets;1949;Certified-Fresh;100;94;47;0;47;13
Kindergarten Cop;;Rotten;51;52;19;18;37;8
Kindergarten Cop 2;2016;Rotten;29;24;2;5;7;0
King and Country;1965;Fresh;86;78;6;1;7;0
King Arthur: Legend Of The Sword;2017;Rotten;30;69;83;190;273;51
King Charles III on Masterpiece;2017;Fresh;100;45;9;0;9;7
King Cobra;2016;Rotten;49;32;17;18;35;11
King Creole;1958;Fresh;100;83;23;0;23;4
King David;1985;Rotten;8;42;1;11;12;4
King Georges;2016;Fresh;100;55;9;0;9;6
King In The Wilderness;2018;Fresh;100;95;10;0;10;6
King Jack;2016;Fresh;94;72;33;2;35;11
King Kong;2005;Certified-Fresh;84;50;224;43;267;50
King of California;2007;Fresh;63;64;42;25;67;29
King of Devil's Island;2011;Certified-Fresh;94;88;46;3;49;16
King of Hearts;1967;Fresh;89;88;16;2;18;4
The King of Kong: A Fistful of Quarters;2007;Certified-Fresh;97;93;100;3;103;32
The King of Marvin Gardens;1972;Fresh;69;58;20;9;29;9
King of New York;;Fresh;73;77;19;7;26;7
King of the Ants;1900;;;;9;1;;1
King of the Gypsies;1978;Fresh;86;66;6;1;7;0
King of Thieves;2019;Rotten;34;27;28;55;83;18
King Ralph;1991;Rotten;27;27;3;8;11;2
Kingdom Come;2001;Rotten;28;72;18;47;65;25
Kingdom of Heaven;2005;Rotten;39;72;74;116;190;43
Kingdom of Us;2017;Fresh;100;82;8;0;8;0
Kings;2018;Rotten;13;35;5;33;38;10
Kings of Pastry;2010;Fresh;86;69;30;5;35;16
Kings of the Evening;2010;Fresh;73;57;8;3;11;5
King's Ransom;2005;Rotten;2;32;1;49;50;15
Kings Row;1942;Fresh;100;76;16;0;16;1
Kingsglaive: Final Fantasy XV;2016;Rotten;12;68;2;15;17;7
Kingsman: The Golden Circle;2017;Rotten;51;64;156;148;304;46
Kingsman: The Secret Service;2015;Certified-Fresh;74;84;192;66;258;53
Kink;2014;Fresh;88;52;7;1;8;3
Kinky Boots;2006;Rotten;56;74;62;48;110;37
Kinsey;2004;Certified-Fresh;90;75;176;20;196;45
Kirk Cameron's Saving Christmas;2014;Rotten;0;30;0;16;16;8
Winter Sleep;2014;Certified-Fresh;87;83;72;11;83;29
Kiss Me Kate;1953;Fresh;91;67;10;1;11;3
Kiss the Bride;2002;Rotten;33;41;2;4;6;0
Kiss Kiss, Bang Bang;2005;Certified-Fresh;86;87;156;26;182;49
Kiss Me Again;1900;Rotten;0;44;0;7;7;4
Kiss Me, Stupid;1964;Fresh;73;66;19;7;26;7
Kiss Of The Damned;2013;Fresh;60;38;21;14;35;11
Kiss of the Dragon;2001;Rotten;52;68;56;52;108;30
Kiss of the Spider Woman;1985;Fresh;87;81;26;4;30;4
Kiss of the Vampire;1963;Fresh;88;62;7;1;8;1
Kiss the Bride;2008;Rotten;38;45;3;5;8;3
Kiss The Girls;1997;Rotten;31;62;10;22;32;8
Kiss the Water;1900;Fresh;87;53;13;2;15;7
Kisses and Caroms;2006;Rotten;40;22;2;3;5;0
Kissing Jessica Stein;2002;Certified-Fresh;83;65;100;20;120;34
Kit Kittredge: An American Girl;2008;Certified-Fresh;80;69;84;21;105;31
Soul Kitchen;2010;Certified-Fresh;73;74;44;16;60;23
Kitchen Stories;2004;Certified-Fresh;91;86;67;7;74;27
Kite;2014;Rotten;0;18;0;15;15;8
The Kite Runner;2007;Fresh;65;84;115;61;176;50
Kites;2010;Fresh;72;53;21;8;29;14
Kitty Foyle;1940;Fresh;80;72;8;2;10;3
The Klansman;1974;Rotten;22;26;2;7;9;0
Klaus;2019;Certified-Fresh;94;97;63;4;67;13
Klitschko;2011;Fresh;84;84;16;3;19;9
The Trap (Klopka);2007;Fresh;60;87;3;2;5;0
Klovn: The Movie (Klown);2012;Certified-Fresh;73;68;38;14;52;20
Klown Forever (Klovn Forever);2016;Rotten;59;47;10;7;17;4
Klute;1971;Certified-Fresh;93;80;38;3;41;10
Knife in the Water;1962;Fresh;100;85;33;0;33;6
Knife Fight;2013;Rotten;28;26;5;13;18;10
Knight & Day;2010;Rotten;52;49;120;110;230;51
Knight of Cups;2016;Rotten;47;37;85;95;179;47
Knightriders;1981;Fresh;77;61;10;3;13;0
Knights of Badassdom;2014;Fresh;63;37;10;6;16;3
Knights of the Round Table;1954;Fresh;67;43;4;2;6;0
A Knight's Tale;2001;Rotten;59;79;88;62;150;40
Knives and Skin;2019;Fresh;68;34;50;23;73;10
Knives Out;2019;Certified-Fresh;97;92;441;14;454;46
Knock Down the House;2019;Certified-Fresh;99;20;102;1;103;25
Knock Knock;2015;Rotten;37;20;26;45;71;21
Knock Off;1998;Rotten;8;25;3;37;40;11
Knockaround Guys;2002;Rotten;21;51;21;80;101;28
Knocked Up;2007;Certified-Fresh;90;83;226;26;252;55
Know How;2015;Rotten;50;67;3;3;6;3
Knowing;2009;Rotten;33;42;61;122;183;37
Knuckle;2011;Certified-Fresh;93;67;40;3;43;18
Knuckleball!;1900;Fresh;94;84;16;1;17;9
Knucklehead;2010;Rotten;10;35;1;9;10;6
Knute Rockne---All American;1940;Fresh;88;61;7;1;8;3
Koch;2013;Fresh;90;76;35;4;39;17
Kodachrome;1900;Fresh;70;69;35;15;50;15
Koi... Mil Gaya (I Found Someone);2003;Fresh;75;76;6;2;8;4
Kolobos;1999;Fresh;60;62;3;2;5;1
Kolya;1997;Fresh;96;92;23;1;24;8
Kon Tiki;2013;Certified-Fresh;81;77;65;15;80;27
Kong: Skull Island;2017;Certified-Fresh;75;69;288;96;384;54
Control (Kontroll);2005;Certified-Fresh;82;89;54;12;66;21
Korengal;2014;Fresh;86;64;32;5;37;16
Korkoro;2011;Fresh;75;68;6;2;8;3
Koyaanisqatsi - Life Out of Balance;1983;Fresh;90;91;19;2;21;1
K-PAX;2001;Rotten;42;75;60;82;142;34
Kramer vs. Kramer;1979;Certified-Fresh;88;89;46;6;52;14
Krampus;2015;Fresh;66;51;85;43;128;22
The Krays;1900;Fresh;81;80;13;3;16;3
The Kreutzer Sonata;2009;Rotten;56;44;10;8;18;8
Die Nibelungen: Kriemhilds Rache (Kriemhild's Revenge);1924;Fresh;83;85;5;1;6;1
Krippendorf's Tribe;1998;Rotten;16;24;6;32;38;8
Kris (Crisis);1946;Rotten;40;40;2;3;5;1
Kronk's New Groove;2005;Rotten;0;43;0;6;6;0
Krrish;2006;Fresh;88;72;7;1;8;4
Krrish 3;2013;Fresh;71;52;10;4;14;3
Krull;1983;Rotten;32;51;7;15;22;1
Krush Groove;1985;Rotten;43;81;3;4;7;2
Krystal;2018;Rotten;14;44;3;19;22;8
Kubo and the Two Strings;2016;Certified-Fresh;97;86;212;7;219;46
Kuffs;1900;Rotten;28;48;5;13;18;2
Kull the Conqueror;1997;Rotten;25;24;5;15;20;4
Kumare;2012;Fresh;60;82;15;10;25;14
Kumiko, the Treasure Hunter;2015;Certified-Fresh;88;62;117;16;133;36
Kundo: Age of the Rampant;2014;Fresh;82;68;9;2;11;7
Kung Fu Hustle;2005;Certified-Fresh;90;89;170;18;188;44
Kung Fu Killer;2015;Fresh;75;57;18;6;24;7
Kung Fu Panda;2008;Certified-Fresh;87;83;164;24;188;44
Kung Fu Panda 3;2016;Certified-Fresh;87;78;154;23;177;41
Kung Fu Panda 2;2011;Certified-Fresh;81;74;146;35;181;43
Kung-Fu Yoga;2017;;;24;11;12;;7
Kung Pow! Enter the Fist;1900;Rotten;13;69;7;48;55;13
Kurt & Courtney;1998;Fresh;62;44;34;21;55;19
Kurt Cobain: About a Son;2007;Certified-Fresh;74;78;31;11;42;15
Kurt Cobain: Montage Of Heck;2015;Certified-Fresh;97;81;91;3;94;29
Kaidan (Kwaidan) (Ghost Stories);1964;Fresh;90;90;26;3;29;5
Kwik Stop;2001;Fresh;100;60;5;0;5;2
Kyun...! Ho Gaya Na;2004;Fresh;80;51;4;1;5;4
The Confession;1970;Fresh;100;85;6;0;6;1
L'Iceberg;2005;Fresh;69;66;22;10;32;15
The Double Hour;2011;Certified-Fresh;82;68;55;12;67;21
La Bamba;1987;Certified-Fresh;91;78;39;4;43;12
La belle endormie (The Sleeping Beauty);2011;Fresh;74;;20;7;27;14
La Belle Noiseuse;1991;Fresh;100;83;29;0;29;11
La Bete Humaine (Judas Was a Woman)(The Human Beast);1938;Fresh;93;82;14;1;15;4
La Cage aux Folles;1979;Fresh;95;85;20;1;21;1
La Cage aux Folles II;1981;Fresh;60;54;3;2;5;0
La Cara Oculta;2012;Fresh;80;72;4;1;5;1
The Blue Room (La chambre bleue);2014;Certified-Fresh;90;51;70;8;78;34
La Chevre (The Goat) (Knock on Wood);1981;Rotten;50;83;3;3;6;1
La Chinoise;1968;Fresh;95;73;18;1;19;7
La Cienaga;2001;Certified-Fresh;88;80;38;5;43;16
L.A. Confidential;1997;Certified-Fresh;99;94;113;1;114;33
The Lady in the Car with Glasses and a Gun (La dame dans l'auto avec un fusil et des lunettes);2015;Fresh;80;47;4;1;5;2
La delicatesse (Delicacy);2012;Fresh;62;57;44;27;71;27
La fee (The Fairy);2012;Certified-Fresh;90;56;36;4;40;18
La Femme Nikita (Nikita);;Certified-Fresh;88;84;38;5;43;5
La France;2008;Fresh;94;47;15;1;16;5
La Grande illusion (Grand Illusion);1938;Certified-Fresh;97;92;64;2;66;18
La Haine;1996;Fresh;100;95;29;0;29;9
La La Land;2016;Certified-Fresh;91;81;415;43;458;66
The Legend of the Chupacabras (La Leyenda del Chupacabras);2016;Rotten;25;25;2;6;8;0
La Maison De La Radio;2013;Fresh;62;33;13;8;21;11
La mujer de mi hermano;2006;Rotten;20;59;8;32;40;23
La nouvelle guerre des boutons (War of the Buttons);2012;Rotten;25;42;6;18;24;11
La Petite Lili;2004;Fresh;66;48;21;11;32;12
La princesse de Montpensier (The Princess of Montpensier);2011;Certified-Fresh;85;54;56;10;66;28
La Promesse (The Promise);1996;Fresh;95;91;20;1;21;8
La religieuse (The Nun);1900;Fresh;64;59;9;5;14;5
La Sapienza;2015;Fresh;88;50;21;3;24;12
La Scorta;1994;Rotten;57;43;4;3;7;3
La Sierra;2005;Fresh;100;92;6;0;6;3
L.A. Slasher;2015;Rotten;0;31;0;6;6;1
L.A. Story;1991;Fresh;94;75;33;2;35;11
La Terra trema;1948;Fresh;90;87;9;1;10;0
La tete en friche (My Afternoons with Margueritte);2011;Certified-Fresh;85;79;52;9;61;22
La Vie en Rose (La Mome);2007;Certified-Fresh;74;84;113;39;152;47
Labor Day;2014;Rotten;35;54;69;131;200;56
Labyrinth;1986;Fresh;72;86;33;13;46;7
Ladder 49;2004;Rotten;41;81;67;97;164;35
Ladies and Gentlemen: The Fabulous Stains;1981;Fresh;64;65;7;4;11;3
Ladies in Black;1900;Fresh;88;72;29;4;33;3
Ladies in Lavender;2005;Fresh;64;66;58;33;91;30
Ladron que Roba a Ladron;2007;Fresh;66;73;19;10;29;13
Lady and the Tramp;1955;Certified-Fresh;93;80;38;3;41;5
Lady and the Tramp II: Scamp's Adventure;2000;Rotten;45;50;5;6;11;0
Lady Bird;2017;Certified-Fresh;99;79;388;4;391;56
The Lady Eve;1941;Certified-Fresh;100;87;47;0;47;10
Lady in a Cage;1964;Rotten;20;65;1;4;5;0
Lady in the Lake;1900;Fresh;60;51;6;4;10;1
Lady in the Water;2006;Rotten;25;49;54;159;213;48
Lady in White;1988;Fresh;69;69;11;5;16;1
Lady J (Mademoiselle de Joncquieres);1900;Fresh;83;68;10;2;12;5
Lady Jane;1986;Rotten;56;76;5;4;9;1
Lady L;1965;Rotten;29;31;2;5;7;3
Lady Macbeth;2017;Certified-Fresh;88;71;170;23;193;41
Lady on a Train;1945;Fresh;71;72;10;4;14;6
Lady Snowblood (Shurayukihime);2005;Fresh;100;85;7;0;7;1
Ladybugs;1992;Rotten;12;42;2;15;17;2
Ladyhawke;1985;Fresh;67;74;16;8;24;1
The Ladykillers;2004;Rotten;54;43;105;88;193;45
Ladyworld;2019;Rotten;52;29;11;10;21;4
Lagaan: Once Upon a Time in India;2001;Certified-Fresh;95;93;57;3;60;21
Lagerfeld Confidential;2007;Rotten;43;54;15;20;35;20
Laggies;2014;Fresh;65;50;75;41;116;37
The Lair of the White Worm;1988;Fresh;67;47;18;9;27;1
Lake City;2008;Rotten;12;34;3;23;26;14
The Lake House;2006;Rotten;35;73;55;101;156;45
Lake Michigan Monster;1900;Fresh;84;;16;3;19;0
Lake of Fire;2007;Certified-Fresh;94;91;51;3;54;22
Lake Placid;1900;Rotten;47;37;44;50;94;24
Lake Tahoe;2008;Fresh;84;63;16;3;19;6
Lakeboat;2000;Certified-Fresh;83;61;35;7;42;16
Lamb;2016;Fresh;82;54;28;6;34;10
Lamb Of God's As The Palaces Burn;2014;Fresh;81;88;13;3;16;9
Lambert & Stamp;2015;Certified-Fresh;89;52;66;8;74;30
Land Ho!;2014;Certified-Fresh;82;54;75;16;90;35
Land of Mine (Under Sandet);2017;Certified-Fresh;92;88;97;9;106;25
Land of Silence and Darkness (Land des Schweigens und der Dunkelheit);1973;Fresh;83;89;5;1;6;2
Land of the Dead;2005;Certified-Fresh;74;51;133;46;179;34
Land of the Pharaohs;1955;Fresh;78;43;7;2;9;2
Landline;2017;Certified-Fresh;74;64;96;33;129;33
Lansdown;2002;Rotten;38;;3;5;8;2
Lansky;1998;Rotten;40;12;2;3;5;2
Lantana;2002;Certified-Fresh;90;82;96;11;107;32
Lara Croft - Tomb Raider;2001;Rotten;20;47;33;128;161;40
Lara Croft Tomb Raider - The Cradle of Life;2003;Rotten;24;44;42;132;174;40
The Laramie Project;2002;Fresh;92;80;12;1;13;1
L'Argent;1983;Fresh;97;82;28;1;29;6
Larger Than Life;1996;Rotten;11;29;2;17;19;7
Heartbreaker (L'Arnacoeur);2010;Fresh;68;66;54;25;79;20
Larry Crowne;2011;Rotten;37;41;74;128;202;50
Larry the Cable Guy: Health Inspector;2006;Rotten;5;52;2;37;39;14
Lassie;2006;Certified-Fresh;93;64;65;5;70;28
Lassie Come Home;1943;Fresh;94;75;15;1;16;5
Lassiter;1984;Fresh;71;31;5;2;7;1
Lasso;1900;Fresh;67;70;6;3;9;0
Last Action Hero;1993;Rotten;38;47;18;30;48;8
The Last Airbender;2010;Rotten;5;30;10;181;191;47
The Last Boy Scout;1991;Rotten;47;68;17;19;36;5
Last Call at the Oasis;2012;Fresh;81;88;21;5;26;12
The Last Castle;2001;Rotten;52;74;60;55;115;30
Last Chance Harvey;2009;Certified-Fresh;71;53;113;46;159;41
Last Day of Summer;2010;Rotten;17;23;1;5;6;2
Last Days;2005;Rotten;58;50;70;51;121;39
Last Days Here;2012;Fresh;86;90;18;3;21;8
Last Days In The Desert;2016;Certified-Fresh;76;45;54;17;71;18
Last Days in Vietnam;2014;Certified-Fresh;95;84;59;3;62;24
Last Days of Disco;1998;Fresh;73;66;44;16;60;13
The Last Detail;1973;Fresh;89;87;32;4;36;7
The Last Emperor;1987;Certified-Fresh;89;88;64;8;72;17
The Last Exorcism;2010;Fresh;72;35;117;45;162;34
Last Flag Flying;2017;Certified-Fresh;78;71;166;47;213;47
The Last Flight of Noah's Ark;1980;Rotten;40;41;2;3;5;2
Last Hijack;2014;Fresh;94;57;15;1;16;4
Last Holiday;1950;Fresh;100;79;8;0;8;3
Last Holiday;2006;Rotten;56;67;68;53;121;32
The Last House on the Left;1972;Fresh;62;44;24;15;39;5
The Last Hurrah;1958;Fresh;86;82;12;2;14;0
The Last King of Scotland;2006;Certified-Fresh;87;89;161;24;185;53
The Last Kiss;2006;Rotten;46;59;60;71;131;36
Last Knights;2015;Rotten;16;46;5;26;31;14
The Last Legion;2007;Rotten;15;34;8;47;55;23
Last Love;2013;Rotten;31;53;12;27;39;16
Last Man Standing;1996;Rotten;37;51;11;19;30;6
Last Men in Aleppo;1900;Fresh;97;75;34;1;35;14
The Last Mogul (Life and Times of Lew Wasserman);2005;Fresh;81;55;13;3;16;7
The Last New Yorker;2010;Rotten;36;17;4;7;11;7
The Last of Sheila;1973;Fresh;86;85;12;2;14;1
Last of the Red Hot Lovers;1972;Rotten;33;81;2;4;6;3
Last Ounce of Courage;2012;Rotten;0;69;0;16;16;5
Last Passenger;1900;Fresh;85;58;17;3;20;8
The Last Picture Show;1971;Certified-Fresh;100;90;57;0;57;15
Last Rampage;2017;Fresh;64;49;7;4;11;4
The Last Samurai;2003;Fresh;66;83;146;75;221;45
Last Shift;2015;Fresh;100;51;8;0;8;1
The Last Sin Eater;2007;Rotten;21;72;8;30;38;14
The Last Stand;2013;Fresh;61;53;102;64;166;39
The Last Station;2010;Fresh;71;67;105;43;148;43
Last Summer in the Hamptons;1995;Fresh;64;47;9;5;14;2
Last Tango in Paris;1972;Certified-Fresh;83;76;33;7;40;8
The Last Temptation of Christ;1988;Certified-Fresh;81;84;47;11;58;9
The Last Time I Saw Paris;1954;Fresh;88;49;7;1;8;4
Last Train from Gun Hill;1900;Fresh;83;80;5;1;6;0
Last Train Home;2010;Certified-Fresh;100;87;54;0;54;18
The Last Tycoon;1976;Rotten;43;40;9;12;21;4
The Last Unicorn;1982;Fresh;71;86;15;6;21;4
Last Vegas;2013;Rotten;46;59;67;79;146;37
The Last Voyage;1960;Fresh;60;60;3;2;5;0
The Last Wave;1977;Fresh;81;79;13;3;16;1
Last Weekend;2014;Rotten;38;35;8;13;21;11
The Last Winter;2007;Certified-Fresh;76;34;39;12;51;18
Last Year at Marienbad (L'annee derniere a Marienbad);1961;Certified-Fresh;94;85;48;3;51;13
L'Atalante;1934;Fresh;100;89;35;0;35;12
Late Bloomers;1997;Rotten;20;54;1;4;5;0
Late for Dinner;1991;Rotten;58;66;7;5;12;3
Late Marriage;2002;Certified-Fresh;88;79;56;8;64;23
Late Phases;2014;Fresh;63;44;12;7;19;5
The Late Show;1977;Fresh;95;79;18;1;19;2
Latter Days;2004;Rotten;46;79;22;26;48;18
Laugh Killer Laugh;2015;Rotten;33;29;2;4;6;3
Laura Smiles;2006;Rotten;47;54;7;8;15;10
Laurel Canyon;2003;Fresh;68;52;75;35;110;32
Laurence Anyways;2013;Certified-Fresh;84;79;52;10;62;21
Lavender;2017;Rotten;36;27;8;14;22;7
The Lavender Hill Mob;1951;Fresh;100;87;30;0;30;4
L'Avventura;1960;Certified-Fresh;94;88;44;3;47;10
Law Abiding Citizen;2009;Rotten;26;75;41;119;160;39
Law of Desire;1987;Fresh;100;82;13;0;13;3
Lawless;2012;Fresh;66;74;144;73;217;49
Lawless Heart;2002;Certified-Fresh;87;58;46;7;53;27
Lawman;1971;Fresh;63;61;5;3;8;1
The Lawnmower Man;1992;Rotten;34;31;14;27;41;6
Lawnmower Man 2 - Jobe's War (Lawnmower Man 2: Beyond Cyberspace);1996;Rotten;11;12;1;8;9;3
Lawrence of Arabia;1962;Certified-Fresh;98;93;86;2;88;23
Laws of Attraction;2004;Rotten;18;47;27;121;148;42
Lay the Favorite;2012;Rotten;18;19;9;42;51;22
Layer Cake;2005;Certified-Fresh;80;84;113;28;141;35
The Lazarus Project;2008;Fresh;60;45;3;2;5;0
Lazer Team;2016;Fresh;60;69;21;14;35;12
Lazy Eye;2016;Fresh;67;42;8;4;12;6
Lazy Susan;2020;Rotten;10;47;1;9;10;6
LBJ;2017;Rotten;58;54;49;36;85;26
Change of Plans (Le Code a Change);2010;Rotten;50;33;8;8;16;9
The Decline of the American Empire (Le Declin de l'Empire Americain);1986;Fresh;86;82;12;2;14;1
Le Feu follet (A Time to Live and a Time to Die) (The Fire Within);1963;Fresh;82;90;9;2;11;5
Salt of This Sea (Milh Hadha al-Bahr);2010;Rotten;54;64;7;6;13;4
Le amiche;1955;Fresh;100;82;16;0;15;6
Le Cercle Rouge;1970;Certified-Fresh;95;92;58;3;61;22
Le Deuxieme souffle (Second Breath);1966;;;67;10;0;;3
Le Doulos;1962;Fresh;97;91;28;1;29;13
Le Havre;2011;Certified-Fresh;99;75;94;1;95;38
Le Jour se leve (Daybreak);1900;Fresh;92;89;22;2;24;11
Le Mans;1971;Fresh;67;80;8;4;12;2
Le nom des gens (The Names of Love);2011;Certified-Fresh;72;78;38;15;53;27
Le passe (The Past);2013;Certified-Fresh;93;83;143;11;154;43
Le Petit Lieutenant;2006;Certified-Fresh;78;64;43;12;55;25
Le samourai;1900;Fresh;100;94;31;0;31;9
Le Week-End;2014;Certified-Fresh;89;56;137;17;154;41
The League of Extraordinary Gentlemen;2003;Rotten;17;44;32;152;184;42
A League of Their Own;1992;Certified-Fresh;78;84;54;15;69;20
Lean on Me;1989;Fresh;69;85;11;5;16;2
Lean on Pete;2018;Certified-Fresh;90;74;169;18;187;40
Leap!;2017;Rotten;42;62;26;36;62;20
Leap Year;2010;Rotten;23;47;32;107;139;37
Leap Year (Ano bisiesto);2011;Fresh;92;56;24;2;26;13
Learning To Drive;2015;Fresh;65;58;64;34;98;28
Least Among Saints;2012;Rotten;36;87;4;7;11;4
Leatherface;2017;Rotten;30;24;13;31;44;10
Leatherface: The Texas Chainsaw Massacre III;;Rotten;19;31;3;13;16;1
Leatherheads;2008;Rotten;51;38;87;82;169;38
Leave Her to Heaven;1945;Fresh;92;86;24;2;26;10
Leave it on the Floor;2013;Fresh;70;68;7;3;10;3
Leave It to Beaver;1997;Rotten;21;31;6;22;28;10
Leave No Trace;2018;Certified-Fresh;100;81;234;0;234;47
Leave The World Behind;2014;Fresh;75;82;6;2;8;3
Leaving Home, Coming Home: A Portrait of Robert Frank;2019;Fresh;90;;9;1;10;4
Leaving Las Vegas;1995;Certified-Fresh;91;85;48;5;53;13
Lebanon (Levanon);2010;Certified-Fresh;90;72;99;11;110;30
Lebanon, Pa.;2011;Rotten;50;47;8;8;16;10
L'Eclisse;1962;Fresh;90;89;26;3;29;9
Lee Daniels' The Butler;2013;Fresh;72;78;141;56;197;53
Left Behind;2014;Rotten;1;38;1;67;68;20
Left Behind: The Movie;2001;Rotten;16;56;7;38;45;14
Left on Purpose;2017;Fresh;88;100;7;1;8;4
Legacy: Black Ops;1900;Fresh;86;42;6;1;7;1
Legacy of Lies;1900;Fresh;86;60;6;1;7;1
Legal Eagles;1986;Rotten;44;32;7;9;16;2
Legally Blonde;2001;Fresh;70;72;103;44;147;36
Legally Blonde 2 - Red, White & Blonde;2003;Rotten;37;43;58;99;157;40
Legend;2015;Fresh;61;59;104;66;170;39
The Legend of 1900 (La leggenda del pianista sull'oceano);1999;Rotten;54;92;22;19;41;11
The Legend of Bagger Vance;2000;Rotten;43;65;56;74;130;35
The Legend of Billie Jean;1985;Rotten;45;75;5;6;11;1
The Legend of Drunken Master (Jui kuen II) (Drunken Fist II);1900;Certified-Fresh;83;88;65;13;78;26
The Legend of Hell House;1973;Fresh;62;56;13;8;21;3
The Legend of Johnny Lingo;1900;Rotten;13;71;2;13;15;3
Die Stille nach dem Schuss (The Legend of Rita) (The Legends of Rita);2000;Fresh;80;75;12;3;15;4
Legend Of The Demon Cat (Kukai);2019;Fresh;91;38;10;1;11;4
Legend of the Fist: The Return of Chen Zhen;2011;Rotten;47;53;17;19;36;10
Legend of the Guardians: The Owls of Ga'Hoole;2010;Rotten;52;63;68;64;132;27
Legend of the Mountain;2001;Fresh;100;;11;0;11;3
The Legend of Zorro;1900;Rotten;26;48;36;101;137;33
Legendary;2010;Rotten;18;59;8;36;44;20
Legends of Oz: Dorothy's Return;2014;Rotten;16;68;10;51;61;20
Legends of the Fall;1994;Rotten;58;87;33;24;57;19
Legion;2010;Rotten;19;31;20;85;105;20
Legion of Brothers;2017;Fresh;100;66;7;0;7;6
Legionnaire;1998;Rotten;29;30;2;5;7;1
Lemony Snicket's A Series of Unfortunate Events;2004;Fresh;72;63;116;46;162;39
Lemora - A Child's Tale of the Supernatural;1900;Fresh;86;58;6;1;7;0
Len and Company;2016;Fresh;70;54;7;3;10;5
L'Enfant;2006;Certified-Fresh;85;72;96;17;113;36
Sister;2012;Certified-Fresh;96;75;67;3;70;27
L'Enfer d'Henri-Georges Clouzot (Henri-George Clouzot's Inferno);2010;Fresh;100;82;32;0;32;14
Lenny;1974;Fresh;88;88;22;3;25;1
Leon: The Professional;1994;Certified-Fresh;74;95;48;17;65;18
Leonard Part 6;1987;Rotten;9;20;1;10;11;0
Leonard Cohen: I'm Your Man;1900;Fresh;69;60;52;23;75;34
Leonie;2013;Rotten;42;52;5;7;12;7
Leprechaun;1993;Rotten;21;32;3;11;14;1
Leprechaun in the Hood;2000;Rotten;30;32;3;7;10;0
Leprechaun 2;1994;Rotten;0;29;0;16;16;1
Leprechaun 3;1900;Rotten;0;34;0;5;5;0
Leprechaun 4: In Space;1997;Rotten;14;21;1;6;7;0
Leprechaun: Back 2 tha Hood;2003;Rotten;22;31;2;7;9;0
Leprechaun: Origins;2014;Rotten;0;10;0;7;7;1
Leprechaun Returns;2018;Rotten;44;48;4;5;9;0
Leroy & Stitch;1900;Rotten;40;53;2;3;5;0
Les Plages d'Agnes (The Beaches of Agnes);2008;Certified-Fresh;96;89;69;3;72;31
Heartbeats;2011;Certified-Fresh;73;71;53;20;73;27
The Adventures of Pinocchio (Les aventures de Pinocchio);1996;Rotten;36;26;9;16;25;11
Les femmes de l'ombre;2008;Fresh;75;71;6;2;8;1
Les femmes du 6e etage (The Women on the 6th Floor);2011;Fresh;67;67;45;22;67;26
Les Girls;1957;Fresh;100;71;8;0;8;2
Les Miserables;2012;Fresh;69;79;177;78;255;49
Lesbian Vampire Killers;2009;Rotten;28;32;7;18;25;3
Leslie Jones: Time Machine;2020;Fresh;100;27;6;0;6;2
Less Than Zero;1987;Rotten;50;63;13;13;26;3
Lessons of Darkness;1995;Fresh;100;92;10;0;10;0
Let Fury Have The Hour;2012;Rotten;42;70;5;7;12;9
Let Him Have It;1991;Fresh;84;86;31;6;37;15
Let it Rain (Parlez-moi de la pluie);2010;Certified-Fresh;76;42;38;12;50;22
Let It Ride;1989;Rotten;27;75;3;8;11;0
Let It Snow;1900;Fresh;81;45;21;5;26;2
Let Me In;2010;Certified-Fresh;88;76;208;28;236;48
Let My People Go!;2013;Rotten;33;34;5;10;15;10
Let the Bullets Fly;2012;Fresh;76;71;25;8;33;17
Let the Devil Wear Black;1999;Rotten;57;27;4;3;7;0
Let The Fire Burn;2013;Certified-Fresh;98;90;44;1;45;21
Let the Right One In;2008;Certified-Fresh;98;90;186;4;190;46
Let the Sunshine In (Un beau soleil interieur);2018;Certified-Fresh;86;31;121;19;140;37
Let There Be Light;2017;Rotten;30;74;3;7;10;4
Let Us Prey;1900;Fresh;83;43;10;2;12;0
Lethal Weapon;1987;Certified-Fresh;81;86;46;11;57;15
Lethal Weapon 2;1989;Certified-Fresh;82;77;37;8;45;7
Lethal Weapon 3;1992;Fresh;60;61;29;19;48;10
Lethal Weapon 4;1998;Rotten;54;64;37;32;69;13
Let's Be Cops;2014;Rotten;18;51;15;67;82;19
Let's Be Evil;2016;Rotten;15;16;2;11;13;4
Let's Do It Again;1975;Fresh;63;87;5;3;8;1
Let's Get Lost;1989;Fresh;96;87;27;1;28;16
Let's Go to Prison;2006;Rotten;12;48;5;36;41;14
Let's Kill Ward's Wife;2015;Rotten;17;29;1;5;6;3
Let's Make Love;1960;Fresh;69;60;11;5;16;0
Let's Scare Jessica to Death;1971;Rotten;30;50;3;7;10;1
Let's Talk About Sex;1998;Rotten;13;30;2;13;15;3
Letter From an Unknown Woman;1948;Fresh;100;86;23;0;23;5
A Letter to Three Wives;1949;Fresh;94;86;17;1;18;2
Letters From Baghdad;2017;Fresh;84;64;32;6;38;16
Letters from Iwo Jima;2006;Certified-Fresh;91;86;184;18;202;53
Letters To God;2010;Rotten;26;75;6;17;23;3
Letters to Juliet;2010;Rotten;42;62;66;92;158;43
Levantando a papa;2007;Rotten;23;13;3;10;13;2
Level 16;2019;Fresh;82;66;18;4;22;3
Level Five;2014;Fresh;94;52;17;1;18;5
Leviathan;2014;Certified-Fresh;98;80;146;3;149;45
Leviathan;1989;Rotten;24;26;6;19;25;2
Leviathan;2013;Certified-Fresh;83;54;43;9;52;19
Levitated Mass: The Story of Michael Heizer's Monolithic Sculpture;2014;Fresh;100;75;6;0;6;2
Lez Bomb;2018;Fresh;89;67;8;1;9;2
L!fe Happens;2012;Rotten;26;30;8;23;31;16
LFO: The Movie;1900;Fresh;100;67;6;0;6;0
Liam Gallagher: As It Was;1900;Fresh;60;66;18;12;30;8
Lianna;1983;Fresh;82;64;14;3;17;0
Libeled Lady;1936;Fresh;86;88;12;2;14;0
Liberal Arts;2012;Fresh;71;60;81;33;114;33
The Libertine;2006;Rotten;33;58;41;82;123;37
Liberty Heights;1999;Certified-Fresh;85;76;41;7;48;13
Liberty Kid;2008;Fresh;88;73;15;2;17;8
Liberty Stands Still;2002;Rotten;20;36;1;4;5;1
The Librarian: Quest for the Spear;2004;Fresh;60;57;3;2;5;0
Licence To Kill;1989;Certified-Fresh;78;61;45;13;58;14
License to Drive;1988;Rotten;17;61;3;15;18;4
The Lickerish Quartet;1970;Fresh;67;57;6;3;9;1
Lies & Alibis;2006;Rotten;57;54;4;3;7;1
Life of Pi;2012;Certified-Fresh;87;84;218;33;251;54
Life;2015;Fresh;64;44;39;22;61;17
Life;2017;Fresh;67;54;170;83;252;50
Life 2;2011;Fresh;89;55;8;1;9;5
Life, Above All;2011;Certified-Fresh;82;82;61;13;74;31
Life After Beth;2014;Rotten;44;30;42;53;95;33
Life After Flash;1900;Fresh;88;87;7;1;8;0
The Life and Death of Colonel Blimp;1943;Fresh;96;91;26;1;27;6
The Life and Times of Judge Roy Bean;1972;Fresh;80;75;8;2;10;1
Life, Animated;2016;Certified-Fresh;94;81;109;7;116;34
The Life Aquatic with Steve Zissou;2004;Rotten;56;82;125;98;223;53
Life as a House;2001;Rotten;47;88;49;56;105;32
The Life Before Her Eyes;2007;Rotten;23;51;22;73;95;33
Life During Wartime;1997;Rotten;56;15;9;7;16;4
Life in a... Metro;2007;Rotten;40;78;2;3;5;2
Life Inside Out;2014;Fresh;67;86;6;3;9;5
Life Is Hot in Cracktown;2009;Rotten;50;54;3;3;6;1
Life Itself;2014;Certified-Fresh;98;88;195;5;200;52
A Life Less Ordinary;1997;Rotten;41;59;15;22;37;9
Life of a King;2014;Rotten;43;65;6;8;14;5
Life Of Crime;2014;Fresh;68;37;54;26;80;32
The Life of David Gale;2003;Rotten;19;81;30;127;157;38
The Life of Emile Zola;1937;Fresh;82;73;27;6;33;9
Life of Riley;2014;Fresh;76;44;22;7;29;11
Life of the Party;2018;Rotten;38;39;57;94;151;35
Life on the Line;2016;Rotten;0;35;0;15;15;8
Life or Something Like It;2002;Rotten;28;44;34;88;122;32
Life Overtakes Me;1900;Fresh;100;75;5;0;5;0
Life Partners;2014;Fresh;67;46;24;12;36;11
Life Stinks;1991;Rotten;18;45;3;14;17;1
Life Tracker;2013;Fresh;100;60;6;0;6;1
Life With Father;1947;Fresh;92;78;11;1;12;2
Life with Mikey;1993;Rotten;25;40;3;9;12;2
Lifeboat;1944;Fresh;92;87;24;2;26;4
Lifechanger;2018;Fresh;86;59;19;3;22;1
Lifeforce;1985;Rotten;58;45;15;11;26;0
Lifeguard;1976;Rotten;40;73;2;3;5;1
Life's a Breeze;2014;Rotten;53;40;8;7;15;6
At the Edge of the World;2009;Fresh;87;48;13;2;15;8
Light It Up;1999;Rotten;39;75;19;30;49;19
Light of My life;2019;Certified-Fresh;81;74;44;10;54;13
Light Sleeper;1992;Fresh;87;64;33;5;38;14
Lightning Bug;2004;Rotten;38;64;3;5;8;0
Lightning Over Water;1980;Fresh;67;70;6;3;9;2
Lights Out;2016;Certified-Fresh;76;61;133;43;176;37
Like Dandelion Dust;2010;Fresh;82;76;14;3;17;5
Like a Boss;2020;;;;32;116;;27
Like Crazy;2011;Certified-Fresh;72;61;111;44;155;47
Like Father;2018;Rotten;46;46;19;22;41;16
Like Father, Like Son;2014;Certified-Fresh;87;89;88;13;101;40
Like Me;2018;Fresh;70;54;19;8;27;7
Like Mike;2002;Rotten;57;52;55;42;97;32
Like Minds (Murderous Intent);2006;Rotten;38;63;3;5;8;6
Like Someone in Love;2013;Certified-Fresh;83;60;85;17;102;39
Like Stars on Earth;2007;Fresh;91;96;10;1;11;4
Like Sunday, Like Rain;2015;Rotten;50;65;9;9;18;6
Like Water for Chocolate (Como Agua para Chocolate);1992;Certified-Fresh;87;84;40;6;46;10
Li'l Quinquin;1900;Fresh;100;79;22;0;22;10
Lila & Eve;2015;Rotten;40;41;16;24;40;15
Lila, Lila;2014;Fresh;60;64;3;2;5;3
Lila Says;2005;Fresh;68;77;27;13;40;14
Lili;1953;Fresh;100;81;7;0;7;0
Lilith;1964;Fresh;86;66;6;1;7;1
Lilo & Stitch;2002;Certified-Fresh;86;77;127;21;148;35
Lilo & Stitch 2: Stitch Has a Glitch;2005;Rotten;40;56;4;6;10;0
Lilting;2014;Certified-Fresh;84;80;46;9;55;21
Limbo;1999;Fresh;72;69;28;11;39;6
Limelight;1952;Fresh;97;90;33;1;34;7
Limelight;2011;Fresh;67;64;14;7;21;12
The Limey;1900;Certified-Fresh;92;78;76;7;83;25
Limitless;2011;Fresh;69;74;139;62;201;44
The Limits of Control;2009;Rotten;42;43;54;74;128;43
Lincoln;2012;Certified-Fresh;89;81;251;32;282;55
The Lincoln Lawyer;2011;Certified-Fresh;83;82;146;29;175;44
Linda Ronstadt: The Sound of My Voice;2019;Certified-Fresh;89;99;81;10;91;16
Line of Duty;2019;Rotten;59;39;10;7;17;5
Linsanity;2013;Fresh;64;77;16;9;25;11
Lion;2016;Certified-Fresh;84;91;223;41;264;49
The Lion King 1 1/2;2004;Fresh;78;62;14;4;18;1
Lion of the Desert (Omar Mukhtar);1981;Fresh;71;93;5;2;7;1
Lionheart;1991;Rotten;31;52;5;11;16;4
Lions for Lambs;2007;Rotten;27;47;50;134;184;51
Lipstick;1976;Rotten;11;37;1;8;9;1
Lipstick & Dynamite: The First Ladies of Wrestling;2004;Fresh;63;57;24;14;38;17
Listen Up Philip;2014;Certified-Fresh;82;54;109;24;133;40
Listening;2015;Rotten;17;42;2;10;12;6
Literally, Right Before Aaron;2017;Rotten;25;48;5;15;20;8
Little Fauss and Big Halsy;1970;Rotten;33;46;2;4;6;4
Little;2019;Rotten;46;60;73;84;157;36
Little Accidents;2015;Rotten;54;29;21;18;39;13
Little Ashes;2009;Rotten;24;49;17;53;70;30
Little Big League;1994;Rotten;31;53;5;11;16;3
Little Big Man;1970;Fresh;96;87;25;1;26;2
Little Big Soldier (Da bing xiao jiang);2011;Fresh;79;69;11;3;14;6
Little Birds;2012;Rotten;59;42;13;9;22;12
Little Black Book;2004;Rotten;22;37;24;87;111;34
Little Boy;2015;Rotten;24;78;13;41;54;21
Little Boy Blue;1998;Rotten;25;70;2;6;8;0
Little Buddha;1994;Fresh;68;53;17;8;25;10
Little Caesar;1931;Fresh;92;75;22;2;24;6
Little Children;2006;Certified-Fresh;80;82;129;33;162;48
Little Dieter Needs to Fly: Escape from Laos;1998;Fresh;93;94;13;1;14;4
Little Evil;2017;Fresh;92;47;11;1;12;0
Little Fockers;2010;Rotten;9;34;14;137;151;42
The Little Foxes;1941;Fresh;100;88;15;0;15;0
Little Fugitive;1953;Fresh;93;88;14;1;15;4
Little Giants;1994;Rotten;36;63;4;7;11;1
The Little Girl Who Lives Down the Lane;1976;Fresh;91;75;11;1;11;2
Little Italy;2018;Rotten;14;59;3;19;22;3
Little Jerusalem;2006;Fresh;63;67;17;10;27;15
Little Joe;2019;Fresh;68;42;78;37;115;23
Little Man;2006;Rotten;12;55;11;79;90;28
Little Man;2005;Fresh;60;80;9;6;15;7
Little Man Tate;1991;Fresh;73;66;19;7;26;4
Little Manhattan;2005;Fresh;77;86;24;7;31;9
Little Men;1998;Rotten;14;79;1;6;7;3
Little Men;2016;Certified-Fresh;97;63;138;5;143;38
The Little Mermaid: Ariel's Beginning;2008;Rotten;33;56;2;4;6;0
Little Miss Sunshine;2006;Certified-Fresh;91;91;198;20;218;54
Little Monsters;1989;Rotten;44;62;4;5;9;1
Little Monsters;2019;Certified-Fresh;80;100;102;26;128;15
Little Nicky;2000;Rotten;22;56;25;90;115;30
Little Nikita;1988;Rotten;54;45;7;6;13;5
Little Odessa;1995;Fresh;61;70;11;7;18;4
Little Pink House;2018;Fresh;76;80;22;7;29;10
Little Red Wagon;2012;Rotten;45;61;5;6;11;2
Little Secrets;2002;Fresh;60;58;29;19;48;17
Little Sister;2016;Fresh;94;56;32;2;34;10
The Little Vampire;2000;Rotten;55;55;36;30;66;23
Little Voice;1998;Certified-Fresh;79;74;38;10;48;12
Little White Lie;2014;Fresh;80;80;4;1;5;3
Little White Lies;2012;Rotten;42;64;30;41;71;31
Little Women;2018;Rotten;30;70;8;19;27;8
Little Woods;2019;Certified-Fresh;95;53;91;5;96;18
Littlerock;2011;Fresh;82;71;23;5;28;11
The Littlest Rebel;1935;Fresh;89;71;8;1;9;0
Live and Let Die;1973;Fresh;66;64;33;17;50;8
Live At The Foxes Den;2013;Rotten;0;74;0;5;5;4
Live By Night;2017;Rotten;35;41;82;155;236;47
Live Die Repeat: Edge of Tomorrow;2014;Certified-Fresh;91;90;293;30;323;63
Live Flesh (Carne tremula);1998;Certified-Fresh;81;87;34;8;42;12
Live Forever (Live Forever: The Rise and Fall of Brit Pop);2003;Fresh;80;83;4;1;5;1
Live Free or Die Hard;2007;Certified-Fresh;82;86;171;38;209;52
Live-In Maid;2007;Fresh;100;75;33;0;33;18
Live Nude Girls;1995;Rotten;38;39;3;5;8;1
Live Nude Girls Unite!;2000;Fresh;82;63;14;3;17;4
Live Twice, Love Once (Vivir dos veces);1900;Rotten;50;72;4;4;8;0
Living Among Us;2018;Rotten;14;74;1;6;7;2
The Living Daylights;1987;Fresh;73;66;40;15;55;15
Living in Emergency: Stories of Doctors Without Borders;2010;Fresh;93;79;25;2;27;17
Living in Oblivion;1995;Fresh;88;87;28;4;32;6
Living Is Easy With Eyes Closed;2014;Fresh;94;77;15;1;16;7
Living Out Loud;1998;Rotten;59;63;20;14;34;8
The Living Wake;2010;Rotten;47;71;8;9;17;8
Liyana;2018;Fresh;97;74;35;1;36;6
Liz & Dick;2012;Rotten;33;19;2;4;6;4
Lizzie;2018;Fresh;66;48;99;50;149;30
Lizzie Borden Took an Ax;1900;Rotten;40;34;6;9;15;6
The Lizzie McGuire Movie;2003;Rotten;41;49;42;61;103;32
Lloyd The Conqueror;1900;Fresh;80;46;4;1;5;1
Lo and Behold, Reveries of the Connected World;2016;Certified-Fresh;93;67;131;10;141;32
Local Color;2006;Rotten;35;58;6;11;17;8
Local Hero;1983;Fresh;100;87;35;0;35;8
Lock, Stock and Two Smoking Barrels;1999;Certified-Fresh;75;93;49;16;65;19
Locke;2014;Certified-Fresh;91;72;195;20;215;55
Locker 13;2014;Rotten;13;53;1;7;8;4
Lockout;2012;Rotten;38;46;52;86;138;37
Loco Love;2003;Rotten;20;30;1;4;5;2
The Locusts;1997;Rotten;18;44;2;9;11;4
Logan;2017;Certified-Fresh;93;90;386;28;414;60
Logan Lucky;2017;Certified-Fresh;92;76;259;23;282;49
Logan's Run;1976;Fresh;62;67;21;13;34;4
Loggerheads;2005;Certified-Fresh;73;65;35;13;48;19
Loins of Punjab Presents;2007;Fresh;64;72;7;4;11;5
Loitering With Intent;2015;Rotten;33;26;9;18;27;10
LOL;2006;Fresh;100;33;11;0;11;3
LOL;2012;Rotten;17;51;1;5;6;1
Lola Versus;2012;Rotten;36;31;30;53;83;34
London Boulevard;2011;Rotten;38;30;18;30;48;16
London mon amour (Mes amis, mes amours);2008;Fresh;63;41;5;3;8;1
London Fields;2018;Rotten;0;48;0;35;35;10
London Has Fallen;2016;Rotten;28;51;54;142;196;38
London River;2011;Fresh;91;67;30;3;33;12
London: The Modern Babylon;2013;Fresh;89;82;8;1;9;5
London Town;2016;Rotten;53;68;9;8;17;7
London's Finest (Hackney's Finest);1900;Rotten;40;33;2;3;5;2
The Lone Ranger and the Lost City of Gold;1958;Fresh;60;71;3;2;5;0
Lone Survivor;2014;Certified-Fresh;75;87;167;57;224;48
Lone Wolf and Cub - Baby Cart at the River Styx;1972;Fresh;100;91;7;0;7;1
Lone Wolf and Cub - Sword of Vengeance;1972;Fresh;83;90;10;2;12;2
Lone Wolf McQuade;1983;Rotten;57;66;4;3;7;2
The Loneliness of the Long Distance Runner;1962;Fresh;73;87;16;6;22;6
Lonely are the Brave;1962;Fresh;93;85;13;1;14;1
The Lonely Guy;1984;Rotten;48;47;10;11;21;4
Lonely Hearts;2006;Rotten;47;49;20;23;43;16
Lonesome Jim;2006;Fresh;60;57;54;36;90;29
Long Weekend (Nature's Grave);2008;Rotten;0;15;0;6;6;0
The Long Gray Line;1955;Fresh;100;76;9;0;9;2
The Long Kiss Goodnight;1996;Fresh;70;70;39;17;56;16
Long Life, Happiness & Prosperity;2004;Rotten;29;62;2;5;7;2
The Long, Long Trailer;1900;Rotten;38;77;3;5;8;0
Long Lost;2019;Fresh;75;77;9;3;12;2
The Long Riders;1980;Fresh;83;74;20;4;24;4
The Long Ships;1964;Rotten;50;39;6;6;12;4
Long Shot;2019;Certified-Fresh;81;74;238;56;293;46
Long Shot The Kevin Laue Story;2012;Fresh;67;90;4;2;6;5
Long Time Coming: A 1955 Baseball Story;2018;Fresh;71;67;5;2;7;0
Long Way North (Tout en haut du monde);2016;Certified-Fresh;98;76;53;1;54;15
Long Weekend;1979;Fresh;88;67;7;1;8;0
The Longest Day;1962;Fresh;87;90;20;3;23;3
The Longest Yard;2005;Rotten;31;62;53;116;169;40
Longing;2018;Fresh;75;;6;2;8;2
The Longshots;2008;Rotten;41;61;29;42;71;23
Look at Us Now, Mother!;2016;Fresh;80;94;8;2;10;5
Look Away;2018;Rotten;17;53;2;10;12;1
Look Who's Talking;1989;Rotten;56;47;20;16;36;9
Look Who's Talking Now;1993;Rotten;0;29;0;26;26;7
Look Who's Talking, Too;;Rotten;13;32;2;13;15;1
Looker;1981;Rotten;29;42;6;15;21;3
Lookin' to Get Out;1982;Rotten;31;29;4;9;13;5
Looking for an Echo;1998;Fresh;67;71;4;2;6;2
Looking for Comedy in the Muslim World;2006;Rotten;42;27;46;63;109;33
Looking for Eric;2010;Certified-Fresh;85;78;84;15;99;31
Looking for Palladin;2008;Rotten;22;33;2;7;9;6
Looking for Richard;1996;Certified-Fresh;81;79;39;9;48;14
Looking Glass;2018;Rotten;21;10;5;19;24;8
The Lookout;2007;Certified-Fresh;87;74;146;21;167;42
Looney Tunes: Back in Action;2003;Rotten;56;50;77;61;138;34
Looper;2012;Certified-Fresh;93;82;248;19;267;59
Loopers: The Caddie's Long Walk;2019;Fresh;75;86;9;3;12;5
Loose Cannons;;Rotten;0;26;0;17;17;7
Loosies;2012;Rotten;22;34;4;14;18;8
Loot;2009;Fresh;60;73;6;4;10;5
Lootera;2013;Fresh;60;78;3;2;5;1
L' Ora di Religione (Il Sorriso di Mia Madre) (The Religion Hour) (My Mother's Smile);2002;Fresh;84;80;21;4;25;12
Lord Byron;2011;Fresh;71;33;5;2;7;2
Lord Jim;1965;Rotten;57;57;8;6;14;4
Lord of Illusions;1995;Fresh;60;52;15;10;25;2
Lord of the Flies;1989;Fresh;60;52;12;8;20;1
Lord of the Flies;1963;Fresh;91;63;20;2;22;0
The Lord of the Rings;1978;Rotten;52;64;22;20;42;8
Lord of War;2005;Fresh;61;84;90;57;147;39
Lords of Chaos;2019;Fresh;72;61;54;21;75;14
The Lords of Discipline;1983;Rotten;38;56;3;5;8;0
Lords of Dogtown;2005;Rotten;55;81;80;66;146;34
The Lords of Flatbush;1974;Fresh;64;42;9;5;14;4
Lore;2013;Certified-Fresh;94;76;108;7;115;32
Lorenzo's Oil;1992;Fresh;92;80;36;3;39;10
Lorna's Silence;2008;Certified-Fresh;86;69;83;14;97;33
Loro;2019;Certified-Fresh;79;59;59;16;75;18
Los Angeles Plays Itself;2003;Certified-Fresh;96;85;43;2;45;22
Los ojos de Julia (Julia's Eyes);1900;Certified-Fresh;90;68;36;4;40;9
Losing Control;2012;Rotten;7;55;1;13;14;8
Losing Isaiah;1995;Rotten;45;73;13;16;29;10
The Loss of a Teardrop Diamond;2009;Rotten;27;40;11;30;41;14
Lost For Words;2013;Rotten;33;54;2;4;6;3
Lost and Delirious;2001;Rotten;51;78;30;29;59;22
Lost & Found;2019;Fresh;73;33;11;4;15;4
Lost Angels: Skid Row Is My Home;2012;Fresh;100;85;7;0;7;3
The Lost Boys;1987;Certified-Fresh;76;85;51;16;67;12
Lost Boys of Sudan;2004;Certified-Fresh;95;83;42;2;44;22
Lost Boys: The Thirst;1900;Rotten;0;34;0;7;7;0
Lost Boys: The Tribe;2008;Rotten;0;25;0;7;7;0
Lost Child;2018;Rotten;55;75;6;5;11;2
Lost Girls;2020;Fresh;72;52;36;14;50;13
Lost Highway;1997;Fresh;61;87;27;17;44;7
Lost Horizon;1937;Fresh;93;83;13;1;14;1
Lost in America;1985;Fresh;97;77;33;1;34;3
Lost in America;2020;Fresh;100;100;7;0;7;5
Lost in Hong Kong;2015;Fresh;60;49;3;2;5;2
Lost in La Mancha;2003;Certified-Fresh;94;77;95;6;101;27
Lost in Paris (Paris pieds nus);2017;Certified-Fresh;87;67;52;8;60;15
Lost in Space;1998;Rotten;28;24;23;60;83;20
Lost In Thailand;2013;Fresh;67;49;4;2;6;4
Lost in the Sun;2015;Rotten;20;37;2;8;10;3
Lost In Translation;2003;Certified-Fresh;95;85;221;12;233;46
Lost in Yonkers;1993;Fresh;71;78;12;5;17;3
Lost River;2015;Rotten;31;38;22;50;72;21
The Lost Skeleton of Cadavra;2004;Rotten;53;85;37;33;70;19
Lost Soul: The Doomed Journey of Richard Stanley's Island of Dr. Moreau;1900;Fresh;100;87;8;0;8;2
Lost Transmissions;2020;Rotten;54;50;15;13;28;6
The Lost Weekend;1945;Fresh;97;90;38;1;39;9
The Lost World - Jurassic Park;1997;Rotten;53;51;41;37;78;16
A Lot Like Love;2005;Rotten;41;77;51;74;125;37
Lou Andreas-Salome: The Audacity to Be Free;2018;Fresh;67;;10;5;15;5
Louder Than A Bomb;2011;Fresh;100;81;26;0;26;11
Louder Than Bombs;2016;Fresh;73;52;93;35;128;33
Louder Than Words;2014;Rotten;13;;2;13;15;9
Loudmouth Soup;2005;Rotten;17;;1;5;6;5
LoudQUIETloud: A Film About the Pixies;2006;Fresh;68;77;15;7;22;8
Louie Bluie;1985;Fresh;100;89;6;0;6;1
Louis C.K.: 2017;1900;Certified-Fresh;95;75;19;1;20;10
Louise Bourgeois: The Spider, the Mistress and the Tangerine;2008;Fresh;88;77;14;2;16;11
Louisiana Story;1948;Fresh;80;55;12;3;15;4
Loulou;1980;Fresh;86;74;6;1;7;1
Love and Other Drugs;2010;Rotten;49;53;81;86;167;47
Love, Sex & Eating the Bones;2004;Rotten;57;46;4;3;7;2
Love;2015;Rotten;39;38;36;56;92;29
Love Aaj Kal;1900;Rotten;21;29;3;11;14;1
Love Actually;2003;Fresh;64;72;141;79;220;53
Love Affair;1939;Fresh;86;71;6;1;7;0
Love Affair;1994;Rotten;30;68;8;19;27;5
Love After Love;2018;Fresh;86;40;24;4;28;11
Love and a .45;1994;Fresh;83;70;5;1;6;0
Love and Basketball;2000;Certified-Fresh;83;95;77;16;93;34
Love and Death;1975;Fresh;100;90;21;0;21;3
Love and Death on Long Island;1998;Fresh;87;58;33;5;38;8
Love & Debt;1900;Fresh;89;;8;1;9;0
Love & Friendship;2016;Certified-Fresh;97;60;201;7;208;48
Love And Honor;2013;Rotten;13;39;2;13;15;8
Love & Mercy;2015;Certified-Fresh;89;85;193;23;216;51
Love and Other Catastrophes;1997;Rotten;47;71;7;8;15;5
Love and Saucers;1900;Fresh;83;82;10;2;12;1
Love & Sex;2000;Rotten;47;76;23;26;49;13
Love at First Child (Ange et Gabrielle);1900;Rotten;57;36;4;3;7;0
Love at First Fight;2015;Fresh;82;66;27;7;33;16
Love Beats Rhymes;2017;Rotten;44;68;4;5;9;6
Love Crazy;1941;Fresh;100;82;9;0;9;0
Love Crime;2011;Fresh;64;47;52;29;81;28
Love Don't Cost a Thing;2003;Rotten;13;65;9;63;72;25
Love Field;1992;Rotten;40;56;4;6;10;3
Love Free or Die;1900;Rotten;57;100;4;3;7;3
Love, Gilda;2018;Certified-Fresh;88;81;78;11;89;24
The Love Guru;2008;Rotten;14;33;24;152;176;49
Love Happens;2009;Rotten;16;37;18;92;110;34
Love Hunter;2014;Fresh;83;90;5;1;6;4
Love in the Afternoon;1957;Fresh;88;79;22;3;25;6
Love in the Time of Cholera;2007;Rotten;26;45;29;82;111;33
Love in the Time of Money;2002;Rotten;18;26;7;32;39;14
Love Is a Many Splendored Thing;1955;Rotten;53;57;8;7;15;4
Love Is All You Need;2013;Certified-Fresh;75;59;81;27;108;36
Love Is Blind;2019;Rotten;40;44;2;3;5;2
Love Is Colder Than Death;1969;Fresh;67;58;6;3;9;1
Love Is Strange;2014;Certified-Fresh;93;66;164;12;176;50
Love Is the Devil;1998;Fresh;68;62;13;6;19;4
Love Is the Drug (Addicted to Her Love);2006;Fresh;60;50;3;2;5;2
Love Is Thicker Than Water;1900;Rotten;43;;3;4;7;3
Love Jones;1997;Fresh;73;97;11;4;15;5
Love Liza;2002;Rotten;53;77;46;40;86;27
Love, Marilyn;2012;Fresh;65;58;15;8;23;13
Love Me if You Dare;2004;Rotten;44;89;35;44;79;27
Love Me Or Leave Me;1955;Fresh;67;74;4;2;6;0
Love Me Tender;1956;Rotten;55;65;6;5;11;1
Love N' Dancing;2008;Rotten;17;42;2;10;12;6
Love Potion No. 9;1992;Rotten;25;43;3;9;12;0
Love Ranch;2010;Rotten;13;28;7;45;52;23
Love, Rosie;2015;Rotten;32;63;18;38;56;19
Love Serenade;1997;Fresh;90;81;9;1;10;5
Love, Simon;2018;Certified-Fresh;91;88;209;20;229;42
Love Songs;2008;Fresh;61;78;35;22;57;21
Love Stinks;1999;Rotten;19;64;9;38;47;17
Love Story;1970;Fresh;68;75;17;8;25;5
Love Streams;1984;Fresh;100;89;16;0;16;4
Love the Beast;2009;Fresh;61;72;14;9;23;9
Love the Coopers;2015;Rotten;18;36;22;100;122;36
Love the Hard Way;2003;Rotten;28;66;12;31;43;21
Love Thy Nature;2016;Rotten;30;88;3;7;10;4
Love Wedding Marriage;2011;Rotten;0;28;0;19;19;13
Love Wedding Repeat;1900;Rotten;32;36;21;45;66;15
Love with the Proper Stranger;1963;Fresh;80;87;8;2;10;3
The Loved One;1965;Rotten;47;77;8;9;17;0
Lovelace;2013;Rotten;53;36;69;60;129;39
Loveless (Nelyubov);2018;Certified-Fresh;95;84;173;10;183;40
Lovely Molly;2012;Rotten;44;32;17;22;39;15
Lovely, Still;2010;Fresh;73;75;16;6;22;10
The Lover (L'amant);1992;Rotten;32;79;7;15;22;9
Lover Come Back;1961;Fresh;90;77;9;1;10;0
Loverboy;2006;Rotten;18;35;6;28;34;13
Loves Her Gun;2014;Fresh;75;54;6;2;8;4
Love's Kitchen;2011;Rotten;18;28;3;14;17;4
Love's Labour's Lost;2000;Rotten;49;40;33;34;67;20
Lovesick;2014;Rotten;29;21;4;10;14;4
Love Wrecked;1900;Rotten;14;48;1;6;7;0
Loving;2016;Certified-Fresh;89;76;256;33;289;56
Loving Pablo;2018;Rotten;31;35;15;33;48;10
Loving Vincent;2017;Certified-Fresh;85;86;134;24;158;29
Low Down;2014;Rotten;50;50;24;24;48;24
A Low Down Dirty Shame;1994;Rotten;0;71;0;22;22;8
Low Tide;2019;Fresh;72;65;23;9;32;8
Lower City (Cidade Baixa);2006;Fresh;60;57;33;22;55;22
Lowlife;2018;Fresh;91;67;32;3;35;7
Lu Over the Wall (Yoake tsugeru Ru no uta);2018;Certified-Fresh;78;66;35;10;45;11
Luce;2019;Certified-Fresh;90;77;143;16;159;32
Lucha Mexico;2016;Fresh;69;62;9;4;13;7
Lucia, Lucia;2003;Rotten;45;53;22;27;49;21
Luciferina;2018;Fresh;83;25;5;1;6;0
Luck by Chance;2009;Fresh;80;67;12;3;15;4
Lucky;2011;Rotten;23;30;3;10;13;7
Lucky Break;2002;Rotten;48;48;21;23;44;18
Lucky Day;2019;Rotten;10;45;1;9;10;5
Lucky Grandma;2020;Certified-Fresh;94;67;48;3;51;8
Lucky Number Slevin;2006;Rotten;52;87;80;75;155;45
Lucky Numbers;2000;Rotten;22;19;21;75;96;30
Lucky Stiff;1900;Rotten;40;55;2;3;5;3
Lucky Them;2014;Fresh;77;58;30;9;39;17
Lucky You;2007;Rotten;29;28;41;101;142;47
Lucy;2014;Fresh;67;47;158;78;236;51
Lucy in the Sky;2019;Rotten;21;31;26;97;123;30
Luis and The Aliens;2018;Rotten;24;56;4;13;17;4
Lullaby;2014;Rotten;30;55;9;21;30;13
Last Hunt;1956;Fresh;88;52;7;1;8;3
Lulu on the Bridge;1998;Rotten;0;54;0;8;8;1
Lumumba;2001;Certified-Fresh;81;83;48;11;59;23
Lunch;2012;Fresh;100;58;6;0;6;5
Lupin III: The Castle of Cagliostro (Rupan sansei: Kariosutoro no shiro);2000;Fresh;94;88;17;1;18;2
Lured;1947;Fresh;100;69;6;0;6;1
Lurking Fear;1994;Rotten;20;13;1;4;5;0
Lust, Caution;2007;Fresh;72;84;106;41;147;52
Lust in the Dust;1985;Rotten;33;80;3;6;9;2
Lust Stories;2018;Fresh;100;63;10;0;10;0
Lustre;2005;Fresh;100;;5;0;5;3
LUV;2013;Rotten;34;61;14;27;41;18
Lying and Stealing;2019;Fresh;62;16;8;5;13;5
Lyle;1900;Fresh;100;35;10;0;10;1
Lymelife;2008;Fresh;63;52;69;40;109;37
M. Butterfly;1993;Rotten;43;67;9;12;21;5
Ma;2017;Fresh;92;55;12;1;13;6
Ma;2019;Rotten;55;64;113;91;204;33
My Life in Pink (Ma Vie en Rose);1997;Fresh;91;90;21;2;23;6
MacGruber;2010;Rotten;48;35;73;79;152;31
Macao;1952;Rotten;44;59;4;5;9;3
MacArthur;1977;Rotten;50;60;5;5;10;0
Macbeth;1971;Fresh;86;73;25;4;29;5
Macbeth;2015;Certified-Fresh;80;64;158;40;198;40
Machete;2010;Certified-Fresh;72;63;139;53;192;38
Machete Kills;2013;Rotten;29;35;36;87;123;33
Machete Maidens Unleashed!;1900;Fresh;88;73;7;1;8;2
Kataude mashin garu (The Machine Girl);2008;Fresh;63;62;5;3;8;3
Machine Gun Preacher;2011;Rotten;27;62;31;83;114;37
The Machinist;2004;Certified-Fresh;77;83;110;33;143;38
MacKenna's Gold;1969;Rotten;20;70;1;4;5;0
Mad As Hell;2015;Rotten;27;84;3;8;11;6
Mad City;1997;Rotten;36;42;10;18;28;6
Mad Cowgirl;2006;Rotten;33;89;4;8;12;5
Mad Detective;2008;Fresh;81;85;17;4;21;7
Mad Dog and Glory;1993;Fresh;77;45;23;7;30;9
Mad Hot Ballroom;2005;Certified-Fresh;84;83;102;19;121;40
Mad Love;2002;Rotten;48;65;24;26;50;17
Mad Max;1979;Certified-Fresh;90;70;56;6;62;7
Mad Max 2: The Road Warrior;1982;Certified-Fresh;93;86;43;3;46;7
Mad Max Beyond Thunderdome;1985;Certified-Fresh;80;49;41;10;51;12
Mad Max: Fury Road;2015;Certified-Fresh;97;85;408;14;422;59
Mad Monster Party;1967;Fresh;70;67;7;3;10;0
Mad Tiger;2016;Fresh;67;56;8;4;12;5
Mad to Be Normal;2018;Fresh;61;63;14;9;23;5
Madagascar;2005;Rotten;54;70;104;87;191;44
Madagascar 3: Europe's Most Wanted;2012;Certified-Fresh;78;72;104;29;133;34
Madagascar: Escape 2 Africa;2008;Fresh;64;66;100;57;157;41
Madagasikara;1900;Fresh;89;;8;1;9;1
Madame;2018;Rotten;44;53;16;20;36;9
Madame Bovary;2015;Rotten;43;26;30;39;69;21
Madame Curie;1943;Fresh;86;67;6;1;7;0
Madame Sata;2002;Fresh;60;81;26;17;43;18
Made;2001;Fresh;71;67;76;31;107;34
Made in America;2014;Rotten;58;33;11;8;19;4
Made in Dagenham;2010;Certified-Fresh;80;75;104;26;130;37
Made in Italy;1900;Rotten;49;46;33;34;67;12
Made of Honor;2008;Rotten;15;55;19;105;124;37
Madea Goes to Jail;2009;Rotten;29;96;15;37;52;13
Madea's Big Happy Family;2011;Rotten;38;74;16;26;42;13
Madea's Family Reunion;2006;Rotten;26;94;15;43;58;19
Madea's Witness Protection;2012;Rotten;19;66;7;30;37;13
Madeline's Madeline;2018;Certified-Fresh;88;44;107;14;121;26
Mademoiselle C;2013;Rotten;47;34;8;9;17;10
Mademoiselle Chambon;2010;Certified-Fresh;83;68;44;9;53;18
Mother (Madeo);2010;Certified-Fresh;96;88;112;5;117;33
Madhouse;;Rotten;0;45;0;5;5;2
Madison;2005;Rotten;30;50;10;23;33;15
Madman;1981;Rotten;36;35;4;7;11;0
Madness in the Method;2019;Rotten;30;59;3;7;10;1
The Madness of King George;1994;Certified-Fresh;93;80;41;3;44;11
Madonna: Truth or Dare;1991;Fresh;87;70;26;4;30;7
Madrid, 1987;2012;Fresh;89;62;8;1;9;7
The Madwoman of Chaillot;1969;Rotten;20;49;1;4;5;1
Maestro;1900;Rotten;38;77;6;10;16;9
Mafioso;1964;Certified-Fresh;96;80;48;2;50;26
The Magdalene Sisters;2003;Certified-Fresh;91;89;135;14;149;42
Maggie;2015;Fresh;60;32;81;54;135;33
Maggie's Plan;2016;Certified-Fresh;87;52;157;24;180;40
Magic Beyond Words: The JK Rowling Story;1900;Rotten;33;58;2;4;6;2
The Magic Flute;2006;Fresh;70;65;16;7;23;12
Magic in the Moonlight;2014;Rotten;51;45;96;91;187;51
Magic in the Water;1995;Rotten;21;59;5;19;24;11
Magic Magic;1900;Fresh;68;30;28;13;41;7
Magic Mike;2012;Certified-Fresh;79;60;168;44;212;46
Magic Mike XXL;2015;Fresh;65;55;153;82;235;52
The Magic Sword;1962;Rotten;29;26;2;5;7;0
Magic Trip;2011;Fresh;72;62;44;17;61;25
Magical Universe;2014;Fresh;63;70;5;3;8;4
Magician: The Astonishing Life and Work of Orson Welles;2014;Fresh;73;;36;13;49;19
Magnificent Obsession;1954;Fresh;87;71;20;3;23;5
Magnolia;1999;Certified-Fresh;83;89;122;25;147;32
Magnum Force;1973;Fresh;72;77;18;7;25;0
Maid in Manhattan;2002;Rotten;38;43;58;93;151;39
Maiden;2019;Certified-Fresh;98;97;114;2;116;26
Maidentrip;2014;Fresh;83;79;19;4;23;12
Mail Order Wife;2005;Fresh;61;68;19;12;31;8
Main Street;2011;Rotten;13;11;1;7;8;1
Maine;2018;Fresh;60;38;6;4;10;3
The Majestic;2001;Rotten;42;60;60;82;142;32
Major Dundee;1965;Fresh;97;67;33;1;34;15
Major League;1989;Certified-Fresh;83;84;33;7;40;10
Major League II;1994;Rotten;5;45;1;20;21;6
Major League: Back to the Minors;1998;Rotten;21;25;4;15;19;4
Major Payne;1994;Rotten;33;68;4;8;12;3
Make Believe;2011;Fresh;85;74;17;3;20;9
Make It Funky;2005;Fresh;93;90;13;1;14;8
Make It Happen;2008;Rotten;22;40;4;14;18;6
Make Out With Violence;1900;Fresh;64;46;9;5;14;3
Make the Yuletide Gay;2009;Rotten;40;63;2;3;5;1
Make Your Move;2014;Rotten;38;48;6;10;16;7
Making the Boys;2010;Fresh;95;78;18;1;19;8
Making Babies;2019;Rotten;25;51;2;6;8;2
Making Montgomery Clift;2018;Fresh;100;80;15;0;15;4
Maktub;2018;Fresh;100;99;5;0;5;1
Mala Noche;2007;Fresh;96;64;22;1;23;10
Maleficent;2014;Rotten;54;70;145;125;270;55
Maleficent: Mistress of Evil;2019;Rotten;40;95;100;152;251;41
Malevolent;1900;Rotten;38;17;3;5;8;1
Malibu's Most Wanted;2003;Rotten;31;54;29;64;93;29
Malice;1993;Rotten;57;46;17;13;30;7
Malice in Wonderland;2010;Rotten;10;48;1;9;10;3
Mallrats;1995;Rotten;56;82;25;20;45;11
Mama;2013;Fresh;64;55;105;60;165;40
Mama's Boy;2007;Rotten;8;26;1;11;12;4
Mambo Italiano;2003;Rotten;32;66;24;52;76;24
The Mambo Kings;1992;Fresh;81;69;22;5;27;8
Mame;1974;Rotten;33;48;3;6;9;0
Mamma Mia!;2008;Rotten;55;66;100;83;183;44
Mamma Mia! Here We Go Again;2018;Certified-Fresh;79;66;216;58;274;47
Man About Town;2006;Rotten;38;29;3;5;8;0
A Man Apart;2003;Rotten;11;62;14;118;132;37
Man Bites Dog;1992;Fresh;74;90;14;5;19;1
A Man Called Horse;1970;Fresh;86;60;12;2;14;0
Man Camp;1900;Fresh;100;91;5;0;5;0
Man Down;2016;Rotten;16;58;9;46;55;21
Man Friday;1900;Rotten;33;65;2;4;6;1
The Man from Elysian Fields;2001;Rotten;51;54;36;34;70;26
The Man From Laramie;1955;Fresh;100;79;9;0;9;0
The Man From Nowhere;2010;Fresh;100;90;6;0;6;2
Jimmy Carter Man From Plains;2007;Certified-Fresh;79;76;68;18;86;39
The Man from Snowy River;1982;Fresh;85;89;11;2;13;2
Man in Camo;1900;Fresh;100;100;5;0;5;0
Man in Red Bandana;2017;Fresh;63;94;5;3;8;3
The Man in the Gray Flannel Suit;1956;Fresh;75;73;9;3;12;4
The Man in the White Suit;1900;Fresh;100;81;14;0;14;0
Man of Aran;1934;Fresh;95;75;21;1;22;5
Man of La Mancha;1973;Rotten;50;72;7;7;14;1
Man of Tai Chi;2013;Fresh;70;50;47;20;67;25
Man of the Century;1999;Fresh;71;77;12;5;17;6
Man of the House;2005;Rotten;9;46;6;61;67;20
Man of the Year;2006;Rotten;22;45;31;113;144;43
Man on a Ledge;2012;Rotten;32;52;51;109;160;41
Man on Fire;2004;Rotten;38;89;65;104;169;44
Man on Wire;2008;Certified-Fresh;100;87;158;0;158;49
Man Push Cart;2006;Certified-Fresh;88;66;43;6;49;20
Man Up;2015;Certified-Fresh;80;69;63;16;79;19
The Man Who Fell to Earth;1976;Certified-Fresh;82;69;51;11;62;18
The Man Who Knew Too Little;1997;Rotten;39;69;13;20;33;7
The Man Who Shot Liberty Valance;1962;Certified-Fresh;94;92;44;3;47;7
The Man Who Wasn't There;2001;Certified-Fresh;81;85;129;30;159;37
The Man Who Would Be King;1975;Fresh;97;91;28;1;29;5
Man With a Movie Camera;1929;Fresh;97;88;34;1;35;7
The Man with One Red Shoe;1985;Rotten;47;40;7;8;15;2
The Man with the Golden Gun;1974;Rotten;41;55;21;30;51;7
The Man with Two Brains;1983;Fresh;76;64;16;5;21;1
The Man Without a Face;1993;Fresh;65;64;15;8;23;5
The Man Without a Past;2002;Certified-Fresh;98;90;97;2;99;31
Management;2009;Rotten;47;30;46;51;97;39
Manakamana;2014;Certified-Fresh;96;61;50;2;52;14
Manborg;1900;Fresh;88;57;7;1;8;2
Manchester by the Sea;2016;Certified-Fresh;96;78;333;14;347;52
Manchild: The Schea Cotton Story;1900;Fresh;100;100;5;0;5;0
The Manchurian Candidate;2004;Certified-Fresh;80;63;167;42;209;47
Manda Bala (Send a Bullet);2007;Certified-Fresh;80;86;40;10;50;19
Mandela: Long Walk to Freedom;2013;Fresh;61;68;87;55;142;36
Manderlay;2006;Rotten;50;75;52;52;104;29
Mandingo;1975;Rotten;26;65;5;14;19;6
All the Boys Love Mandy Lane;2013;Rotten;45;31;30;37;67;19
Mandy;2018;Certified-Fresh;91;66;220;23;243;30
Manglehorn;2015;Rotten;51;24;43;42;85;28
The Mangler;1994;Rotten;27;18;3;8;11;1
Manhattan;1979;Certified-Fresh;96;92;64;3;67;13
Manhattan Melodrama;1934;Fresh;81;71;13;3;16;6
Manhattan Murder Mystery;1993;Fresh;93;84;28;2;30;8
Manhattan Night (Manhattan Nocturne);2016;Rotten;36;52;8;14;22;14
Maniac;1934;Fresh;89;31;8;1;9;0
Maniac;1980;Rotten;40;58;8;12;20;1
Maniac;2013;Rotten;53;44;39;35;74;20
Maniac Cop;1988;Rotten;50;39;7;7;14;2
Manic;2003;Fresh;67;79;43;21;64;25
Manifesto;2017;Certified-Fresh;75;55;64;21;85;27
Manito;2003;Fresh;94;73;29;2;31;15
The Manitou;1978;Rotten;33;35;3;6;9;1
Mannequin 2: On the Move;1900;Rotten;13;41;3;20;23;7
Manny;2015;Rotten;25;65;3;9;12;5
Manolo, The Boy Who Made Shoes For Lizards;2017;Fresh;67;68;22;11;33;13
Manos: The Hands of Fate;1966;Rotten;0;20;0;16;16;0
Man's Best Friend;1991;Rotten;21;43;3;11;14;2
Man's Favorite Sport?;1964;Fresh;64;73;9;5;14;4
Mansome;2012;Rotten;25;23;9;27;36;15
The Manson Family;2004;Fresh;69;50;22;10;32;14
Manson Family Vacation;1900;Fresh;100;56;14;1;14;3
Man-Thing;1900;Rotten;17;13;1;5;6;0
Manufactured Landscapes;2007;Certified-Fresh;84;80;52;10;62;26
Manufacturing Consent - Noam Chomsky and the Media;1993;Fresh;75;94;6;2;8;1
Manuscripts Don't Burn;2014;Fresh;93;78;25;2;27;11
The Manxman;1929;Fresh;92;46;11;1;12;4
Many Adventures of Winnie the Pooh;1977;Fresh;100;88;17;0;17;2
Mao's Last Dancer;2010;Rotten;56;76;43;34;77;26
Map of the Human Heart;1992;Fresh;77;80;17;5;22;4
Mapplethorpe;2019;Rotten;33;63;17;35;52;17
Maps to the Stars;2015;Fresh;61;44;96;62;158;43
Mara;2018;Rotten;29;24;5;12;17;4
Marathon Man;1976;Fresh;81;81;34;8;42;1
Marathon: The Patriots Day Bombing;2016;Fresh;90;83;9;1;10;5
Marat/Sade;1900;Fresh;92;79;12;1;13;1
Marauders;2016;Rotten;20;30;4;16;20;9
Marc Maron: Too Real;1900;Fresh;80;68;4;1;5;1
The Marc Pease Experience;2009;Rotten;18;14;2;9;11;6
Marcel Duchamp: The Art of the Possible;2020;Rotten;50;;3;3;6;1
March of the Penguins;2005;Certified-Fresh;94;81;173;11;184;51
Babes In Toyland;1934;Fresh;100;78;16;0;16;2
Marci X;2003;Rotten;8;30;5;55;60;17
Mardi Gras: Made in China;2005;Fresh;68;90;13;6;19;9
Marebito;2005;Rotten;40;50;12;18;30;10
Marfa Girl;2015;Rotten;27;32;4;11;15;9
Margaret;2011;Certified-Fresh;74;48;74;26;100;36
Margin Call;2011;Certified-Fresh;87;74;149;22;171;46
Margot at the Wedding;2007;Rotten;52;40;88;81;169;47
Marguerite & Julien (Marguerite et Julien);2016;Rotten;20;33;2;8;10;5
Maria Bamford: Old Baby;1900;Fresh;100;;14;0;14;6
Maria By Callas;2018;Certified-Fresh;91;70;72;7;79;14
Maria Full of Grace;2004;Certified-Fresh;97;87;141;5;146;35
Mariachi Gringo;2013;Rotten;43;69;3;4;7;4
Marianne & Leonard: Words of Love;2019;Certified-Fresh;79;85;91;24;115;25
Marie Curie: The Courage of Knowledge;2017;Fresh;64;55;16;9;25;10
Marigold;2007;Rotten;30;40;8;19;27;13
Marilyn Hotchkiss Ballroom Dancing & Charm School;2006;Rotten;22;61;13;46;59;23
Marina Abramovic: The Artist Is Present;2012;Certified-Fresh;96;88;44;2;46;22
The Marine;2006;Rotten;20;60;9;37;46;15
Marinoni: The Fire in the Frame;2016;Fresh;70;80;7;3;10;5
Mario;1900;Fresh;100;72;12;0;12;4
Marion Bridge;2003;Fresh;76;62;13;4;17;8
Marjoe;2000;Fresh;100;79;6;0;6;3
Marjorie Prime;2017;Certified-Fresh;90;62;81;9;90;28
Mark of the Devil;1969;Rotten;38;46;3;5;8;1
Mark Felt: The Man Who Brought Down the White House;2017;Rotten;35;40;40;73;113;34
Marked for Death;;Rotten;20;50;2;8;10;1
Marked Woman;1937;Fresh;100;70;5;0;5;0
Marketa Lazarova;1967;Fresh;100;87;11;0;11;3
Marlene;1984;Fresh;100;97;7;0;7;2
Marley;2012;Certified-Fresh;95;90;106;6;112;37
Marley & Me;2008;Fresh;62;75;88;53;141;43
Marlowe;1969;Fresh;71;50;5;2;7;1
Marmaduke;2010;Rotten;9;42;9;93;102;28
Marnie;1964;Certified-Fresh;83;73;33;7;40;8
Marooned;1969;Fresh;86;45;6;1;7;1
Die Marquise von O... (The Marquise of O);1976;Fresh;85;75;11;2;13;5
Marriage Italian Style;1964;Fresh;80;84;4;1;5;1
Marriage Story;2019;Certified-Fresh;94;85;359;22;381;48
Married to It;1993;Rotten;33;43;3;6;9;2
Married to the Mob;1988;Certified-Fresh;89;48;42;5;47;8
Une femme mariee: Suite de fragments d'un film tourne en 1964 (A Married Woman);1964;Fresh;85;83;17;3;20;6
Marrowbone;2018;Rotten;48;58;35;38;73;9
The Marrying Man;1991;Rotten;10;45;2;19;21;7
Mars;2010;Fresh;86;;6;1;7;2
Mars Attacks!;1996;Rotten;54;53;45;38;83;22
Mars Needs Moms;2011;Rotten;37;40;43;73;116;39
Mars Needs Women;1966;Rotten;0;10;0;9;9;0
Marshall;2017;Certified-Fresh;81;84;117;28;145;35
Marshland (La isla minima);1900;Fresh;92;77;33;3;36;9
Martha Marcy May Marlene;2011;Certified-Fresh;90;71;188;22;210;49
Martian Child;2007;Rotten;35;72;38;72;110;32
Martin & Orloff;2002;Rotten;47;74;8;9;17;8
Martin Lawrence Live - Runteldat;2002;Rotten;39;69;22;35;57;24
Martyrs;2008;Fresh;63;69;24;14;38;9
Marvel's The Avengers;2012;Certified-Fresh;92;91;327;30;357;59
Marvin's Room;1996;Certified-Fresh;84;63;42;8;50;16
Marwencol;2010;Certified-Fresh;98;87;61;1;62;20
Mary Pickford: The Muse of the Movies;2008;Fresh;88;100;7;1;8;1
Mary;2019;Rotten;4;15;1;26;27;10
Mary and The Witch's Flower;2018;Certified-Fresh;89;71;79;10;89;19
Mary Magdalene;2019;Rotten;44;47;49;62;111;22
Mary Poppins;1964;Certified-Fresh;100;86;51;0;51;9
Mary Queen of Scots;2018;Fresh;62;41;176;106;282;50
Mary Reilly;1996;Rotten;26;40;11;32;43;11
Mary Shelley;2018;Rotten;38;47;48;77;125;33
Mary Shelley's Frankenstein;1994;Rotten;38;49;17;28;45;11
Maryam;2002;Fresh;78;75;29;8;37;13
Masai: The Rain Warriors;2006;Fresh;63;58;5;3;8;5
Mascots;2016;Rotten;49;36;23;24;47;15
M*A*S*H;1970;Certified-Fresh;87;83;46;7;53;10
The Mask of Zorro;1998;Certified-Fresh;82;72;60;13;73;15
Masked and Anonymous;2003;Rotten;24;45;20;62;82;30
Masquerade;2012;Fresh;100;89;9;0;9;2
Master and Commander: The Far Side of the World;2003;Certified-Fresh;85;80;184;33;217;45
Master of Dark Shadows;1900;Fresh;100;;5;0;5;0
The Master of Disguise;2002;Rotten;1;33;1;103;104;33
Master Z: Ip Man Legacy;2019;Fresh;89;68;33;4;37;7
Masterminds;1998;Rotten;19;49;3;13;16;3
Masterminds;2016;Rotten;34;35;33;65;98;25
Masters of the Universe;1987;Rotten;17;40;4;20;24;8
Masters of the Universe 2: Cyborg;1989;Rotten;19;30;3;13;16;3
Matador;1986;Fresh;92;78;24;2;26;10
Match;2015;Fresh;76;67;29;9;38;17
Match Point;2005;Certified-Fresh;77;81;167;51;218;49
Matchstick Men;2003;Certified-Fresh;82;74;153;34;187;44
Mateo;2015;Fresh;63;50;5;3;8;4
Material Girls;2006;Rotten;4;44;2;52;54;17
The Mating Habits of the Earthbound Human;1999;Rotten;33;73;4;8;12;1
The Matrix;1999;Certified-Fresh;88;85;135;19;154;37
The Matrix Reloaded;2003;Certified-Fresh;73;72;179;66;245;50
The Matrix Revisited;2001;Fresh;71;64;5;2;7;0
The Matrix Revolutions;2003;Rotten;35;60;76;140;216;41
Matru Ki Bijlee Ka Mandola;2013;Rotten;33;44;3;6;9;3
Matt Shepard is a Friend of Mine;2015;Fresh;100;86;30;0;30;13
Matthew Barney: No Restraint;2006;Rotten;50;55;11;11;22;12
Maudie;2017;Certified-Fresh;89;89;134;16;150;32
Maurice;1987;Fresh;89;87;24;3;27;7
Maurice Richard (The Rocket);2007;Rotten;56;88;5;4;9;5
Mausam;2011;Rotten;20;33;1;4;5;0
Mauvais Sang;1987;Fresh;85;82;11;2;13;4
Maverick;1994;Fresh;66;71;35;18;53;16
Mavis!;2016;Fresh;97;65;31;1;32;11
Max;2002;Fresh;69;64;77;35;112;28
Max;2015;Rotten;38;70;37;61;98;32
Max Dugan Returns;1983;Fresh;71;69;10;4;14;4
Max Keeble's Big Move;2001;Rotten;29;38;16;40;56;21
Max Manus: Man of War;2010;Fresh;79;83;27;7;34;16
Max Payne;2008;Rotten;16;29;21;114;135;37
Max Reload and the Nether Blasters;2020;Fresh;82;76;9;2;11;0
Max Steel;2016;Rotten;0;48;0;21;21;6
Maxed Out;2006;Certified-Fresh;88;70;42;6;48;22
Maximum Impact;2018;Rotten;9;;1;10;11;3
Maximum Overdrive;1986;Rotten;15;49;2;11;13;0
Maximum Risk;1996;Rotten;31;34;11;24;35;12
May;2003;Fresh;69;75;46;21;67;16
May In The Summer;2014;Rotten;58;46;15;11;26;11
May It Last: A Portrait of the Avett Brothers;2017;Fresh;89;98;8;1;9;3
May the Devil Take You (Sebelum iblis menjemput);1900;Fresh;77;57;10;3;13;0
Maya The Bee Movie;2015;Rotten;47;45;8;9;17;7
Mayhem;2017;Certified-Fresh;85;64;51;10;60;11
Maytime;1937;Fresh;100;88;5;0;5;0
Maze;2001;Rotten;39;45;9;14;23;12
Maze;2019;Fresh;92;49;12;1;13;6
Maze Runner: The Death Cure;2018;Rotten;43;59;72;97;169;36
Maze Runner: The Scorch Trials;2015;Rotten;46;54;69;80;149;30
McCabe & Mrs. Miller;1971;Certified-Fresh;85;87;47;8;55;12
McCanick;2014;Rotten;13;15;2;14;16;6
McConkey;2013;Fresh;100;94;5;0;5;3
McFarland USA;2015;Certified-Fresh;81;88;107;25;132;40
McLibel: Two Worlds Collide;2005;Fresh;100;;10;0;10;3
McLintock!;1963;Fresh;67;85;4;2;6;0
McQ;1974;Rotten;44;57;4;5;9;1
McQueen;2018;Certified-Fresh;99;79;122;1;123;30
Me and Earl and the Dying Girl;2015;Certified-Fresh;81;86;171;40;211;47
Me and You and Everyone We Know;2005;Certified-Fresh;82;84;99;22;121;39
Me Before You;2016;Rotten;54;73;97;81;178;43
Me, Myself & Irene;2000;Rotten;47;57;47;52;99;26
Me Myself I;2000;Fresh;63;57;20;12;32;8
Me Without You;2002;Fresh;67;78;44;22;66;24
Me You Them;2001;Certified-Fresh;75;72;42;14;56;20
Mea Maxima Culpa: Silence In The House Of God;2012;Certified-Fresh;98;90;49;1;50;19
Mean Creek;2004;Certified-Fresh;89;82;110;14;124;37
Mean Dreams;2017;Certified-Fresh;78;56;35;10;45;13
Mean Girls;2004;Certified-Fresh;84;66;159;30;189;45
Mean Machine;2002;Rotten;34;72;19;37;56;23
The Mean Season;1985;Rotten;50;31;4;4;8;0
Mean Streets;1973;Certified-Fresh;95;84;59;3;62;9
Meantime;1983;Fresh;75;81;6;2;8;1
Measure for Measure;1900;Rotten;33;80;8;16;24;3
Meatballs;1979;Fresh;72;58;26;10;36;5
The Mechanic;2011;Rotten;53;51;88;78;166;39
Mechanic: Resurrection;2016;Rotten;31;40;18;41;59;11
The Medallion;2003;Rotten;17;27;21;104;125;34
Medea;1969;Fresh;70;75;7;3;10;1
Medicine for Melancholy;2008;Fresh;84;65;31;6;37;16
Mediterranea;2015;Fresh;90;54;18;2;20;7
Meek's Cutoff;2011;Certified-Fresh;86;54;110;18;128;45
Meet The Browns;2008;Rotten;33;90;19;39;58;19
Meet Dave;2008;Rotten;20;35;20;82;102;30
Meet Joe Black;1998;Rotten;45;81;22;27;49;11
Meet John Doe;1941;Fresh;91;83;20;2;22;0
Meet Me In Montenegro;2015;Rotten;50;59;4;4;8;4
Meet Me In St. Louis;1944;Fresh;100;87;33;0;33;9
Meet Monica Velour;2011;Rotten;48;34;14;15;29;13
Meet the Blacks;2016;Rotten;17;72;2;10;12;4
Meet the Fockers;2004;Rotten;39;58;63;99;162;41
Ouwehoeren (Meet the Fokkens);2012;Fresh;94;67;16;1;17;11
Meet The Mormons;2014;Rotten;18;89;2;9;11;4
Meet the Parents;2000;Certified-Fresh;84;79;124;24;148;39
Meet The Patels;2015;Certified-Fresh;87;76;45;7;52;22
Meet the Robinsons;2007;Fresh;67;74;95;47;142;39
Meet the Spartans;2008;Rotten;2;25;1;48;49;11
Meet Wally Sparks;1997;Rotten;13;31;2;13;15;2
Meeting Evil;2012;Rotten;22;31;2;7;9;1
Meeting People Is Easy;1999;Fresh;71;85;5;2;7;1
Meeting Spencer;2011;Rotten;33;40;4;8;12;6
Mega Piranha;2010;Rotten;8;16;1;12;13;5
Mega Shark vs. Giant Octopus;2009;Rotten;18;20;4;18;22;5
Mega Time Squad;2019;Fresh;78;59;14;4;18;3
Megaforce;1982;Rotten;0;42;0;14;14;2
Megamind;2010;Fresh;72;72;131;50;181;44
Megan Leavey;2017;Certified-Fresh;87;82;88;13;101;28
The Mermaid (Mei ren yu);2016;Fresh;95;60;36;2;38;13
Melancholia;2011;Certified-Fresh;79;67;162;42;204;54
Melinda and Melinda;2005;Rotten;52;47;82;75;157;44
Melo;1986;Fresh;80;61;4;1;5;1
Melody Makers;2019;Fresh;78;;7;2;9;3
Melvin Goes to Dinner;2003;Fresh;100;80;11;0;11;3
Memento;2000;Certified-Fresh;93;94;166;13;179;43
Memoir of War (La douleur);2018;Fresh;66;50;27;14;41;12
Memoirs of a Geisha;2005;Rotten;35;83;57;107;164;41
Memoirs of an Invisible Man;1992;Rotten;24;32;8;25;33;3
Memoria;2016;Fresh;100;47;5;0;5;1
Memories of Murder;2003;Certified-Fresh;93;94;56;4;60;17
Memories of the Sword;2015;Fresh;75;53;6;2;8;4
Memory: The Origins of Alien;2019;Certified-Fresh;81;92;64;15;79;15
Memphis;2014;Fresh;74;40;20;7;27;15
Men at Lunch;2013;Rotten;38;39;5;8;13;4
Men at Work;;Rotten;30;45;8;19;27;6
Men in Black;1997;Certified-Fresh;92;79;83;7;90;27
Men in Black II;2002;Rotten;39;45;77;121;198;39
Men in Black III;2012;Fresh;68;70;170;80;250;45
Men in Black International;2019;Rotten;23;66;71;244;314;43
Men of Boys Town;1941;Rotten;40;65;2;3;5;2
Men of Honor;2000;Rotten;42;81;44;62;106;32
The Men Who Stare at Goats;2009;Rotten;50;39;109;107;216;54
Men with Brooms;2002;Rotten;55;67;11;9;20;4
Men, Women & Children;2014;Rotten;34;44;46;91;137;44
Menace II Society;1993;Fresh;84;93;31;6;37;9
Menashe;2017;Certified-Fresh;96;65;113;5;118;28
Mendy: A Question of Faith;2003;Fresh;75;50;6;2;8;5
Mental;2013;Rotten;44;55;24;31;55;15
Menu degustacio (Tasting Menu);2014;Rotten;17;23;3;15;18;8
The Mephisto Waltz;1971;Fresh;67;39;4;2;6;1
Red & White (Merah Putih);2009;Rotten;0;56;0;7;7;3
Mercedes Sosa: The Voice of Latin America;2014;Fresh;60;57;6;4;10;5
Mercenaries;2011;Rotten;0;12;0;7;7;3
Handler der vier Jahreszeiten (The Merchant of Four Seasons);1900;Fresh;94;75;15;1;16;2
William Shakespeare's The Merchant of Venice;2004;Fresh;71;72;90;37;127;41
Merchants Of Doubt;2015;Certified-Fresh;84;78;76;14;90;29
Merci Docteur Rey;2002;Rotten;0;65;0;22;22;8
Mercury 13;2018;Fresh;100;77;24;0;24;4
Mercury Rising;1998;Rotten;21;40;12;45;57;20
Mercy;2010;Rotten;43;56;6;8;14;7
Mercy Streets;2000;Rotten;13;55;1;7;8;1
Mermaids;;Fresh;74;70;17;6;23;7
Merry Christmas, Mr. Lawrence;1983;Fresh;82;79;18;4;22;6
The Merry Gentleman;2009;Fresh;65;49;50;27;77;33
Meru;2015;Certified-Fresh;89;91;68;8;76;22
Meskada;2010;Rotten;33;29;2;4;6;2
Mesrine: Public Enemy #1 (Mesrine: L'ennemi public no. 1);2010;Certified-Fresh;81;82;72;17;89;26
Message from the King;1900;Rotten;45;50;5;6;11;0
Message in a Bottle;1999;Rotten;32;66;12;26;38;6
The Messenger: The Story of Joan of Arc;1999;Rotten;30;58;22;51;73;23
Metallica: Some Kind of Monster;2004;Certified-Fresh;89;83;109;14;123;34
Metallica Through the Never;2013;Certified-Fresh;79;73;53;14;67;26
Method to the Madness of Jerry Lewis;1900;Fresh;67;79;8;4;12;10
Metroland;1999;Fresh;64;54;18;10;28;5
Metropia;2010;Rotten;50;56;3;3;6;1
Metropolitan;;Certified-Fresh;93;85;37;3;40;15
The Mexican;2001;Rotten;54;44;72;61;133;36
M.F.A.;2017;Fresh;79;87;19;5;24;4
MFKZ;2018;Rotten;39;82;7;11;18;5
MI-5 (Spooks: The Greater Good);2015;Fresh;63;50;26;15;41;9
Mia and the White Lion;2019;Fresh;88;56;15;2;17;3
Mia et le Migou (Mia and the Migoo);2011;Rotten;38;64;6;10;16;11
Mia Madre;2016;Certified-Fresh;83;60;74;15;89;26
Miami Blues;;Fresh;81;55;17;4;21;3
Miami Connection;1988;Fresh;68;64;13;6;19;4
Miami Rhapsody;1995;Rotten;45;26;9;11;20;4
Miami Vice;2006;Rotten;47;43;104;119;223;50
Michael Jordan to the Max;2000;Fresh;67;81;18;9;27;8
Michael;2012;Certified-Fresh;80;67;32;8;40;17
Michael Bolton's Big, Sexy Valentine's Day Special;1900;Fresh;100;62;5;0;5;3
Michael Che Matters;1900;Fresh;100;83;5;0;5;3
Michael Clayton;2007;Certified-Fresh;91;69;184;19;203;52
Michael Collins;1996;Certified-Fresh;77;84;36;11;47;12
Michael Jackson's This Is It;2009;Certified-Fresh;81;82;150;36;186;49
Michelle Wolf: Joke Show;1900;Fresh;100;58;8;0;8;4
Mickey Blue Eyes;1999;Rotten;45;42;35;42;77;24
Mickey's Christmas Carol;1983;Fresh;100;90;7;0;7;1
Mickey's Once Upon a Christmas;1900;Rotten;40;66;2;3;5;0
Micki + Maude;1984;Fresh;70;44;7;3;10;2
Micmacs (Micmacs a tire-larigot);2010;Certified-Fresh;72;74;103;40;143;39
Microcosmos;1996;Fresh;97;91;32;1;33;6
Mid90s;2018;Certified-Fresh;80;80;180;45;224;42
Pranzo di Ferragosto (Mid-August Lunch);2009;Certified-Fresh;88;70;58;8;66;21
Middle Men;2010;Rotten;40;56;21;32;53;19
Middle of Nowhere;2012;Certified-Fresh;88;64;44;6;50;22
Middle School: The Worst Years of My Life;2016;Fresh;63;58;27;16;43;11
Midgets vs. Mascots;1900;Rotten;0;55;0;9;9;2
Midnight Son;1900;Fresh;96;58;22;1;23;4
Midnight Cowboy;1969;Certified-Fresh;88;88;66;9;75;16
Midnight Crossing;1988;Rotten;40;38;2;3;5;0
Midnight Express;1978;Fresh;96;89;25;1;26;2
Midnight Family;2019;Certified-Fresh;97;82;69;2;71;13
Midnight in Paris;2011;Certified-Fresh;93;83;208;16;224;56
Midnight in the Garden of Good and Evil;1997;Rotten;50;65;18;18;36;8
Midnight Return: The Story of Billy Hayes and Turkey;2017;Fresh;75;80;6;2;8;4
Midnight Run;1988;Certified-Fresh;94;87;50;3;53;14
Midnight Special;2016;Certified-Fresh;84;67;193;38;231;50
Midnight Sun;2018;Rotten;21;55;13;48;61;17
Midnighters;2018;Fresh;81;37;26;6;32;6
Midnight's Children;2013;Rotten;41;39;26;37;63;25
Midsommar;2019;Certified-Fresh;83;63;321;66;387;48
A Midsummer Night's Sex Comedy;1982;Fresh;77;57;20;6;26;6
Midway;1976;Rotten;47;72;7;8;15;1
Mifune: The Last Samurai;2016;Fresh;83;77;30;6;36;11
Mifune's Last Song (Mifune) (Mifunes sidste sang);2000;Fresh;74;85;23;8;31;7
The Mighty;1998;Certified-Fresh;75;79;30;10;40;7
The Mighty Ducks;1992;Rotten;23;65;7;23;30;7
Mighty Fine;2012;Rotten;19;49;3;13;16;10
A Mighty Heart;2007;Certified-Fresh;79;70;155;40;195;60
Mighty Oak;2020;Fresh;65;88;11;6;17;2
Xing xing wang (The Mighty Peking Man) (Colossus of Congo) (Goliathon);1978;Rotten;55;38;6;5;11;2
The Mighty Quinn;1989;Fresh;88;48;14;2;16;3
A Mighty Wind;2003;Certified-Fresh;87;75;153;22;175;41
Mike and Dave Need Wedding Dates;2016;Rotten;38;51;64;106;170;34
Mike Birbiglia: My Girlfriend's Boyfriend;2013;Fresh;100;;6;0;6;3
Mike Birbiglia: Thank God for Jokes;1900;Fresh;100;77;8;0;8;2
Mike Birbiglia: The New One;1900;Fresh;100;88;5;0;5;1
Mikey and Nicky;1976;Fresh;86;81;18;3;21;2
The Milagro Beanfield War;1988;Rotten;59;75;19;13;32;8
Milarepa;2007;Rotten;41;61;11;16;27;8
Mildred Pierce;1945;Certified-Fresh;86;90;38;6;44;9
Mile 22;2018;Rotten;23;44;43;146;189;33
Miles Ahead;2016;Fresh;74;57;131;47;178;48
Miles Davis: Birth of the Cool;2019;Certified-Fresh;92;81;54;5;59;15
Military Intelligence and You!;1900;Rotten;45;33;9;11;20;6
Military Wives;2020;Certified-Fresh;76;61;90;28;118;22
Milk;2008;Certified-Fresh;93;89;226;18;244;55
The Milk of Sorrow (La Teta Asustada);2010;Certified-Fresh;78;69;32;9;41;14
Millennium Actress (Sennen joyu);2001;Certified-Fresh;93;90;52;4;56;16
Miller's Crossing;;Certified-Fresh;92;90;55;5;60;11
Million Dollar Arm;2014;Fresh;65;68;95;51;146;41
Million Dollar Baby;2004;Certified-Fresh;91;90;243;25;268;58
The Million Dollar Hotel;2000;Rotten;25;67;11;33;44;15
Millions;2005;Certified-Fresh;88;78;141;20;161;35
Milton Glaser: To Inform and Delight;2009;Fresh;80;67;12;3;15;9
Milton's Secret;2016;Rotten;38;70;5;8;13;5
Secret Sunshine;2010;Fresh;94;79;29;2;31;8
Mimic 2;2001;Rotten;8;12;1;12;13;0
Mimic: Sentinel;2003;Fresh;60;15;3;2;5;0
The Last Mimzy;1900;Rotten;55;54;69;57;126;35
Mind Game;2004;Fresh;100;93;11;0;11;5
Mindhunters;2005;Rotten;24;57;29;90;119;32
Anna;2014;Rotten;33;38;7;14;21;6
Mine;2009;Fresh;81;;13;3;16;6
Mine;2017;Rotten;17;45;5;25;30;8
Mine 9;2019;Fresh;89;77;17;2;19;8
Loose Cannons (Mine Vaganti);2010;Fresh;72;73;13;5;18;7
Minions;2015;Rotten;55;49;122;99;221;41
Minnie and Moskowitz;1900;Fresh;80;86;12;3;15;4
Minority Report;2002;Certified-Fresh;90;80;227;25;252;51
The Minus Man;1999;Rotten;58;46;21;15;36;9
Minuscule: Valley of the Lost Ants (Minuscule - La vallee des fourmis perdues);1900;Fresh;90;71;9;1;10;4
Miracle;2004;Certified-Fresh;81;90;133;32;165;38
Miracle at St. Anna;2008;Rotten;33;51;40;81;121;36
Miracle Mile;1989;Fresh;91;73;29;3;32;1
The Miracle of Morgan's Creek;1944;Fresh;89;83;24;3;27;4
Miracle on 34th Street;1947;Certified-Fresh;96;87;45;2;47;10
Miracle on 34th Street;1994;Fresh;60;62;21;14;35;10
Miracles from Heaven;2016;Rotten;45;81;42;51;93;25
Mirage (Durante la tormenta);1900;Fresh;75;73;6;2;8;1
Mirai;2018;Certified-Fresh;90;80;75;8;83;16
Miral;2011;Rotten;17;54;11;54;65;26
The Mirror Crack'd;1980;Fresh;65;45;13;7;20;8
The Mirror Has Two Faces;1996;Rotten;55;72;18;15;33;7
Mirror Mirror;2012;Rotten;50;45;99;98;197;40
MirrorMask;2005;Rotten;54;80;48;41;89;27
Mischief Night;1900;Fresh;100;65;5;0;5;0
Misconception;2016;Rotten;40;38;2;3;5;1
Misconduct;2016;Rotten;7;22;2;26;28;13
Misery;;Certified-Fresh;90;89;61;7;68;12
Misery Loves Comedy;2014;Rotten;36;33;9;16;25;12
The Misfits;1961;Fresh;97;78;29;1;30;9
De Helaasheid der Dingen (The Misfortunates);2010;Fresh;71;77;15;6;21;12
Misfortune;2016;Rotten;20;;1;4;5;3
Mishima: A Life in Four Chapters;1985;Fresh;89;91;25;3;28;11
Miss Americana;2020;Certified-Fresh;91;91;83;8;91;21
Miss Arizona;2019;Rotten;50;50;3;3;6;3
Miss Bala;2012;Certified-Fresh;87;63;60;9;69;30
Miss Bala;2019;Rotten;22;54;24;86;110;26
Miss Congeniality;2000;Rotten;41;69;48;68;116;31
Miss Congeniality 2 - Armed and Fabulous;2005;Rotten;15;43;22;125;147;36
Miss Fisher and the Crypt of Tears;2020;Fresh;67;83;14;7;21;3
Miss Julie;2014;Rotten;52;25;28;26;54;21
Miss Juneteenth;2020;Certified-Fresh;99;61;119;1;120;27
Miss Meadows;2014;Rotten;25;35;5;15;20;9
Miss Minoes;2011;Fresh;64;71;7;4;11;5
Miss Peregrine's Home for Peculiar Children;2016;Fresh;64;60;158;90;248;47
Miss Pettigrew Lives for a Day;2008;Certified-Fresh;78;71;117;33;150;42
Miss Potter;2007;Fresh;67;68;87;42;129;45
Miss Sloane;2016;Certified-Fresh;76;72;145;46;191;43
Miss Stevens;2016;Fresh;91;67;21;2;23;12
Miss Virginia;2019;Rotten;50;84;7;7;14;4
Miss You Already;2015;Fresh;71;68;83;34;117;32
Missing Link;2019;Certified-Fresh;89;67;149;19;168;29
Mission: Impossible;1996;Fresh;64;71;37;21;58;21
Mission: Impossible 2;2000;Rotten;57;42;86;65;151;36
Mission: Impossible III;2006;Fresh;71;69;158;66;224;51
Mission: Impossible - Fallout;2018;Certified-Fresh;97;88;417;12;428;59
Mission: Impossible Ghost Protocol;2011;Certified-Fresh;94;76;233;16;249;56
Mission: Impossible Rogue Nation;2015;Certified-Fresh;93;87;301;21;322;52
Mission of Honor;2019;Fresh;83;46;5;1;6;2
Mission Park;2013;Rotten;0;60;0;6;6;3
Mission to Mars;2000;Rotten;24;30;27;85;112;28
The Missionary;1982;Fresh;100;42;5;0;5;1
Missionary;2014;Rotten;45;24;5;6;11;4
Mississippi Burning;1988;Fresh;84;90;21;4;25;6
Mississippi Grind;2015;Certified-Fresh;91;55;107;11;118;33
The Missouri Breaks;1976;Fresh;81;59;22;5;27;4
The Mist;2007;Fresh;72;65;105;41;145;33
Hallam Foe (Mister Foe);2007;Certified-Fresh;73;72;47;17;64;23
Mistress;1991;Fresh;72;39;13;5;18;7
Mixed Nuts;1994;Rotten;10;47;3;27;30;7
Mo' Better Blues;1900;Fresh;71;75;24;10;34;10
Mo' Money;1992;Rotten;16;51;4;21;25;5
Moana;2016;Certified-Fresh;95;89;265;14;279;51
Mob Queen;1900;Rotten;40;;0;0;5;0
Mob Town;2019;Rotten;0;29;0;9;9;3
Mobile Homes;2018;Fresh;60;40;12;8;20;6
Mobsters;1991;Rotten;6;57;2;30;32;13
The Mod Squad;1999;Rotten;3;17;2;61;63;19
Model Shop;1968;Fresh;83;44;5;1;6;0
Modern Life (Profils paysans: la vie moderne);2008;Fresh;100;74;19;0;19;8
Modern Life Is Rubbish;2018;Rotten;33;73;5;10;15;7
Modern Romance;1981;Fresh;81;71;17;4;21;3
Modern Times;1936;Certified-Fresh;100;95;61;0;61;13
Modigliani;2004;Rotten;4;78;1;23;24;12
Moebius;2014;Certified-Fresh;79;58;34;9;43;15
Mogambo;1953;Fresh;83;55;10;2;12;1
Mohawk;2018;Certified-Fresh;84;28;36;7;43;9
Mojados: Through the Night;2004;Fresh;80;88;8;2;10;5
Mojave;2016;Rotten;31;29;20;45;65;21
Mojin: The Lost Legend;2015;Rotten;56;56;5;4;9;4
Molly;1999;Rotten;14;53;3;19;22;7
The Molly Maguires;1970;Fresh;90;63;9;1;10;3
Molly's Game;2018;Certified-Fresh;81;84;242;55;297;47
Molokai: The Story of Father Damien;1999;Fresh;63;76;5;3;8;1
Mom and Dad;2018;Certified-Fresh;75;39;100;34;134;29
Mom and Dad Save the World;1992;Rotten;9;43;2;21;23;7
Mom and Me;2017;Fresh;100;44;8;0;8;2
Moments of Clarity;2016;Rotten;40;57;2;3;5;2
Momentum;2015;Rotten;26;27;8;23;31;6
Momentum Generation;1900;Fresh;100;100;6;0;6;2
Mommie Dearest;1981;Rotten;49;72;21;22;43;10
Mommy;2015;Certified-Fresh;89;89;114;15;128;37
Mommy Dead and Dearest;1900;Fresh;100;87;13;0;13;5
Moms' Night Out;2014;Rotten;20;66;9;35;44;16
Mon Oncle;1958;Fresh;92;89;24;2;26;5
Mona Lisa;1986;Fresh;97;81;29;1;30;6
Mona Lisa Smile;2003;Rotten;34;60;51;101;152;45
Monday Night Mayhem;2002;Fresh;67;71;4;2;6;2
Mondays in the Sun (Los Lunes al sol);2003;Certified-Fresh;80;87;55;14;69;23
Mondo Cane;1963;Rotten;50;52;5;5;10;0
Money Buys Happiness;1999;Rotten;40;;2;3;5;2
Money Monster;2016;Rotten;59;51;164;115;279;51
The Money Pit;1986;Rotten;48;58;10;11;21;1
Money Plane;1900;Rotten;25;46;3;9;12;0
Money Talks;1997;Rotten;16;71;3;16;19;7
Money Train;1995;Rotten;22;29;7;25;32;10
Moneyball;2011;Certified-Fresh;94;86;250;16;266;55
Mongol;2008;Certified-Fresh;86;76;89;14;103;35
Summer With Monika (Sommaren med Monika);1953;Fresh;100;83;15;0;15;5
Monk With a Camera;2014;Fresh;82;67;14;3;17;7
Monkey Shines: An Experiment in Fear;1988;Rotten;53;40;17;15;32;7
Monkey Trouble;1994;Rotten;50;41;6;6;12;2
Monkeybone;2001;Rotten;19;27;22;92;114;33
Monogamy;2011;Rotten;48;27;12;13;25;10
Monsieur Lazhar;2012;Certified-Fresh;97;86;116;3;119;42
Monsieur Verdoux;1947;Fresh;97;88;33;1;34;8
Monsoon Wedding;2002;Certified-Fresh;95;87;117;6;123;40
Monster;2004;Certified-Fresh;81;81;154;36;190;40
Monster Camp: The Story of NERO Seattle;2008;Fresh;64;52;9;5;14;6
Monster Family;2018;Rotten;10;22;2;19;21;4
Monster House;2006;Certified-Fresh;75;63;121;41;162;41
Monster Hunt (Zhuo Yao Ji);2016;Fresh;66;50;19;10;29;12
Monster-in-Law;2005;Rotten;18;55;31;139;170;44
Monster Party;2018;Fresh;76;50;16;5;21;3
Monster Road;2003;Fresh;86;86;6;1;7;1
The Monster Squad;1987;Fresh;62;78;16;10;26;5
The Monster That Challenged the World;1957;Fresh;67;35;4;2;6;0
Monster Trucks;2017;Rotten;32;51;31;66;97;25
Monsters;2010;Fresh;73;53;117;43;160;33
Monsters and Men;2018;Certified-Fresh;84;72;66;13;79;20
Monster's Ball;2002;Certified-Fresh;85;67;122;21;143;40
Monsters: Dark Continent;2015;Rotten;17;16;6;29;35;9
Monsters, Inc.;2001;Certified-Fresh;96;90;188;8;196;46
Monsters University;2013;Certified-Fresh;80;81;161;41;202;49
Monsters vs. Aliens;2009;Fresh;73;59;159;58;217;53
Monstrous;1900;Fresh;60;38;3;2;5;0
Monte Carlo;2011;Rotten;40;49;37;56;93;35
Montenegro;1981;Fresh;88;77;14;2;16;5
Monterey Pop;1968;Fresh;96;90;25;1;26;5
A Month by the Lake;1995;Fresh;71;58;12;5;17;4
Monty Python and the Holy Grail;1975;Certified-Fresh;97;95;76;2;78;20
Monty Python's Life of Brian;1979;Certified-Fresh;95;93;62;3;65;17
Monty Python's The Meaning of Life;1983;Fresh;86;83;30;5;35;3
L'ecume des jours (Mood Indigo);2014;Fresh;60;53;65;43;108;35
Moon;2009;Certified-Fresh;90;89;173;20;193;46
Moon over Parador;1988;Rotten;42;47;5;7;12;1
Moonlight;2016;Certified-Fresh;98;79;378;7;384;63
Moonlight and Valentino;1995;Rotten;15;52;2;11;13;3
Moonlight Mile;2002;Fresh;63;66;95;55;150;38
Moonrise;1948;Fresh;100;74;10;0;10;2
Moonrise Kingdom;2012;Certified-Fresh;94;86;245;17;262;57
Moonstruck;1987;Certified-Fresh;93;81;58;4;61;15
Moonwalkers;2016;Rotten;42;41;16;22;38;9
Mooz-lum;2011;Fresh;78;78;7;2;9;6
Mope;2020;Rotten;53;;9;8;17;2
More American Graffiti;1979;Rotten;20;33;2;8;10;1
More Than a Game;2009;Fresh;71;86;36;15;51;24
More Than Honey;2013;Fresh;100;79;39;0;39;18
More Than The Rainbow;2014;Fresh;80;;4;1;5;2
The More the Merrier;1943;Fresh;94;82;17;1;18;4
Morgan;2016;Rotten;38;30;57;95;152;34
Morlang;2003;Rotten;56;49;5;4;9;6
Morning Glory;2010;Rotten;55;51;99;80;179;52
Morning;2013;Rotten;45;14;5;6;11;8
The Morning After;1986;Fresh;63;38;12;7;19;1
Morning Light;2008;Rotten;33;50;11;22;33;15
Mortal Engines;2018;Rotten;26;49;48;138;186;35
Mortal Kombat;1995;Rotten;48;57;19;21;40;10
Mortal Kombat: Annihilation;1997;Rotten;2;25;1;42;43;13
Mortal Kombat Legends: Scorpion's Revenge;1900;Fresh;89;86;17;2;19;0
Mortal Thoughts;1991;Rotten;57;35;8;6;14;3
Mortdecai;2015;Rotten;12;30;13;97;110;25
Moscow, Belgium (Aanrijding in Moscou);2008;Certified-Fresh;93;80;37;3;40;20
Moscow On The Hudson;1984;Fresh;86;59;18;3;21;5
Moses and Aaron;1900;Fresh;100;;6;0;6;2
Mosquita Y Mari;2012;Fresh;87;70;13;2;15;8
The Mosquito Coast;1986;Fresh;76;61;16;5;21;2
Moss;2018;Fresh;75;89;6;2;8;5
Most Beautiful Island;2017;Certified-Fresh;93;46;43;3;46;13
The Most Dangerous Game;1932;Fresh;100;73;19;0;19;0
Most Likely to Die;2016;Rotten;40;10;2;3;5;1
Most Likely to Murder;1900;Fresh;62;46;8;5;13;1
Most Likely to Succeed;2019;Fresh;71;100;5;2;7;2
Most Wanted;2020;Fresh;69;49;25;11;36;6
Mostly Martha (Bella Martha);2001;Certified-Fresh;92;89;79;7;86;28
Mosul;1900;Fresh;100;100;5;0;5;1
Motel Hell;1980;Fresh;71;49;17;7;24;1
Mother Kusters Goes to Heaven;1975;Fresh;100;88;8;0;8;2
mother!;2017;Fresh;68;51;256;118;374;51
Mother and Child;2010;Certified-Fresh;78;76;100;28;128;38
Mother India;1957;Fresh;92;86;11;1;12;6
Mother, May I Sleep with Danger?;2016;Fresh;62;21;8;5;13;5
Mother Night;1996;Fresh;63;76;17;10;27;7
Mother Of George;2013;Certified-Fresh;93;65;40;3;43;22
Mother of Tears: The Third Mother;2007;Rotten;48;27;35;38;73;21
Motherhood;2009;Rotten;20;16;10;41;51;25
Mothers and Daughters;2016;Rotten;18;28;4;18;22;7
Mother's Day;1980;Rotten;42;38;5;7;12;3
Mother's Day;2012;Rotten;41;52;18;26;44;12
Mother's Day;2016;Rotten;8;44;12;146;158;39
Mother's Milk;1900;Rotten;43;33;3;4;7;2
The Mothman Prophecies;2002;Rotten;52;56;73;67;140;36
Mothra;1961;Fresh;75;62;9;3;12;0
Mothra vs. Godzilla (Mosura tai Gojira);1964;Fresh;92;68;12;1;13;0
Motorama;1992;Fresh;60;61;3;2;5;0
Moulin Rouge!;2001;Certified-Fresh;76;89;151;48;199;44
The Mountain Men;1900;Rotten;43;64;3;4;7;1
Mountain Men;2016;Fresh;80;42;8;2;10;5
Mountain Patrol (Kekexili);2006;Certified-Fresh;98;90;49;1;50;20
Mountains May Depart (Shan he gu ren);2016;Certified-Fresh;91;68;75;7;82;23
Mountains of the Moon;;Fresh;67;77;10;5;15;3
Mouse Hunt;1997;Rotten;42;49;13;18;31;9
The Mouse That Roared;1959;Fresh;90;73;18;2;20;0
La Moustache;2005;Certified-Fresh;86;66;37;6;43;19
Mouth to Mouth;2006;Rotten;54;50;15;13;28;9
Movie 43;2013;Rotten;4;24;4;85;89;22
Moving McAllister;2007;Rotten;10;29;1;9;10;1
Moving Midway;2008;Fresh;100;64;25;0;25;13
Mowgli: Legend of the Jungle;2018;Rotten;53;51;55;49;104;23
Mozart's Sister;2011;Certified-Fresh;74;54;45;16;61;24
Mr. Blandings Builds His Dream House;1948;Fresh;82;76;14;3;17;2
Mr. Lucky;1943;Fresh;100;69;6;0;6;3
Mr. Right;2006;Rotten;14;30;2;12;14;7
Mr. 3000;2004;Rotten;55;30;62;51;113;39
Mr. & Mrs. Smith;2005;Fresh;60;58;128;86;214;48
Mr. Arkadin;1962;Fresh;74;81;20;7;27;5
Mr. Baseball;1992;Rotten;13;41;2;14;16;1
Mr. Bean's Holiday;2007;Rotten;52;49;59;55;114;37
Mr. Brooks;2007;Rotten;55;76;88;72;160;49
Mr. Bug Goes to Town;1941;Fresh;71;65;5;2;7;1
Mr. Church;2016;Rotten;24;80;8;25;33;10
Mr. Deeds;2002;Rotten;22;59;34;122;156;34
Mr. Deeds Goes to Town;1936;Fresh;90;86;19;2;21;0
Mr. Destiny;;Rotten;38;55;6;10;16;3
Mr. Dynamite: The Rise of James Brown;1900;Fresh;100;86;11;0;11;6
Mr. Gaga: A True Story of Love and Dance;2017;Fresh;87;83;26;4;30;16
Mr. Hobbs Takes a Vacation;1962;Fresh;80;70;12;3;15;5
Mr. Holland's Opus;1995;Fresh;75;84;21;7;28;7
Mr. Holmes;2015;Certified-Fresh;88;70;164;22;186;44
Mr. Hulot's Holiday (Les Vacances de Monsieur Hulot);1954;Fresh;100;85;29;0;29;5
Mr. Jealousy;1998;Fresh;71;61;10;4;14;4
Mr. Jones;1993;Rotten;46;51;6;7;13;2
Mr. Jones;2014;Rotten;50;19;5;5;10;2
Mr. Magoo;1997;Rotten;7;24;2;28;30;10
Mr. Magorium's Wonder Emporium;2007;Rotten;38;55;48;77;125;36
Mr. Majestyk;1974;Fresh;77;67;10;3;13;1
Mr. Mom;1983;Fresh;82;57;18;4;22;1
Mr. Nanny;1993;Rotten;6;33;1;15;16;4
Mr. Nice;2011;Rotten;53;44;24;21;45;18
Mr. Nobody;2013;Fresh;68;76;21;10;31;6
Mr. North;1988;Rotten;50;41;4;4;8;1
Mr. Peabody & Sherman;2014;Certified-Fresh;81;73;111;26;137;29
Mr. Pip;2014;Rotten;47;62;8;9;17;5
Mr. Popper's Penguins;2011;Rotten;47;53;68;76;144;42
Mr. Right;2016;Rotten;45;56;24;29;53;18
Mr. Saturday Night;1992;Rotten;58;38;15;11;26;3
Mr. Skeffington;1944;Rotten;57;81;4;3;7;0
Mr. Smith Goes to Washington;1939;Certified-Fresh;96;94;43;2;45;5
Mr. Turner;2014;Certified-Fresh;97;56;187;6;193;50
Mr. Warmth: The Don Rickles Project;2008;Fresh;80;79;4;1;5;1
Mr. Wonderful;1993;Rotten;52;43;11;10;21;7
Mr. Woodcock;2007;Rotten;14;32;15;96;111;34
Mr. Wrong;1996;Rotten;7;26;2;27;29;8
Mrs. Brown;1997;Certified-Fresh;92;78;46;4;50;12
Mrs. Dalloway;1998;Fresh;71;57;24;10;34;10
Mrs. Doubtfire;1993;Fresh;71;77;37;15;52;10
Mrs. Henderson Presents;2006;Fresh;67;72;97;47;144;40
Mrs. Hyde (Madame Hyde);2018;Rotten;58;11;18;13;31;11
Mrs. Lowry & Son;2019;Fresh;61;82;22;14;36;11
Mrs. Miniver;1942;Fresh;93;85;28;2;30;9
Mrs. Palfrey at the Claremont;2005;Fresh;70;82;42;18;60;22
Mrs. Parker and the Vicious Circle (Mrs. Parker and the Round Table);1994;Fresh;75;61;24;8;32;11
Mrs. Serial Killer;1900;Rotten;17;54;2;10;12;0
Mrs. Winterbourne;1996;Rotten;10;63;3;27;30;11
Ms. 45;2013;Fresh;85;72;28;5;33;7
Much Ado About Nothing;2013;Certified-Fresh;86;77;151;24;175;44
Muck;2015;Rotten;0;15;0;7;7;2
Mud;2013;Certified-Fresh;97;80;175;6;181;44
Mudbound;2017;Certified-Fresh;97;85;191;6;197;42
Mugabe and the White African;2010;Fresh;97;90;35;1;36;15
Mughal-E-Azam;2005;Fresh;91;90;10;1;11;6
Mulan;1998;Certified-Fresh;86;85;66;11;77;16
Mulan II;2003;Rotten;0;42;0;5;5;0
Mulberry Street;2007;Fresh;73;37;8;3;11;0
The Mule;2014;Fresh;87;70;27;4;31;4
Mulholland Drive;2001;Certified-Fresh;83;87;150;30;180;40
Mulholland Falls;1996;Rotten;31;39;10;22;32;5
Multiple Maniacs;1970;Fresh;100;73;21;0;21;4
Multiple Sarcasms;2010;Rotten;9;24;2;20;22;10
Multiplicity;1996;Rotten;43;49;20;26;46;15
Mum & Dad;2008;Fresh;78;80;7;2;9;2
Mumford;1999;Rotten;57;66;46;35;81;21
Mumia: Long Distance Revolutionary;2013;Rotten;50;89;9;9;18;10
Mummies: Secrets of the Pharaohs;2007;Fresh;80;67;4;1;5;2
The Mummy Returns;2001;Rotten;47;63;66;74;140;36
The Mummy: Tomb of the Dragon Emperor;2008;Rotten;12;30;22;155;177;47
The Mummy's Curse;1944;Rotten;40;22;4;6;10;0
The Mummy's Ghost;1944;Rotten;33;20;2;4;6;0
The Mummy's Hand;1940;Fresh;67;49;6;3;9;0
The Mummy's Tomb;1942;Rotten;29;25;2;5;7;0
Munich;2005;Certified-Fresh;78;83;163;47;210;42
Munyurangabo;2009;Fresh;93;62;25;2;27;11
The Muppet Christmas Carol;1992;Certified-Fresh;76;85;37;12;49;14
The Muppet Movie;1979;Certified-Fresh;88;88;44;6;50;5
Muppet Treasure Island;1996;Fresh;73;77;19;7;26;5
Muppets From Space;1999;Fresh;63;58;36;21;57;23
Muppets Most Wanted;2014;Certified-Fresh;80;58;159;40;199;45
The Muppets Take Manhattan;1984;Fresh;83;76;19;4;23;4
Murder at 1600;1997;Rotten;33;42;11;22;33;7
Murder at the Vanities;1934;Fresh;75;38;6;2;8;0
Murder by Death;1976;Fresh;65;83;13;7;20;4
Murder by Decree;1979;Fresh;80;64;8;2;10;0
Murder in the First;1994;Rotten;50;80;18;18;36;11
Murder Is My Beat;1955;Fresh;100;45;5;0;5;0
Murder, My Sweet;1944;Fresh;94;87;16;1;17;0
Murder Mystery;1900;Rotten;43;42;29;38;67;12
Murder of a Cat;2014;Rotten;27;29;3;8;11;7
A Murder of Crows;1999;Rotten;0;57;0;5;5;0
Murder on the Orient Express;1974;Fresh;90;79;35;4;39;6
Murder On The Orient Express;2017;Fresh;61;53;177;114;291;48
Murder Party;1900;Fresh;100;57;6;0;6;1
Murder, Set, Pieces;2004;Rotten;36;25;4;7;11;4
Murder to Mercy: The Cyntoia Brown Story;1900;Fresh;79;46;11;3;14;5
Muriel ou Le Temps d'un Retour (The Time of Return);1963;Fresh;85;79;11;2;13;3
Muriel's Wedding;1995;Certified-Fresh;78;84;32;9;41;11
Murph: The Protector;2013;Fresh;78;90;7;2;9;3
Murphy's Law;1986;Rotten;40;45;2;3;5;0
Murphy's Romance;1985;Fresh;73;75;19;7;26;7
Muscle Shoals;2013;Certified-Fresh;97;89;83;3;86;33
The Muse;1999;Rotten;53;34;41;37;78;25
Museum Hours;2013;Certified-Fresh;94;61;67;4;70;28
Music and Lyrics;2007;Fresh;63;68;105;63;168;44
Music From Another Room;1997;Rotten;33;67;2;4;6;0
Music from the Big House;2012;Rotten;50;83;6;6;12;7
Music From the Inside Out;2005;Fresh;82;80;18;4;22;13
Music of the Heart;1999;Fresh;63;72;57;33;90;23
Music Within;2007;Rotten;33;78;14;28;42;20
Must Love Dogs;2005;Rotten;36;50;55;96;151;35
Mustang;2015;Certified-Fresh;97;88;145;4;149;35
Mutant Aliens;2001;Rotten;38;75;6;10;16;5
Mutant Chronicles;2008;Rotten;18;24;6;28;34;8
Mute;2018;Rotten;21;46;18;68;86;20
Mutual Appreciation;2006;Certified-Fresh;85;72;47;8;55;27
MVP: Most Valuable Primate;2000;Rotten;20;40;1;4;5;2
My Dog Tulip;2010;Certified-Fresh;90;69;54;6;60;23
My Girl 2;1996;Rotten;27;46;4;11;15;4
My Perestroika;2011;Fresh;92;77;24;2;26;13
My Sister Maria;1900;Rotten;58;60;7;5;12;6
My All American;2015;Rotten;31;77;14;31;45;17
My Amityville Horror;2013;Fresh;70;39;19;8;27;7
My Awkward Sexual Adventure;1900;Fresh;71;54;5;2;7;2
My Beautiful Girl, Mari;2002;Rotten;50;55;3;3;6;2
My Beautiful Laundrette;1985;Fresh;97;75;38;1;39;10
My Best Enemy;2013;Rotten;18;70;2;9;11;8
My Best Fiend (Mein liebster Feind - Klaus Kinski);1999;Fresh;80;92;20;5;25;6
My Best Friend;2007;Certified-Fresh;75;69;66;22;88;36
My Best Friend's Wedding;1997;Certified-Fresh;73;73;43;16;59;20
My Big Fat Greek Wedding;2002;Certified-Fresh;76;73;98;31;129;29
My Big Fat Greek Wedding 2;2016;Rotten;27;53;48;127;175;39
My Big Night (Mi Gran Noche);2016;Fresh;90;59;19;2;21;10
My Blind Brother;2016;Fresh;81;56;29;7;36;13
My Bloody Valentine;1981;Rotten;54;52;13;11;24;2
My Bloody Valentine 3-D;2009;Fresh;63;44;67;40;107;17
My Blueberry Nights;2007;Rotten;46;61;59;69;128;43
My Bodyguard;1980;Fresh;84;69;26;5;31;5
My Boss's Daughter;2003;Rotten;8;23;6;68;74;18
My Boyfriend's Back;1993;Rotten;14;45;3;19;22;8
My Brilliant Career;1979;Fresh;85;68;17;3;20;6
My Brother;2006;Rotten;30;65;3;7;10;6
My Brother The Devil;2013;Certified-Fresh;90;70;46;5;51;16
My Country, My Country;1900;Fresh;86;72;31;5;36;15
My Cousin Rachel;2017;Certified-Fresh;76;45;117;37;154;40
My Cousin Vinny;1992;Certified-Fresh;86;87;50;8;58;18
My Darling Clementine;1946;Fresh;100;86;31;0;31;2
My Date With Drew;2004;Fresh;71;57;46;19;65;25
My Days of Mercy;1900;Fresh;89;74;17;2;19;5
My Dead Boyfriend;2016;Rotten;0;29;0;11;11;3
My Dinner with Andre;1981;Fresh;92;85;22;2;24;1
My Dinner with Herve;1900;Fresh;83;81;19;4;23;12
My Dog Skip;2000;Fresh;73;68;60;22;82;25
My Entire High School Sinking Into the Sea;2017;Certified-Fresh;85;56;60;11;71;19
My Father and the Man in Black;2013;Fresh;65;81;13;7;20;12
My Father, Die;2017;Fresh;67;48;10;5;15;4
My Father, the Hero;1994;Rotten;14;54;2;12;14;3
My Father's Glory (La Gloria de Mon Pere);;Fresh;100;88;5;0;5;2
My Favorite Brunette;1947;Fresh;75;70;6;2;8;0
My Favorite Martian;1999;Rotten;12;30;5;37;42;10
My Favorite Season (Ma saison preferee);1996;Fresh;93;80;13;1;14;4
My Favorite Wife;1940;Fresh;85;82;11;2;13;4
My Favorite Year;1982;Fresh;96;84;26;1;27;1
My Fellow Americans;1996;Rotten;47;64;28;32;60;24
My First Mister;2002;Rotten;52;76;43;39;82;25
My First Wedding;2006;Rotten;0;26;0;7;7;2
My 5 Wives;2000;Rotten;0;45;0;5;5;0
My Flesh and Blood;2003;Fresh;90;93;27;3;30;11
My Friend Dahmer;2017;Certified-Fresh;86;61;89;15;104;25
My Friend Flicka;1944;Fresh;86;79;6;1;7;0
My Giant;1998;Rotten;19;25;5;22;27;7
My Golden Days (Trois Souvenirs De Ma Jeunesse);2016;Certified-Fresh;89;50;68;8;76;25
My Hindu Friend (Meu amigo Hindu);2020;Fresh;83;45;5;1;6;0
My Italian Secret: The Forgotten Heroes;2015;Fresh;80;69;4;1;5;2
My Journey Through French Cinema;2017;Certified-Fresh;100;57;41;0;41;14
My Joy;2011;Fresh;90;66;18;2;20;10
My Kid Could Paint That;2007;Certified-Fresh;94;78;78;5;83;30
My Last Five Girlfriends;2009;Rotten;32;40;6;13;19;6
My Left Foot;1989;Certified-Fresh;98;92;40;1;41;9
My Life;1993;Rotten;42;74;10;14;24;7
My Life as a Dog (Mitt Liv som Hund);1987;Fresh;100;90;34;0;34;3
My Life as a Zucchini (Ma vie de courgette);2017;Certified-Fresh;99;89;135;2;137;31
My Life Directed By Nicolas Winding Refn;2015;Rotten;58;40;14;10;24;7
My Life in Ruins;2009;Rotten;10;44;12;114;126;40
My Life So Far;1999;Fresh;70;54;19;8;27;6
My Life's In Turnaround;1994;Fresh;86;20;6;1;7;4
My Little Chickadee;1940;Fresh;91;63;10;1;11;0
My Little Pony: The Movie;2017;Rotten;46;76;30;35;65;15
My Love, Don't Cross That River;2016;Fresh;77;66;20;6;26;9
My Mistress;1900;Rotten;33;37;3;6;9;3
Le Chateau de Ma Mere (My Mother's Castle);;Fresh;67;87;6;3;9;3
My Name Is Joe (Mein Name ist Joe);1999;Fresh;88;86;23;3;26;6
My Name Is Khan;2010;Fresh;85;83;23;4;27;7
My Name is Myeisha;2020;Fresh;90;;9;1;10;2
My Name Is Nobody (Il mio nome e Nessuno);1973;Fresh;100;84;5;0;5;0
My Neighbor Totoro;1988;Certified-Fresh;94;94;50;3;53;12
My Neighbors the Yamadas;1999;Fresh;78;76;7;2;9;0
My Old Lady;2014;Fresh;62;43;57;35;92;28
My Own Private Idaho;1991;Certified-Fresh;80;80;47;12;59;17
My Piece of the Pie;2011;Rotten;46;34;6;7;13;6
My Reincarnation;2011;Fresh;73;71;11;4;15;7
My Side of the Mountain;1969;Fresh;83;56;5;1;6;2
My Son;2019;Fresh;61;20;14;9;23;6
My Son, My Son, What Have Ye Done;2010;Rotten;49;44;20;21;41;15
My Son the Fanatic;1999;Fresh;78;75;21;6;27;7
My Stepmother Is an Alien;1988;Rotten;19;30;3;13;16;1
My Sucky Teen Romance;1900;Fresh;71;50;5;2;7;1
My Summer of Love;2004;Certified-Fresh;90;69;84;9;93;35
My Super Ex-Girlfriend;2006;Rotten;39;31;52;80;132;37
My Uncle Rafael;2012;Rotten;20;82;1;4;5;3
My Way;2011;Rotten;21;77;4;15;19;11
My Way;2012;Rotten;20;82;3;12;15;9
My Week with Marilyn;2011;Certified-Fresh;83;71;154;31;185;48
My Worst Nightmare;2012;Fresh;67;28;8;4;12;8
Mysteries of Lisbon;2011;Certified-Fresh;86;71;49;8;57;28
The Mysteries of Pittsburgh;2009;Rotten;12;23;5;37;42;18
Mysteries Of The Jesus Prayer;1900;Rotten;20;100;1;4;5;3
Mysterious Skin;2005;Certified-Fresh;85;89;94;16;110;33
Mystery, Alaska;1999;Rotten;37;66;30;51;81;28
Mystery Men;1999;Fresh;61;57;63;41;104;29
Mystery Road;1900;Fresh;92;64;33;3;36;7
Mystery Science Theater 3000: The Movie;1996;Certified-Fresh;80;88;44;11;55;19
Mystic Pizza;1988;Fresh;75;55;18;6;24;6
Mystic River;2003;Certified-Fresh;88;89;181;25;206;49
The Myth Of The American Sleepover;2011;Certified-Fresh;81;51;39;9;48;26
Nabbeun namja (Bad Guy);2001;Rotten;44;67;14;18;32;12
Nacho Libre;2006;Rotten;40;54;66;100;166;38
Nadine;1987;Rotten;45;26;5;6;11;1
Nail in the Coffin: The Fall and Rise of Vampiro;2020;Fresh;100;;11;0;11;0
Nails;2017;Rotten;40;23;6;9;15;1
Naked;1900;Rotten;0;31;0;8;8;2
Naked Ambition: An R Rated Look at an X Rated Industry;2009;Rotten;38;37;3;5;8;2
Naked Boys Singing;2007;Fresh;67;49;8;4;12;5
Naked Fame;2005;Rotten;50;47;4;4;8;3
The Naked Gun 2 1/2: The Smell of Fear;1991;Rotten;56;65;23;18;41;8
The Naked Jungle;1954;Fresh;86;60;6;1;7;0
The Naked Man;1998;Rotten;20;34;1;4;5;0
The Naked Prey;1966;Fresh;86;79;12;2;14;1
The Naked Spur;1953;Fresh;100;75;13;0;13;1
The Namesake;2006;Certified-Fresh;85;79;115;20;135;42
Nancy Drew;2007;Rotten;50;59;68;69;137;48
Nancy Drew and the Hidden Staircase;2019;Fresh;68;59;17;8;25;6
Nanking;2007;Certified-Fresh;96;88;45;2;47;18
The Nanny Diaries;2007;Rotten;34;51;45;87;132;48
Nanny McPhee;2006;Certified-Fresh;73;64;99;36;135;34
Nanny McPhee Returns;2010;Certified-Fresh;76;55;91;29;120;37
Nanook of the North;1922;Fresh;100;80;30;0;30;5
Napoleon Dynamite;2004;Fresh;71;74;124;50;174;41
Nappily Ever After;1900;Fresh;71;73;10;4;14;3
Napping Princess (Hirune-hime: Shiranai watashi no monogatari);2017;Fresh;67;53;12;6;18;6
Naqoyqatsi (Naqoyqatsi: Life as War);2002;Rotten;48;70;25;27;52;17
Narayama bushiko (Ballad of Narayama);1958;Fresh;86;90;6;1;7;0
Narc;2002;Certified-Fresh;84;79;132;26;158;35
Narcissister Organ Player;2018;Fresh;71;;5;2;7;5
Narco Cultura;2013;Certified-Fresh;89;77;39;5;44;17
Narcopolis;2015;Rotten;18;25;2;9;11;5
Nas: Time Is Illmatic;2014;Certified-Fresh;98;83;39;1;40;17
NASCAR: The IMAX Experience;2004;Fresh;61;88;27;17;44;20
Nashville;1975;Certified-Fresh;90;84;56;6;62;14
Nasty Baby;2015;Fresh;68;40;38;18;56;18
Das Schreckliche Madchen (The Nasty Girl);;Fresh;67;74;4;2;6;1
Nate and Hayes;1983;Rotten;0;59;0;6;6;2
Nate & Margaret;2012;Fresh;80;51;8;2;10;5
National Lampoon Presents The Beach Party at the Threshold of Hell;2006;Fresh;67;45;4;2;6;2
National Lampoon's Gold Diggers;2004;Rotten;0;20;0;44;44;15
National Lampoon's Pledge This!;2006;Rotten;0;18;0;6;6;1
National Lampoon's Animal House;1978;Certified-Fresh;90;89;46;5;51;9
National Lampoon's Blackball;2005;Rotten;41;42;9;13;22;5
National Lampoon's Christmas Vacation;1989;Fresh;67;86;31;15;46;9
National Lampoon's European Vacation;1985;Rotten;34;49;10;19;29;6
Homo Erectus (National Lampoon's The Stoned Age);2007;Rotten;17;10;1;5;6;2
National Lampoon's Loaded Weapon 1;1993;Rotten;23;49;8;27;35;9
National Lampoon's Movie Madness;1982;Rotten;0;20;0;5;5;0
National Lampoon's Senior Trip;1995;Rotten;0;55;0;8;8;1
National Lampoon's Vacation;1983;Certified-Fresh;93;85;41;3;44;5
National Lampoon's Van Wilder;2002;Rotten;18;73;18;80;98;28
National Security;2003;Rotten;11;45;10;80;90;28
National Treasure;2004;Rotten;46;76;82;97;179;43
National Treasure: Book of Secrets;2007;Rotten;36;67;47;83;130;30
National Velvet;1944;Fresh;100;78;26;0;26;7
Nativity!;1900;Rotten;48;65;13;14;27;7
Nativity 2;2013;Rotten;36;49;8;14;22;5
The Nativity Story;2006;Rotten;37;76;49;82;131;39
The Natural;1984;Certified-Fresh;81;88;35;8;43;8
Natural Born Killers;1994;Rotten;48;81;19;21;40;9
Natural City;2004;Rotten;57;46;4;3;7;0
Natural Resistance;2015;Fresh;88;50;7;1;8;5
Natural Selection;2012;Fresh;74;68;26;9;35;18
Nature Calls;2012;Rotten;5;17;1;21;22;9
The Nature of Existence;2010;Fresh;64;65;14;8;22;8
Nausicaa of the Valley of the Wind (Kaze no tani no Naushika);1985;Fresh;88;91;15;2;17;2
Tell No One (Ne le Dis a Personne);2006;Certified-Fresh;94;87;111;7;118;38
Ne Te Retourne Pas (Don't Look Back);2009;Rotten;33;42;2;4;6;2
Ne Zha;2019;Fresh;88;98;15;2;17;4
Neal Brennan: 3 Mics;1900;Fresh;100;80;7;0;7;3
Nebraska;2013;Certified-Fresh;91;83;225;23;247;56
Necessary Roughness;1991;Rotten;33;46;10;20;30;11
Neds;2011;Fresh;94;71;32;2;34;10
Need For Speed;2014;Rotten;22;57;41;144;185;41
Needful Things;1993;Rotten;31;44;8;18;26;4
Negocios Sucios;1900;Fresh;64;51;9;5;14;4
Neighbors;2014;Certified-Fresh;73;63;162;60;222;53
Neighbors 2: Sorority Rising;2016;Fresh;64;44;130;74;204;39
Neil Young Journeys;2012;Certified-Fresh;89;59;56;7;63;26
Nekrotronic;2019;Rotten;39;76;9;14;23;5
Nell;1994;Rotten;55;64;18;15;33;4
Nemesis;1900;Fresh;60;40;3;2;5;0
Neo Ned;2005;Fresh;80;75;4;1;5;2
Neon Bull (Boi Neon);2016;Certified-Fresh;88;68;44;6;50;12
Neptune's Daughter;1949;Fresh;100;59;5;0;5;2
The Betrayal - Nerakhoon;2008;Fresh;93;72;28;2;30;15
Nerdland;1900;Rotten;21;28;3;11;14;2
Nerve;2016;Fresh;67;66;92;47;138;38
The Net;1995;Rotten;41;44;20;29;49;11
Netizens;1900;Fresh;92;88;12;1;13;3
Network;1976;Certified-Fresh;91;93;62;6;68;11
Nevada Smith;1966;Rotten;50;65;4;4;8;0
Never Apologize: A Personal Visit With Lindsay Anderson;2007;Fresh;67;58;8;4;12;8
Never Back Down;2008;Rotten;23;34;19;65;84;25
Never Be Done: The Richard Glen Lett Story;1900;Fresh;100;98;5;0;5;0
Never Been Kissed;1999;Rotten;55;69;49;40;89;30
Never Been Thawed;2005;Rotten;58;62;14;10;24;10
Never Cry Wolf;1983;Fresh;100;83;19;0;19;5
Never Die Alone;2004;Rotten;26;61;24;68;92;28
Never Grow Old;2019;Fresh;90;62;19;2;21;5
Never Let Me Go;2010;Fresh;70;70;127;54;181;42
Never Rarely Sometimes Always;2020;Certified-Fresh;99;20;193;2;195;34
Never Say Never Again;1983;Fresh;67;37;35;17;52;9
Never Sleep Again: The Elm Street Legacy;2010;Fresh;100;94;7;0;7;0
Never So Few;1960;Rotten;40;34;2;3;5;0
Never Talk to Strangers;1995;Rotten;15;39;3;17;20;6
Never Too Late;2020;Rotten;50;50;8;8;16;5
New Police Story (San ging chaat goo si);2006;Rotten;50;76;4;4;8;1
New Port South;1999;Rotten;0;53;0;5;5;1
New York City Serenade;2007;Rotten;8;23;1;12;13;6
The New Adventures of Pippi Longstocking;1988;Rotten;17;67;1;5;6;0
New Best Friend;2002;Rotten;5;39;2;36;38;12
The New Daughter;2009;Rotten;33;24;3;6;9;2
New Guy;2004;Fresh;63;42;5;3;8;3
New In Town;2009;Rotten;28;37;47;123;170;53
New Jack City;1991;Fresh;77;80;23;7;30;9
New Jersey Drive;1995;Fresh;64;84;7;4;11;5
A New Kind of Love;1963;Rotten;14;51;1;6;7;3
A New Leaf;1971;Fresh;100;83;35;0;35;7
A New Life;1988;Rotten;29;28;2;5;7;1
New Life;2016;Rotten;29;63;2;5;7;1
New Money;1900;Fresh;60;;3;2;5;0
The New Twenty;2009;Rotten;50;18;7;7;14;7
New World;2013;Fresh;63;86;10;6;16;6
New Year's Eve;2011;Rotten;7;45;10;131;141;37
New York Doll;2005;Certified-Fresh;90;88;46;5;51;16
New York, I Love You;2009;Rotten;37;37;37;62;99;35
New York Minute;2004;Rotten;11;47;13;106;119;31
Lo Squartatore di New York (The New York Ripper);1982;Rotten;14;54;1;6;7;0
New York Stories;1989;Fresh;75;56;18;6;24;6
Newcastle;2008;Fresh;61;51;11;7;18;6
Newly Single;2018;Fresh;88;84;7;1;8;1
Newlyweds;2012;Fresh;73;53;8;3;11;3
Newlyweeds;2013;Fresh;71;71;12;5;17;10
Newness;1900;Fresh;69;60;11;5;16;4
Newsies;1992;Rotten;39;88;15;23;38;16
The Newton Boys;1998;Fresh;63;44;24;14;38;10
Newtown;2016;Fresh;94;68;33;2;35;16
Next;2007;Rotten;28;53;37;93;130;28
The Next Best Thing;2000;Rotten;19;35;18;75;93;29
Next Day Air;2009;Rotten;21;31;14;52;66;24
Next Friday;2000;Rotten;22;76;14;51;65;22
Next Gen;2018;Fresh;80;67;4;1;5;1
Next Goal Wins;2014;Fresh;100;89;30;0;30;9
The Next Karate Kid;1994;Rotten;7;24;2;25;27;8
Next Stop Wonderland;1998;Certified-Fresh;75;74;33;11;44;10
The Next Three Days;2010;Rotten;50;66;84;83;167;41
Daughter of the Nile (Ni luo he nu er);1987;Fresh;100;86;6;0;6;1
Niagara;1953;Fresh;80;68;16;4;20;4
Nick and Norah's Infinite Playlist;2008;Certified-Fresh;75;65;138;47;185;48
Nick of Time;1995;Rotten;32;47;10;21;31;5
Nickelodeon;1976;Rotten;9;47;1;10;11;5
Nicky's Family;2013;Fresh;64;86;14;8;22;13
Nicotina;2004;Rotten;45;73;21;26;47;14
Night Across the Street;2013;Fresh;95;57;18;1;19;9
Nuit et Brouillard (Night and Fog);1955;Fresh;100;95;24;0;24;2
Night at the Golden Eagle;2002;Rotten;41;62;7;10;17;6
Night at the Museum;2006;Rotten;43;67;59;79;138;37
Night at the Museum 2: Battle of the Smithsonian;2009;Rotten;45;47;75;93;168;45
Night at the Museum: Secret of the Tomb;2014;Rotten;47;57;53;59;112;37
A Night at the Roxbury;1998;Rotten;11;69;6;49;55;11
Night Catches Us;2010;Certified-Fresh;81;66;46;11;57;18
Night Comes On;2018;Certified-Fresh;98;79;48;1;49;11
Night Crossing;1982;Fresh;80;65;4;1;5;0
Night Falls on Manhattan;1997;Fresh;69;66;20;9;29;6
Night Hunter (Nomis);2019;Rotten;14;53;5;30;35;8
A Night in Casablanca;1946;Rotten;57;70;4;3;7;0
Night Moves;1900;Fresh;83;71;15;3;18;5
Night Moves;2014;Certified-Fresh;86;42;131;21;152;52
Night of the Creeps;1986;Fresh;75;70;15;5;20;0
Night of the Demons;1988;Rotten;36;55;4;7;11;0
Night of the Demons;2010;Rotten;33;25;6;12;18;5
The Night of the Generals;1967;Rotten;50;70;3;3;6;0
The Night of the Hunter;1955;Certified-Fresh;95;90;71;4;75;15
The Night of the Iguana;1964;Fresh;71;85;10;4;14;4
Night of the Lepus;1972;Rotten;8;26;1;11;12;2
Night of the Living Dead;;Fresh;66;68;21;11;32;4
Night of the Living Deb;2014;Fresh;88;29;7;1;8;0
Die Nacht der lebenden Loser (Night of the Living Dorks);2005;Rotten;33;65;2;4;6;0
La Notte di San Lorenzo (Night of the Shooting Stars) (The Night of San Lorenzo);1982;Fresh;77;76;10;3;13;3
Night on Earth;1991;Fresh;75;91;18;6;24;6
Il portiere di notte (The Night Porter);1974;Fresh;64;69;16;9;25;5
Night School;2018;Rotten;26;38;37;104;140;31
Night Shift;1982;Fresh;92;63;22;2;24;6
Night Sweats;2019;Rotten;46;;6;7;13;0
Night Tide;1963;Fresh;83;52;5;1;6;0
Night Train To Lisbon;2013;Rotten;41;61;12;17;29;8
Night Watch;1900;Rotten;38;60;3;5;8;3
Night Watch;2006;Fresh;60;72;79;53;132;37
Night Will Fall;1900;Fresh;100;93;23;0;23;11
Nightbreed;;Rotten;39;60;11;17;28;2
The Nightcomers;1972;Rotten;57;42;4;3;7;0
Nightcrawler;2014;Certified-Fresh;95;85;257;14;271;59
Nightingale;1900;Fresh;82;60;18;4;22;15
Nightjohn;1996;Fresh;100;83;9;0;9;7
Nightlight;2015;Rotten;14;12;1;6;7;4
The Nightmare Before Christmas;1993;Certified-Fresh;95;91;91;5;96;25
Nightmare Cinema;2019;Certified-Fresh;77;44;34;10;44;10
Incubo sulla citta contaminata (Nightmare City) (Invasion by the Atomic Zombies);1980;Rotten;40;40;2;3;5;0
Nightmare Man;2006;Rotten;56;18;5;4;9;2
A Nightmare on Elm Street;1984;Certified-Fresh;94;83;50;3;53;7
A Nightmare on Elm Street;2010;Rotten;15;43;27;154;181;35
Nightmares;1983;Rotten;29;32;2;5;7;2
Nightmares in Red, White and Blue;2009;Fresh;100;78;6;0;6;2
Nights in Rodanthe;2008;Rotten;31;52;41;93;134;34
Nights of Cabiria (Le Notti di Cabiria);1957;Fresh;97;94;37;1;38;11
Nijinsky;1980;Rotten;43;29;3;4;7;1
Nim's Island;2008;Rotten;51;46;54;51;105;29
Nina's Heavenly Delights;2007;Rotten;16;63;3;16;19;11
Nine;2009;Rotten;39;37;81;126;207;53
Nine Lives;2016;Rotten;14;41;10;62;72;17
The Nine Lives of Fritz the Cat;1974;Rotten;38;41;3;5;8;0
Nine Months;1995;Rotten;26;37;7;20;27;7
Ninja: Shadow of a Tear;1900;Fresh;100;42;5;0;5;0
Ninotchka;1939;Fresh;97;89;34;1;35;7
The Ninth Configuration (Twinkle, Twinkle, Killer Kane);1980;Fresh;77;76;10;3;13;1
The Ninth Gate;1999;Rotten;43;57;39;51;90;26
Nitro Circus: The Movie 3D;2012;Rotten;6;62;1;17;18;6
Nixon;1995;Certified-Fresh;74;74;46;16;62;19
No Blade of Grass;1970;Rotten;40;41;2;3;5;2
No;2013;Certified-Fresh;93;80;123;9;132;41
No Alternative;1900;Fresh;83;;5;1;6;2
No Clue;1900;Rotten;40;49;2;3;5;2
No Country for Old Men;2007;Certified-Fresh;93;86;268;19;287;64
No End in Sight;2007;Certified-Fresh;96;94;94;4;98;32
No Escape;2015;Rotten;47;62;73;82;155;37
No Escape (Follow Me);1900;Rotten;20;63;2;8;10;0
No God, No Master;2014;Fresh;73;47;11;4;15;6
No Good Deed;2003;Rotten;25;25;3;9;12;5
No Good Deed;2014;Rotten;12;55;7;50;57;18
For No Good Reason;2014;Fresh;62;59;38;23;61;29
No Holds Barred;1989;Rotten;10;34;2;19;21;6
No Manches Frida;2016;Rotten;13;73;1;7;8;0
No Manches Frida 2;2019;Rotten;13;28;1;7;8;2
No Man's Land;2001;Certified-Fresh;93;93;91;7;98;27
No Men Beyond This Point;1900;Rotten;50;47;4;4;8;2
No No: A Dockumentary;2014;Fresh;97;81;31;1;32;12
No One Killed Jessica;2011;Fresh;80;67;8;2;10;3
No One Knows About Persian Cats (Les Chats Persans);2010;Certified-Fresh;95;76;58;3;61;22
No One Lives;2013;Rotten;48;42;19;21;40;10
No Pay, Nudity;2016;Fresh;71;27;5;2;7;3
No Place On Earth;2013;Certified-Fresh;80;72;32;8;40;14
No Reservations;2007;Rotten;42;62;68;94;162;47
No se aceptan devoluciones (Instructions Not Included);2013;Rotten;57;89;12;9;21;4
No Small Affair;1984;Rotten;57;33;4;3;7;1
No Small Matter;2020;Fresh;100;100;10;0;10;3
No Stranger Than Love;2016;Rotten;7;16;1;13;14;8
No Strings Attached;2011;Rotten;49;51;84;88;172;49
No Such Thing;2002;Rotten;30;58;13;30;43;15
No Tears For The Dead;2014;Rotten;33;54;2;4;6;2
No Turning Back;2001;Fresh;60;40;6;4;10;2
No Way to Treat a Lady;1968;Fresh;89;75;8;1;9;0
Noah;2014;Certified-Fresh;76;41;198;63;261;57
Noah's Arc: Jumping the Broom;2008;Rotten;42;74;5;7;12;9
Nobelity;2006;Rotten;50;92;3;3;6;3
Noble;2015;Fresh;82;72;28;6;34;10
Nobody Else But You;2012;Fresh;83;67;25;5;30;12
Nobody Walks;2012;Rotten;41;23;17;24;41;22
Nobody's Fool;2018;Rotten;24;35;10;32;42;12
Nocturnal Animals;2016;Certified-Fresh;74;73;219;77;296;44
Noel;2004;Rotten;28;48;10;26;36;13
Noelle;2007;Rotten;57;55;4;3;7;3
Noi the Albino (Noi albinoi);2003;Certified-Fresh;87;85;45;7;52;16
Noise;2007;Fresh;83;71;5;1;6;1
Noises Off;1992;Fresh;61;84;14;9;23;1
Nola;2003;Rotten;0;44;0;13;13;8
Noma: My Perfect Storm;2015;Rotten;57;42;12;9;21;6
Nomad;2007;Rotten;6;40;1;15;16;8
Nomads;1986;Rotten;30;37;3;7;10;1
The Nomi Song;2005;Fresh;94;86;33;2;35;15
Non Ma Fille, Tu N'iras Pas Danser (Making Plans for Lena);2010;Rotten;50;44;4;4;8;5
The Living Dead at Manchester Morgue;1974;Fresh;86;71;18;3;21;1
Non-Stop;2014;Fresh;62;63;139;86;225;49
Norbit;2007;Rotten;9;53;11;113;124;36
Norm Macdonald: Hitler's Dog, Gossip & Trickery;1900;Fresh;100;;6;0;6;3
Norm of the North;2016;Rotten;9;22;6;63;69;19
Normal Life;1996;Fresh;70;48;7;3;10;2
Norman;2011;Fresh;67;58;10;5;15;10
Norman (Norman: The Moderate Rise and Tragic Fall of a New York Fixer);2017;Certified-Fresh;88;57;110;15;125;32
Norman Lear: Just Another Version of You;2016;Certified-Fresh;86;67;37;6;43;15
Norte, the End of History;2014;Certified-Fresh;93;79;37;3;40;13
North;1994;Rotten;14;27;5;30;35;13
North by Northwest;1959;Certified-Fresh;99;94;77;1;78;18
The North Avenue Irregulars;1979;Fresh;78;79;7;2;9;0
North Country;2005;Fresh;69;76;121;54;175;42
North Dallas Forty;1979;Fresh;84;70;21;4;25;6
North Face (Nordwand);2010;Certified-Fresh;84;82;49;9;58;23
Noordzee, Texas (North Sea Texas);2012;Fresh;83;71;24;5;29;12
North to Alaska;1960;Rotten;50;76;4;4;8;0
Northern Borders;2015;Rotten;40;50;2;3;5;4
Northern Light;2014;Fresh;83;60;5;1;6;3
Northern Soul;2015;Fresh;76;57;29;9;38;14
Northfork;2003;Rotten;56;66;58;45;103;34
Northwest Passage;1940;Fresh;100;69;6;0;6;0
Norwegian Wood;2012;Certified-Fresh;74;49;49;17;66;27
Nos enfants nous accuseront (Food Beware: The French Organic Revolution);2008;Rotten;57;62;8;6;14;7
Nosferatu, a Symphony of Horror (Nosferatu, eine Symphonie des Grauens) (Nosferatu the Vampire);1922;Certified-Fresh;97;87;64;2;66;14
Nosferatu: Phantom der Nacht (Nosferatu the Vampyre);1979;Certified-Fresh;95;83;56;3;59;14
Nostalgia (Nostalghia);1984;Fresh;86;90;19;3;22;4
Nostalgia;2018;Rotten;39;46;22;34;56;20
Nostalgia for the Light;2011;Certified-Fresh;100;84;47;0;47;17
Not Another Happy Ending;2013;Rotten;31;36;5;11;16;4
Not Another Teen Movie;2001;Rotten;29;55;29;70;99;23
Not as a Stranger (Morton Thompson's Not as a Stranger);1955;Rotten;11;54;1;8;9;3
Not Cool;2014;Rotten;14;72;1;6;7;3
Not Easily Broken;2009;Rotten;31;67;21;47;68;21
Not Fade Away;2012;Fresh;70;42;63;27;90;33
Not One Less;2000;Certified-Fresh;96;90;43;2;45;11
Not Quite Hollywood: The Wild, Untold Story of Ozploitation!;2008;Certified-Fresh;95;80;63;3;66;20
Not Suitable for Children;1900;Fresh;88;53;15;2;17;0
Not Today;2013;Rotten;50;84;3;3;6;2
Not Wanted;1949;Fresh;80;42;4;1;5;1
Not Without My Daughter;1991;Rotten;50;71;8;8;16;3
Not Yet Begun to Fight;2013;Fresh;88;;7;1;8;6
Note by Note: The Making of Steinway L1037;2007;Fresh;90;88;19;2;21;12
The Notebook;2004;Rotten;53;85;94;84;178;44
Notes From The Field;1900;Fresh;100;67;6;0;6;2
Notes on a Scandal;2006;Certified-Fresh;87;83;152;22;174;46
Notes on Blindness;2016;Certified-Fresh;95;70;38;2;40;12
Nothing Bad Can Happen;2014;Fresh;71;64;20;8;28;8
Nothing But the Blood;1900;Rotten;0;;0;5;5;0
Nothing But the Truth;2008;Certified-Fresh;82;73;49;11;60;20
Nothing but Trouble;1900;Rotten;5;47;1;21;22;7
Nothing in Common;1986;Rotten;57;40;13;10;23;5
Nothing Left to Fear;2013;Rotten;9;16;1;10;11;5
Nothing Like the Holidays;2008;Rotten;54;42;53;46;99;31
The Notorious Bettie Page;2006;Rotten;57;51;76;58;134;47
La Notte;1961;Fresh;84;91;21;4;25;5
Notting Hill;1999;Certified-Fresh;83;79;83;17;100;30
Nous ne vieillirons pas ensemble (We Won't Grow Old Together);1972;Fresh;100;73;8;0;8;3
November Criminals;2017;Rotten;0;23;0;11;11;5
Novitiate;2017;Certified-Fresh;86;69;87;14;101;33
Novocaine;2001;Rotten;38;38;41;66;107;31
Now & Later;2011;Rotten;25;44;3;9;12;5
Now and Then;1995;Rotten;32;82;6;13;19;5
Now Is Good;1900;Rotten;56;64;15;12;27;5
Now, Voyager;1942;Fresh;93;90;26;2;28;0
Now You See Him, Now You Don't;1972;Fresh;80;57;4;1;5;2
Now You See Me;2013;Rotten;51;70;85;83;168;35
Now You See Me 2;2016;Rotten;33;53;64;129;193;40
Nowhere Boy;2010;Certified-Fresh;80;74;117;30;147;40
Nowhere to Hide;2000;Rotten;47;55;9;10;19;6
Nuclear Nation;2013;Fresh;90;75;9;1;10;7
Number Seventeen (Number 17);1932;Fresh;63;22;5;3;8;2
Number 37 (Nommer 37);2018;Fresh;93;72;14;1;15;4
Nurse;2014;Fresh;61;28;14;9;23;4
Nurse Betty;2000;Certified-Fresh;83;45;109;22;131;38
Nursery University;2009;Fresh;82;61;9;2;11;7
Nuts;1987;Rotten;33;72;8;16;24;6
Nutty Professor II: The Klumps;2000;Rotten;26;33;23;65;88;24
Ny Export: Opus Jazz;2010;Fresh;80;;4;1;5;2
O;2001;Fresh;64;58;80;45;125;34
O Brother, Where Art Thou?;2000;Certified-Fresh;77;89;117;34;151;38
O Lucky Man!;1900;Fresh;78;87;14;4;18;3
O Som ao Redor (Neighbouring Sounds);2012;Fresh;92;76;36;3;39;17
Oasis;2003;Fresh;90;84;27;3;30;12
Oasis: Supersonic;2016;Certified-Fresh;84;87;46;9;55;17
The Object of Beauty;1991;Fresh;77;38;10;3;13;3
The Object of My Affection;1998;Rotten;52;51;30;28;58;18
Objectified;2009;Fresh;81;76;13;3;16;11
Oblivion;2013;Rotten;53;61;135;120;255;49
Obscene;2008;Fresh;92;79;23;2;25;11
Observe and Report;2009;Rotten;51;37;109;104;213;51
Obvious Child;2014;Certified-Fresh;90;72;149;16;165;49
Occupation;2018;Rotten;50;88;10;10;20;5
Ocean Waves (Umi ga kikoeru);2016;Fresh;88;66;15;2;17;4
Ocean's 11;1960;Rotten;48;81;15;16;31;8
Ocean's 8;2018;Fresh;69;45;246;111;357;57
Ocean's Eleven;2001;Certified-Fresh;82;80;146;31;177;37
Ocean's Thirteen;2007;Fresh;70;75;139;60;199;54
Ocean's Twelve;2004;Rotten;55;60;101;84;185;42
The Octagon;1980;Rotten;33;31;2;4;6;0
October Baby;2012;Rotten;25;79;10;30;40;14
October Country;2009;Fresh;88;67;28;4;32;16
October Gale;2015;Rotten;19;20;5;22;27;13
October Sky;1999;Certified-Fresh;91;88;67;7;74;16
Octopussy;1983;Rotten;43;47;21;28;49;9
Oculus;2014;Certified-Fresh;74;53;114;40;154;35
Odd Brodsky;1900;Fresh;100;83;6;0;6;0
The Odd Couple II;1998;Rotten;27;56;8;22;30;9
Odd Thomas;2014;Rotten;38;65;18;29;47;13
Oddball and the Penguins (Oddball);1900;Fresh;87;62;20;3;23;6
Ode to Billy Joe;1976;Rotten;20;80;1;4;5;1
Ode to Joy;2019;Rotten;45;69;13;16;29;6
Of Gods and Men;2011;Certified-Fresh;93;75;111;9;120;34
Of Love and Shadows;1996;Rotten;20;33;1;4;5;0
Of Men And War;1900;Fresh;100;50;14;0;14;6
Of Unknown Origin;1983;Rotten;57;41;4;3;7;0
Off the Map;2003;Fresh;70;84;66;28;94;27
Off and Running;2010;Fresh;88;73;14;2;16;5
The Offence;1973;Fresh;71;72;10;4;14;5
Office Christmas Party;2016;Rotten;41;40;75;110;185;36
Office Space;1999;Certified-Fresh;80;93;81;20;101;27
An Officer and a Gentleman;1982;Fresh;79;81;22;6;28;6
Officer Downe;2016;Rotten;33;30;4;8;12;2
Official Secrets;2019;Certified-Fresh;82;89;134;29;163;35
La Historia Oficial (The Official Story);1985;Fresh;100;89;11;0;11;2
Offside;2006;Certified-Fresh;94;74;79;5;84;29
The Garden of Earthly Delights;2006;Fresh;67;63;4;2;6;5
Oh, God!;1977;Fresh;72;60;18;7;25;4
Oh, God! Book II;1980;Rotten;50;38;3;3;6;1
Oh, God! You Devil;1984;Rotten;36;39;4;7;11;3
Oh, Hello On Broadway;1900;Fresh;88;81;7;1;8;2
Oh! What A Lovely War;1969;Fresh;79;72;11;3;14;4
O' Horten;2007;Certified-Fresh;91;63;78;8;86;36
OKA!;2011;Fresh;71;43;10;4;14;9
Okami kodomo no ame to yuki (The Wolf Children Ame and Yuki);1900;Fresh;95;92;18;1;19;6
Okja;2017;Certified-Fresh;86;81;203;32;235;45
Oklahoma!;1900;Fresh;88;76;23;3;26;8
The General Line (Generalnaya liniya);1929;Fresh;100;65;5;0;5;2
Old Fashioned;2015;Rotten;18;84;4;18;22;6
Old Goats;2014;Fresh;62;61;8;5;13;6
Old Gringo;1989;Rotten;42;48;5;7;12;1
Old Joy;2006;Certified-Fresh;85;71;79;14;93;33
Old School;2003;Fresh;60;86;100;67;167;37
Old Stone (Lao Shi);2016;Fresh;94;60;29;2;31;13
Old Yeller;1957;Fresh;100;79;21;0;21;3
Oldboy;2005;Certified-Fresh;82;94;121;27;148;40
Oldboy;2013;Rotten;40;37;59;90;149;46
Oleanna;1994;Rotten;53;61;9;8;17;2
Oliver!;1968;Fresh;82;81;28;6;34;8
Oliver & Company;1988;Rotten;50;62;25;25;50;13
Oliver Twist;1951;Fresh;100;84;24;0;24;4
Oliver's Story;1978;Rotten;29;26;2;5;7;0
Olivia (The Pit of Loneliness);2019;Fresh;100;67;9;0;9;2
Olympic Dreams;2020;Fresh;70;58;33;14;47;7
Olympic Pride, American Prejudice;2016;Fresh;100;49;8;0;8;6
Olympus Has Fallen;2013;Rotten;49;66;97;100;197;40
Om Shanti Om;2007;Fresh;76;77;13;4;17;4
Omar;2014;Certified-Fresh;90;84;78;9;87;36
The Omega Man;1971;Fresh;65;53;22;12;34;5
The Omen;2006;Rotten;26;40;44;124;168;41
Omen IV - The Awakening;1991;Rotten;17;23;1;5;6;0
On the Bowery;1957;Fresh;96;88;23;1;24;9
On a Clear Day You Can See Forever;1970;Fresh;100;74;10;0;10;1
On a Magical Night (Chambre 212);2020;Fresh;65;23;20;11;31;10
On Any Sunday;1971;Fresh;83;85;5;1;6;3
On Any Sunday, The Next Chapter;2014;Rotten;54;86;7;6;13;7
On Body and Soul (A Testrol es Lelekrol);2018;;;85;70;8;;12
On Chesil Beach;2018;Fresh;68;62;112;53;165;39
On Dangerous Ground;1952;Fresh;94;78;17;1;18;1
On Deadly Ground;1994;Rotten;10;34;3;28;31;9
On Golden Pond;1981;Fresh;93;87;27;2;29;8
On Guard;1997;Fresh;88;78;28;4;32;14
On Her Majesty's Secret Service;1969;Certified-Fresh;81;64;44;10;54;7
On_Line;2003;Rotten;38;30;15;25;40;17
On Moonlight Bay;1951;Fresh;100;81;5;0;5;0
On the Basis of Sex;2019;Fresh;73;76;186;68;254;44
On the Beach at Night Alone (Bamui haebyun-eoseo honja);2017;Certified-Fresh;92;69;46;4;50;11
On the Ice;2012;Fresh;67;62;10;5;15;11
On The Job;2013;Fresh;94;89;16;1;17;7
On the One;2005;Rotten;36;73;5;9;14;8
On the Outs;2005;Fresh;94;84;29;2;31;12
On the Road;2012;Rotten;44;34;68;85;153;46
On the Road With Judas;1900;Fresh;60;64;3;2;5;2
On the Ropes;1999;Fresh;93;75;13;1;14;4
On the Waterfront;1954;Certified-Fresh;99;95;71;1;72;14
Once;2007;Certified-Fresh;97;91;153;5;158;48
Once Bitten;1985;Rotten;18;39;2;9;11;0
Once I Was A Beehive;2015;Fresh;75;70;6;2;8;1
Once in the Life;2001;Rotten;28;56;7;18;25;14
Once Upon a Crime;1991;Rotten;0;42;0;6;6;0
Once Upon a Deadpool;2018;Rotten;55;54;33;27;60;11
Once Upon a Forest;1993;Rotten;22;69;5;18;23;11
Once Upon a Time in America;1984;Certified-Fresh;87;93;46;7;53;13
Once Upon a Time in Anatolia;2012;Certified-Fresh;92;74;72;6;78;26
Once Upon a Time in Brooklyn;2013;Rotten;0;18;0;6;6;4
Once Upon a Time In Hollywood;2019;Certified-Fresh;85;70;474;81;554;61
Once upon a Time in Mexico;2003;Fresh;66;64;112;57;169;36
Once Upon a Time in the West;1968;Certified-Fresh;95;95;61;3;64;15
Once Upon a Time in Venice;2017;Rotten;21;27;8;31;39;9
Once Were Warriors;1900;Certified-Fresh;93;95;42;3;45;16
Ondine;2010;Fresh;68;60;69;32;101;32
One on One;1977;Fresh;88;75;7;1;8;3
One;2000;Fresh;65;90;11;6;17;5
One & Two;2015;Rotten;44;34;7;9;16;7
One Bad Cat: The Reverend Albert Wagner Story;2008;Fresh;67;;4;2;6;4
One Bright Shining Moment: The Forgotten Summer of George McGovern;2005;Fresh;82;76;14;3;17;6
One Crazy Summer;1986;Rotten;59;63;10;7;17;2
One Cut, One Life;2015;Fresh;100;36;11;0;11;5
One Day;2011;Rotten;36;49;52;93;145;44
One Eight Seven;1997;Rotten;30;67;8;19;27;5
One-Eyed Jacks;1961;Rotten;56;72;9;7;16;1
One Fall;2011;Rotten;10;50;1;9;10;4
One False Move;1992;Certified-Fresh;94;75;48;3;51;15
One Flew Over the Cuckoo's Nest;1975;Certified-Fresh;94;96;75;5;80;14
One for the Money;2012;Rotten;2;42;1;54;55;16
One From the Heart;1982;Rotten;52;61;17;16;33;12
One Good Cop;1991;Rotten;15;32;2;11;13;3
One Hour Photo;2002;Certified-Fresh;82;65;163;37;200;44
One Last Night;2019;Fresh;60;83;3;2;5;2
One Last Thing;2006;Rotten;11;61;1;8;9;4
One Lucky Elephant;2011;Fresh;96;73;26;1;27;11
One Magic Christmas;1985;Rotten;47;69;8;9;17;4
One Man's Hero;1999;Rotten;38;63;3;5;8;1
One Missed Call;2008;Rotten;0;29;0;81;81;18
One Missed Call;2003;Rotten;44;63;12;15;27;8
One More Time (When I Live My Life Over Again);2016;Rotten;53;30;16;14;30;12
One Night In Bangkok;1900;Rotten;20;35;1;4;5;2
One October;2018;Fresh;100;80;5;0;5;3
One of Us;2017;Fresh;93;83;26;2;28;10
One Small Hitch;2015;Rotten;17;59;1;5;6;1
One Track Heart: The Story of Krishna Das;2013;Fresh;67;52;10;5;15;9
One True Thing;1998;Certified-Fresh;89;71;54;7;61;20
One Week and a Day (Shavua ve Yom);2017;Fresh;90;78;26;3;29;10
Ong Bak 3;2011;Rotten;50;36;4;4;8;2
Ong-Bak (Ong Bak: Muay Thai Warrior);2005;Certified-Fresh;85;84;92;16;108;26
Only;2020;Rotten;40;32;8;12;20;4
Only Angels Have Wings;1939;Fresh;100;82;28;0;27;8
Only God Forgives;2013;Rotten;41;37;68;97;165;43
Only Human (Seres queridos);2006;Fresh;72;77;38;15;53;23
Only Lovers Left Alive;2014;Certified-Fresh;85;75;172;30;202;51
Only the Brave;2017;Certified-Fresh;87;91;142;21;163;39
Only the Strong Survive;2003;Fresh;60;59;27;18;45;22
Only The Young;2012;Fresh;80;60;12;3;15;9
Onward;2020;Certified-Fresh;88;95;285;39;324;40
Opal Dream;2006;Fresh;69;64;24;11;35;13
Open 24 Hours;1900;Rotten;40;44;4;6;10;0
Open City;1946;Certified-Fresh;100;92;45;0;44;15
Open Grave;2014;Rotten;18;39;3;14;17;3
Open Range;2003;Certified-Fresh;79;84;146;38;184;42
The Open Road;2009;Rotten;29;25;2;5;7;4
Open Season;2006;Rotten;48;57;48;53;101;30
Open Water;2004;Fresh;71;33;140;56;196;41
Open Water 2: Adrift;2007;Rotten;45;23;5;6;11;0
Open Water 3: Cage Dive;2017;Rotten;25;14;2;6;8;0
Open Windows;2014;Rotten;42;20;18;25;43;6
Open Your Eyes (Abre los Ojos);1999;Certified-Fresh;85;88;40;7;47;11
Opening Night;1977;Fresh;96;91;26;1;27;12
Opera;1900;Fresh;91;79;20;2;22;1
Armour of God (Long xiong hu di) (Operation Condor 2);1987;Fresh;70;62;7;3;10;0
Operation Avalanche;2016;Fresh;69;52;42;19;61;18
Operation Chromite;2016;Rotten;40;52;8;12;20;7
Operation Condor (Fei ying gai wak) (Armour of God II);1991;Fresh;71;66;25;10;35;15
Operation Crossbow;1965;Fresh;71;55;5;2;7;0
Operation Dumbo Drop;1995;Rotten;31;29;8;18;26;4
Operation: Endgame (Rogue's Gallery);2010;Rotten;40;25;2;3;5;3
Operation Finale;2018;Fresh;60;64;80;53;133;31
Operation Mekong;2016;Fresh;80;60;8;2;10;2
Operation Petticoat;1959;Fresh;81;81;17;4;21;3
Operation Red Sea;2018;Fresh;80;64;8;2;10;2
Operator;2016;Fresh;100;60;6;0;6;2
Ophelia;2019;Fresh;60;60;78;52;130;24
Opportunity Knocks;;Rotten;13;47;1;7;8;2
The Opposite of Sex;1998;Certified-Fresh;80;60;33;8;41;8
The Opposite Sex;1956;Rotten;20;47;1;4;5;1
The Opposite Sex And How To Live With Them;1993;Rotten;8;26;1;12;13;5
Or (My Treasure);2007;Fresh;74;76;20;7;27;10
Orange County;2002;Rotten;46;61;56;65;121;33
Orange Sunshine;1900;Fresh;100;58;7;0;7;2
Oranges And Sunshine;2011;Fresh;69;70;50;22;72;26
Orca - The Killer Whale;1977;Rotten;9;33;3;29;32;7
Orchestra Of Exiles;2012;Fresh;80;70;8;2;10;7
Orchestra Rehearsal (Prova d'orchestra);1979;Fresh;88;82;7;1;8;2
Ordinary Decent Criminal;2000;Rotten;14;60;1;6;7;0
Ordinary People;1980;Certified-Fresh;89;88;48;6;54;11
Ordinary World;2016;Rotten;47;46;8;9;17;5
The Organization;1971;Rotten;40;27;2;3;5;2
Orgasm, Inc.;2011;Fresh;86;56;19;3;22;10
Orgazmo;1998;Rotten;48;66;16;17;33;7
Orgy of the Dead;1965;Rotten;0;22;0;6;6;0
Orhim le-rega (Off-White Lies);2012;Rotten;43;46;3;4;7;4
Original Gangstas;1996;Rotten;53;46;8;7;15;6
The Original Kings of Comedy;2000;Certified-Fresh;83;80;85;18;103;38
Original Sin;2001;Rotten;12;61;11;80;91;30
Oritsu uchugun Oneamisu no tsubasa (Royal Space Force - Wings of Honneamise);1987;Fresh;100;80;9;0;9;3
Orlando;1993;Certified-Fresh;84;82;49;9;58;20
Ornette: Made in America;2012;Fresh;89;46;17;2;19;10
Orphans of the Storm;1921;Fresh;92;71;12;1;13;4
Orwell Rolls in His Grave;2003;Fresh;79;91;19;5;24;9
Osama;2004;Certified-Fresh;96;87;98;4;102;37
Oscar and Lucinda;1997;Fresh;66;65;21;11;32;8
Oslo, August 31st;2012;Certified-Fresh;97;82;68;2;70;33
Osmosis Jones;2001;Rotten;55;41;61;49;110;33
OSS 117: Rio ne repond plus (Lost in Rio);2010;Certified-Fresh;75;63;39;13;52;22
The Osterman Weekend;1983;Rotten;39;38;7;11;18;4
OT: Our Town;2003;Fresh;88;75;22;3;25;7
The Other Boleyn Girl;2008;Rotten;43;62;63;83;146;43
The Other End of the Line;2008;Rotten;35;50;7;13;20;11
The Other Guys;2010;Certified-Fresh;78;60;161;46;207;46
Other People's Money;1991;Rotten;31;46;5;11;16;3
The Other Sister;1999;Rotten;29;71;14;35;49;14
Otherhood;2019;Rotten;23;54;6;20;26;7
Ouija;2014;Rotten;6;24;5;83;88;24
Ouija: Origin of Evil;2016;Certified-Fresh;82;57;99;22;121;25
Our Blood Is Wine;2018;Fresh;83;;5;1;6;3
Our Brand Is Crisis;2005;Certified-Fresh;93;75;37;3;40;17
Our Brand is Crisis;2015;Rotten;36;34;62;110;171;43
Our Children;2013;Certified-Fresh;93;69;41;3;44;18
Our City Dreams;2008;Fresh;75;59;12;4;16;7
Our Evil (Mal nosso);1900;Fresh;100;67;6;0;6;1
Our Family Wedding;2010;Rotten;15;48;13;74;87;30
Our Hospitality;1923;Fresh;96;89;26;1;27;5
Our House;2018;Fresh;62;27;16;10;26;6
Our Idiot Brother;2011;Fresh;70;51;99;43;142;42
Our Kind of Traitor;2016;Fresh;72;50;101;39;140;37
Our Lady of the Assassins;2001;Certified-Fresh;77;68;48;14;62;23
Our Little Sister (Umimachi Diary);2016;Certified-Fresh;94;83;114;7;121;30
Our Man Flint;1966;Fresh;77;68;23;7;30;4
Our Man in Tehran;2015;Fresh;83;76;15;3;18;6
Our Nixon;2013;Certified-Fresh;91;74;39;4;43;23
Our Song;2001;Certified-Fresh;91;81;50;5;55;22
Our Souls at Night;2017;Certified-Fresh;88;75;37;5;42;16
Our Vinyl Weighs A Ton: This Is Stones Throw Records;2014;Fresh;88;82;7;1;8;1
Out Cold;2001;Rotten;8;84;4;45;49;15
Out for Justice;1991;Rotten;23;53;5;17;22;6
Out in the Dark;2013;Fresh;79;82;23;6;29;11
Out of Africa;1985;Rotten;59;83;32;22;54;17
Out of Blue;2019;Rotten;38;37;25;41;66;16
Out of Print;2016;Fresh;80;56;4;1;5;1
Out of the Clear Blue Sky;2013;Fresh;90;85;9;1;10;5
Out Of The Dark;2015;Rotten;24;22;5;16;21;8
Out of the Furnace;2013;Rotten;54;52;105;91;196;50
Out of the Past;1947;Fresh;95;92;35;2;37;9
Out of Time;2003;Fresh;64;58;96;54;150;38
Out Stealing Horses (Ut og Stjale Hester);2020;Fresh;79;100;26;7;33;6
Outbreak;1995;Fresh;60;56;37;25;62;17
Outcast;1900;Fresh;64;30;7;4;11;3
Outcast;2015;Rotten;5;22;1;21;22;7
Outfoxed: Rupert Murdoch's War on Journalism;2004;Certified-Fresh;85;77;51;9;60;17
Outland;1981;Rotten;56;54;14;11;25;4
Outlander;2009;Rotten;37;44;23;39;62;18
Outlaw;2007;Rotten;21;52;4;15;19;7
The Outlaw Josey Wales;1976;Certified-Fresh;90;92;37;4;41;6
Outlaw King;2018;Fresh;61;67;91;57;148;33
Outlaws;2019;Rotten;27;44;3;8;11;1
Outlaws and Angels;2016;Rotten;29;49;8;20;28;10
Outpost: Black Sun;2012;Rotten;20;15;1;4;5;0
Outrageous Fortune;1987;Rotten;50;61;11;11;22;6
Outside Bet;1900;Rotten;0;29;0;9;9;4
Outside In;2018;Certified-Fresh;95;77;39;2;41;17
Outside Ozona;1999;Rotten;25;46;2;6;8;2
Outside Providence;1999;Rotten;51;65;38;37;75;25
Outside the Law;2001;Fresh;86;0;6;1;7;5
The Outsiders;1983;Fresh;63;82;25;15;40;10
Outsourced;2007;Certified-Fresh;76;73;31;10;41;17
Ovation!;2016;Rotten;38;46;3;5;8;4
Over the Edge;1979;Fresh;82;85;9;2;11;5
Over the GW;2007;Rotten;50;80;4;4;8;6
Over the Hedge;2006;Certified-Fresh;75;71;130;43;173;43
Over the Top;1987;Rotten;30;49;8;19;27;8
Over Your Dead Body (Kuime);1900;Rotten;56;41;5;4;9;1
Overboard;1987;Rotten;44;74;14;18;32;4
Overboard;2018;Rotten;24;54;21;68;89;28
Overcomer;2019;Rotten;53;98;9;8;17;5
Overdrive;2017;Rotten;29;26;4;10;14;3
Overlord;1975;Fresh;89;72;17;2;19;12
Overlord;2018;Certified-Fresh;81;67;179;42;221;26
Overnight;2004;Certified-Fresh;78;71;61;17;78;30
Overnight Delivery;1998;Rotten;43;52;3;4;7;0
The Ox-Bow Incident;1943;Fresh;91;91;20;2;22;2
Oyster Farmer;2005;Rotten;56;66;9;7;16;9
Oz the Great and Powerful;2013;Rotten;57;56;154;115;269;53
P2;2007;Rotten;33;36;23;47;70;18
Pacific Heights;;Rotten;50;46;13;13;26;3
Pacific Rim;2013;Fresh;72;77;211;82;293;56
Pacific Rim Uprising;2018;Rotten;43;38;111;146;257;43
The Pacifier;2005;Rotten;21;59;27;104;131;39
The Package;1989;Fresh;60;44;9;6;15;2
Paddington 2;2018;Certified-Fresh;100;88;242;0;242;41
Paddington;2015;Certified-Fresh;98;80;157;4;161;47
Paddleton;1900;Certified-Fresh;90;88;37;4;41;10
Padre Padrone;1900;Fresh;75;79;6;2;8;1
Page Eight;2011;Fresh;93;64;14;1;15;6
Page One: Inside the New York Times;2011;Certified-Fresh;78;75;87;24;111;38
The Page Turner (La Tourneuse de pages);2006;Certified-Fresh;77;67;51;15;66;25
The Pagemaster;1994;Rotten;21;48;4;15;19;8
Pahokee;1900;Fresh;100;;22;0;22;5
Paid in Full;2002;Rotten;53;93;23;20;43;18
Pain & Gain;2013;Rotten;50;47;102;101;203;48
Pain and Glory (Dolor y gloria);2019;Certified-Fresh;97;91;280;10;290;45
Paint Your Wagon;1969;Rotten;27;68;4;11;15;1
Painted Skin: The Resurrection;2012;Fresh;83;56;5;1;6;2
The Painted Veil;2006;Certified-Fresh;74;85;107;37;144;46
Pajama Party;1964;Rotten;33;34;3;6;9;0
Pal Joey;1957;Fresh;80;60;8;2;10;0
Pale Rider;1985;Fresh;93;83;25;2;27;6
The Paleface;1948;Fresh;100;65;10;0;10;1
Pali Road;2016;Rotten;55;99;6;5;11;7
Palindromes;2004;Rotten;43;69;52;69;121;37
Palio;2015;Fresh;95;84;19;1;20;11
The Pallbearer;1996;Rotten;45;18;9;11;20;5
The Palm Beach Story;1942;Fresh;97;82;28;1;29;7
Palmetto;1997;Rotten;39;31;13;20;33;8
Palo Alto;2014;Fresh;69;49;87;40;126;44
Pan;2015;Rotten;27;40;53;144;197;42
Pandemic;2016;Rotten;44;74;7;9;16;2
Pandora and the Flying Dutchman;1951;Fresh;66;77;21;11;32;11
Pandora's Promise;2013;Fresh;65;71;24;13;37;18
Pandorum;2009;Rotten;30;49;26;62;88;21
Panic in the Streets;1950;Fresh;96;77;26;1;27;3
Panic in Year Zero! (End of the World);1962;Fresh;67;62;6;3;9;0
Panic Room;2002;Certified-Fresh;75;63;140;46;186;38
Pan's Labyrinth;2006;Certified-Fresh;95;91;224;12;236;53
Papa: Hemingway in Cuba;2016;Rotten;11;53;5;39;44;19
Papadopoulos & Sons;1900;Fresh;71;52;10;4;14;4
Paparazzi;2004;Rotten;18;38;15;70;85;15
The Paper;1994;Fresh;88;66;30;4;34;8
The Paper Chase;1973;Fresh;83;72;24;5;29;5
Paper Heart;2009;Fresh;60;45;66;44;110;39
Paper Moon;1973;Fresh;92;94;36;3;39;9
Paper Planes;1900;Fresh;85;63;23;4;27;5
Paper Towns;2015;Rotten;58;47;80;59;139;35
Paper Clips;2004;Fresh;72;74;38;15;53;17
Papillon;1900;Fresh;79;90;22;6;28;8
Papillon;2018;Rotten;52;66;56;52;108;26
Paprika;2006;;;89;76;14;;28
Parade;1974;Rotten;56;46;5;4;9;3
Paradise;2013;Rotten;22;30;9;33;41;11
Paradise Alley;1978;Rotten;40;43;2;3;5;0
Paradise: Faith;2013;Fresh;73;53;29;11;40;16
Paradise Hills;2019;Fresh;64;74;39;22;61;13
Paradise Lost 2 - Revelations;2000;Fresh;91;84;10;1;11;1
Paradise Lost 3: Purgatory;1900;Fresh;100;93;16;0;16;6
Paradise Lost: Child Murders at Robin Hood Hills;1996;Fresh;100;94;26;0;26;3
Paradise: Love;2013;Certified-Fresh;78;68;35;10;45;19
Paradise Now;2005;Certified-Fresh;89;87;92;11;103;34
Paradise Road;1997;Rotten;45;78;10;12;22;8
PARADOX;2018;Rotten;29;37;2;5;7;3
The Parallax View;1974;Fresh;90;78;28;3;31;7
Paranoia;2013;Rotten;7;35;8;100;108;32
Paranoid Park;2007;Certified-Fresh;77;65;95;29;124;39
Los Paranoicos (The Paranoids);2008;Rotten;40;65;4;6;10;6
Paranormal Activity;2009;Certified-Fresh;83;57;169;35;204;37
Paranormal Activity 2;2010;Rotten;58;48;79;58;137;31
Paranormal Activity 3;2011;Fresh;66;51;83;42;125;24
Paranormal Activity 4;2012;Rotten;23;34;26;86;112;19
Paranormal Activity: The Ghost Dimension;2015;Rotten;14;27;11;66;77;11
Paranormal Activity: The Marked Ones;2014;Rotten;39;34;32;50;82;19
ParaNorman;2012;Certified-Fresh;89;72;162;21;183;39
Parasite;1982;Rotten;18;14;2;9;11;3
Parasite (Gisaengchung);2019;Certified-Fresh;99;90;445;6;451;49
Parched;2016;Fresh;86;67;19;3;22;6
Parental Guidance;2012;Rotten;18;59;17;76;93;26
Parenthood;1989;Certified-Fresh;91;76;52;5;57;15
Parents;1989;Rotten;53;54;8;7;15;2
Pariah;2011;Certified-Fresh;95;82;110;6;116;37
Pariah Dog;1900;Fresh;100;100;9;0;9;1
Faubourg 36 (Paris 36);2009;Fresh;64;57;53;30;83;25
Paris Belongs to Us (Paris Nous Appartient);1960;Fresh;86;71;12;2;14;5
Paris Can Wait (Bonjour Anne);2017;Rotten;47;39;53;60;113;22
Paris Is Burning;1991;Certified-Fresh;98;88;53;1;54;18
Paris Is Us;1900;Rotten;43;41;3;4;7;1
Paris Je T'aime;2007;Certified-Fresh;87;84;97;15;112;36
Paris Manhattan;2013;Rotten;43;41;10;13;23;10
Paris, Texas;1984;Fresh;97;94;32;1;33;1
Paris Was a Woman;1996;Fresh;60;70;3;2;5;1
Paris When It Sizzles;1964;Rotten;50;66;4;4;8;1
Parker;2013;Rotten;41;48;44;64;108;31
Parkland;2013;Rotten;50;47;63;62;125;42
Particle Fever;2014;Certified-Fresh;96;83;47;2;49;22
Leaving (Partir);2010;Fresh;68;48;44;21;65;24
Partisan;2015;Rotten;58;38;28;20;48;18
Party Monster;2003;Rotten;29;75;23;56;79;31
Party Monster;1999;Fresh;60;82;3;2;5;0
Pass Over;1900;Fresh;93;61;13;1;14;7
A Passage to India;1984;Fresh;76;78;19;6;25;5
Passage to Mars;2016;Rotten;29;85;2;5;7;5
Passed Away;1900;Rotten;10;44;1;9;10;3
Passenger Side;2010;Fresh;94;60;17;1;18;7
Passenger 57;1992;Rotten;24;38;6;19;25;3
Passengers;2016;Rotten;31;63;86;196;281;51
Passing Poston;1900;Fresh;63;;5;3;8;3
Passion;2013;Rotten;33;25;25;50;75;22
Passion Fish;1992;Fresh;100;82;24;0;24;4
Passion in the Desert;1997;Fresh;71;65;15;6;21;4
The Passion of Darkly Noon;1995;Rotten;44;55;4;5;9;0
The Passion of Joan of Arc (La Passion de Jeanne d'Arc);1928;Certified-Fresh;98;93;54;1;55;12
Passion of Mind;2000;Rotten;19;51;7;29;36;9
The Passion of the Christ;2004;Rotten;49;80;137;141;278;56
Passion Play;2011;Rotten;3;17;1;32;33;11
Passionada;2003;Rotten;57;53;26;20;46;17
Passione;2011;Fresh;89;62;34;4;38;19
Pat and Mike;1952;Fresh;88;69;21;3;24;8
Pat Garrett & Billy the Kid;1973;Fresh;86;83;18;3;21;5
Patagonia Rising;2012;Rotten;50;38;5;5;10;5
Patch Adams;1998;Rotten;22;73;15;53;68;23
Patch Town;2015;Fresh;75;57;6;2;8;2
Patema Inverted;2014;Fresh;73;79;11;4;15;7
Paterno;1900;Fresh;70;49;28;12;40;17
Paterson;2016;Certified-Fresh;96;72;249;10;258;47
Path to War;2002;Fresh;100;72;11;0;11;6
Pather Panchali;1955;Certified-Fresh;98;94;45;1;46;14
Pathfinder;2007;Rotten;10;36;8;69;77;24
Paths of Glory;1957;Certified-Fresh;95;95;57;3;60;17
Patience (After Sebald);2012;Fresh;90;68;19;2;21;12
Patient Zero;2018;Rotten;14;23;1;6;7;1
Patrick;2019;Rotten;38;59;13;21;34;7
Patrick: Evil Awakens;2014;Fresh;73;29;16;6;22;4
Patrick's Day;1900;Fresh;100;83;5;0;5;0
Patriocracy;2012;Rotten;43;77;3;4;7;2
Patriot Games;1992;Fresh;73;73;30;11;41;10
Patriots Day;2017;Certified-Fresh;80;86;189;46;235;50
Patton;1970;Certified-Fresh;94;93;46;3;49;10
Patton Oswalt: Annihilation;1900;Fresh;100;63;13;0;13;6
Patton Oswalt: Finest Hour;1900;Fresh;100;85;5;0;5;3
Patton Oswalt: Talking for Clapping;1900;Fresh;86;;6;1;7;3
Patton Oswalt: Tragedy Plus Comedy Equals Time;1900;Fresh;80;;4;1;5;3
Paul;2011;Fresh;70;62;144;61;205;49
Paul, Apostle of Christ;2018;Rotten;46;81;18;21;39;10
Paul Blart: Mall Cop;2009;Rotten;34;43;39;77;116;33
Paul Blart: Mall Cop 2;2015;Rotten;5;33;3;58;61;17
Paul Goodman Changed My Life;2011;Fresh;95;64;19;1;20;13
Paul Williams Still Alive;2012;Fresh;97;77;31;1;32;15
Paulie;1998;Fresh;62;55;23;14;37;12
Pauline At The Beach;1983;Fresh;93;85;13;1;14;3
Pauly Shore Is Dead;2003;Rotten;57;29;8;6;14;0
Pavarotti;2019;Certified-Fresh;87;97;74;11;85;21
Pawn Sacrifice;2015;Fresh;72;66;83;32;115;29
Pay 2 Play: Democracy's High Stakes;2014;Fresh;80;85;4;1;5;2
Pay It Forward;2000;Rotten;39;77;51;79;130;38
Payback;2012;Fresh;73;54;11;4;15;10
Paycheck;2003;Rotten;27;45;42;115;157;35
Paydirt;2020;Rotten;22;25;2;7;9;2
Peace, Love, & Misunderstanding;2012;Rotten;30;39;21;50;71;28
Peaceful Warrior;2006;Rotten;25;76;18;53;71;25
The Peacekeeper;1997;Rotten;0;19;0;0;7;0
Pearl;1900;Rotten;57;88;4;3;7;2
Pearl Jam Twenty;2011;Fresh;68;89;19;9;28;14
The Pebble and the Penguin;1995;Rotten;10;44;1;9;10;2
Pecker;1998;Rotten;52;64;24;22;46;7
Peep World;2011;Rotten;25;22;7;21;28;9
Peeping Tom;1960;Certified-Fresh;96;85;51;2;53;16
Peeples;2013;Rotten;38;49;24;39;63;28
Peepli Live;2010;Fresh;86;73;24;4;28;12
Pee-wee's Big Adventure;1985;Certified-Fresh;87;79;40;6;46;6
Peggy Sue Got Married;1986;Fresh;86;55;24;4;28;8
Pele: Birth of a Legend;2016;Rotten;33;69;10;20;30;11
The Pelican Brief;1993;Rotten;53;61;28;25;53;9
Pelican Dreams;2014;Fresh;92;81;22;2;24;9
Pelle the Conqueror (Pelle Erobreren);1988;Fresh;88;89;21;3;24;10
The Penalty;1920;Fresh;80;76;4;1;5;0
Penance;2009;Fresh;80;16;4;1;5;3
Penelope;2006;Rotten;54;73;68;59;127;34
Penguins Of Madagascar;2014;Fresh;73;63;83;31;114;39
Penny Serenade;1941;Fresh;94;75;16;1;17;4
Penumbra;2012;Rotten;50;26;3;3;6;2
People I Know;2003;Rotten;44;31;24;31;55;19
People Like Us;2012;Rotten;53;62;63;56;119;38
People Of A Feather;2013;Fresh;86;85;6;1;7;2
People Places Things;2015;Certified-Fresh;76;72;42;13;55;19
The People That Time Forgot;1977;Fresh;63;24;5;3;8;1
The People Under The Stairs;1991;Fresh;66;58;19;10;29;5
The People Vs. Larry Flynt;1996;Certified-Fresh;88;80;50;7;57;17
People Will Talk;1951;Fresh;100;79;7;0;7;1
People's Republic of Desire;2018;Fresh;97;74;32;1;33;11
Pepe le Moko;1937;Fresh;100;87;31;0;31;12
Pepi, Luci, Bom and Other Girls Like Mom (Pepi, Luci, Bom y otras chicas del monton);1980;Rotten;43;64;3;4;7;3
Peppermint;2018;Rotten;12;71;17;128;144;26
Peppermint Candy (Bakha satang);2000;Fresh;86;82;6;1;7;0
Peppermint Soda;1977;Fresh;90;78;9;1;10;3
Percy Jackson: Sea of Monsters;2013;Rotten;42;55;49;69;118;32
Perestroika;2009;Rotten;57;36;8;6;14;5
The Perez Family;1995;Fresh;65;59;11;6;17;7
Perfect;1985;Rotten;19;28;3;13;16;4
Perfect;2019;Rotten;21;50;3;11;14;5
Perfect Blue;1999;Certified-Fresh;80;89;35;9;44;7
The Perfect Man;2005;Rotten;6;58;8;121;129;39
The Perfect Score;2004;Rotten;16;44;17;92;109;32
Perfect Sense;2012;Rotten;57;59;36;27;63;20
Perfect Sisters;2014;Rotten;25;39;3;9;12;6
The Perfect Sleep;2008;Rotten;38;25;5;8;13;6
The Perfect Storm;2000;Rotten;47;64;63;72;135;30
A Perfect World;1993;Fresh;79;84;26;7;33;7
Performance;1970;Fresh;85;79;29;5;34;7
Perfume: The Story of a Murderer;2006;Rotten;59;74;75;53;128;41
Period. End of Sentence.;1900;Fresh;86;88;6;1;7;1
Period of Adjustment;1962;Fresh;71;51;5;2;7;2
Permanent;2017;Rotten;44;68;4;5;9;4
Permanent Midnight;1998;Rotten;58;54;31;22;53;12
Permanent Record;1988;Rotten;50;69;7;7;14;6
Perrier's Bounty;2010;Rotten;56;47;24;19;43;15
Persecuted;2014;Rotten;0;58;0;14;14;5
Persepolis;2007;Certified-Fresh;96;92;154;7;161;48
Person to Person;2017;Rotten;52;;24;22;46;12
Persona;1966;Certified-Fresh;90;94;46;5;51;15
Personal Best;1982;Fresh;73;52;24;9;33;10
Personal Velocity: Three Portraits;2002;Fresh;69;62;71;32;103;33
Persons Unknown;1996;Rotten;14;31;1;6;7;1
The Pest;1997;Rotten;8;68;2;22;24;8
Pet;2016;Rotten;56;32;10;8;18;5
Pet Sematary;1989;Rotten;51;59;18;17;35;1
Pet Sematary;2019;Rotten;58;33;157;115;272;32
Pet Sematary Two;1992;Rotten;22;30;5;18;23;0
Pete Davidson: Alive From New York;1900;Rotten;40;59;4;6;10;4
Pete Seeger: The Power of Song;2007;Fresh;95;92;19;1;20;13
Peter and Vandy;2009;Fresh;65;56;13;7;20;9
Peter Rabbit;2018;Fresh;63;56;92;54;146;28
Peter's Friends;1992;Fresh;69;78;24;11;35;8
Pete's Dragon;1977;Rotten;54;60;14;12;26;3
Pete's Dragon;2016;Certified-Fresh;88;72;213;29;241;44
Petits Freres;2001;Fresh;62;;8;5;13;4
Petulia;1968;Fresh;86;81;12;2;14;4
Petunia;2013;Rotten;20;36;1;4;5;3
Peyton Place;1957;Fresh;65;72;11;6;17;3
Phantasm;1979;Fresh;74;67;34;12;46;9
Phantasm II;1988;Rotten;38;57;6;10;16;1
Phantasm: Lord of the Dead;1994;Rotten;40;42;4;6;10;0
Phantasm: OblIVion;1998;Rotten;25;41;2;6;8;0
Phantasm: Ravager;2016;Rotten;57;28;8;6;14;5
Phantom;2013;Rotten;25;33;14;42;56;21
Phantom Lady;1944;Fresh;89;72;8;1;9;0
The Phantom of the Opera;2005;Rotten;33;84;56;115;171;38
Phantom of the Opera;1943;Fresh;76;77;16;5;21;4
Phantom of the Paradise;1974;Fresh;85;84;22;4;26;4
Phantom Thread;2018;Certified-Fresh;91;71;315;31;346;49
Phantoms;1998;Rotten;13;27;4;27;31;8
Phase 7;2011;Fresh;80;49;8;2;10;2
Phase IV;1974;Rotten;50;55;9;9;18;4
Phat Girlz;2006;Rotten;21;65;10;37;47;14
Phenomena (Creepers);1985;Fresh;76;68;16;5;21;2
Phenomenon;1996;Rotten;50;59;18;18;36;8
Phil;2019;Rotten;24;37;6;19;25;8
Phil the Alien;2004;Rotten;44;68;4;5;9;2
Phil Ochs: There But For Fortune;2011;Fresh;97;78;32;1;33;9
Phil Spector;2013;Rotten;50;32;20;20;40;20
Philadelphia;1993;Certified-Fresh;80;89;45;11;56;10
The Philadelphia Experiment;1984;Rotten;50;40;5;5;10;0
The Philadelphia Story;1940;Certified-Fresh;100;93;63;0;62;12
Philip Roth: Unmasked;2013;Fresh;63;75;10;6;16;13
Philomena;2013;Certified-Fresh;90;89;179;19;198;51
Philophobia: Or the Fear of Falling in Love;1900;Fresh;100;72;11;0;11;0
Phineas and Ferb the Movie: Across the 2nd Dimension;2011;Fresh;100;79;5;0;5;2
Phoenix;1998;Rotten;50;52;3;3;6;1
Phoenix;2015;Certified-Fresh;98;78;126;3;129;33
Phoenix Forgotten;2017;Rotten;44;40;8;10;18;4
Phone (Pon);2002;Fresh;63;62;5;3;8;1
Phone Booth;2003;Fresh;72;64;135;53;188;39
Photographing Fairies;1998;Fresh;82;74;9;2;11;2
Phyllis and Harold;2010;Fresh;69;69;18;8;26;9
Physical Evidence;1989;Rotten;22;12;4;14;18;5
Pi;1998;Certified-Fresh;88;85;51;7;58;14
The Pianist;2002;Certified-Fresh;95;96;173;9;182;40
The Piano;1993;Certified-Fresh;92;86;56;5;61;15
The Piano Teacher (La Pianiste);2001;Fresh;73;81;65;24;89;28
Picasso and Braque Go to the Movies;2010;Fresh;67;50;10;5;15;6
Pick of the Litter;2018;Certified-Fresh;97;90;63;2;65;19
Pickpocket;1959;Certified-Fresh;95;85;38;2;40;9
Picnic;1955;Rotten;50;54;4;4;8;1
Picnic at Hanging Rock;1975;Certified-Fresh;90;83;36;4;40;7
Picture Me: A Model's Diary;2010;Rotten;55;61;6;5;11;4
Picture Bride;1995;Fresh;82;79;9;2;11;4
Picture Day;1900;Fresh;80;62;4;1;5;1
Pieces;1983;Rotten;46;51;6;7;13;1
Pieces of April;2003;Certified-Fresh;84;73;128;25;153;41
The Pied Piper;1972;Rotten;44;25;4;5;9;2
Piercing;2019;Fresh;72;43;69;27;96;21
Pierrepoint: The Last Hangman;2007;Certified-Fresh;79;85;42;11;53;22
Pierrot le Fou (Pierrot Goes Wild) (Crazy Pete);1969;Certified-Fresh;86;87;37;6;43;12
Pieta;2013;Certified-Fresh;72;72;39;15;54;22
Piglet's Big Movie;2003;Certified-Fresh;70;64;54;23;77;26
Pilgrim Song;2013;Rotten;20;64;1;4;5;2
Pilgrimage;2017;Fresh;69;40;27;12;39;7
Pillow Talk;1959;Fresh;93;87;26;2;28;5
Pimp;1900;Rotten;0;13;0;13;13;8
Pimp;2018;Rotten;56;96;5;4;9;3
Pin Cushion;2018;Fresh;90;69;35;4;39;11
Pina;2011;Certified-Fresh;95;81;99;5;104;39
Pineapple Express;2008;Fresh;68;73;139;64;203;49
Pinero;2002;Rotten;43;71;26;35;61;24
Ping Pong;1900;Fresh;95;79;20;1;21;5
Ping Pong Playa;2007;Fresh;64;52;21;12;33;13
Ping Pong Summer;2014;Rotten;59;32;20;14;34;18
Pink Cadillac;1989;Rotten;21;25;4;15;19;5
The Pink Panther;2006;Rotten;21;51;30;112;142;37
Pink Panther 2;2009;Rotten;13;42;17;118;135;38
The Pink Panther Strikes Again;1976;Fresh;76;84;16;5;21;1
Pink Ribbons, Inc.;2012;Fresh;89;77;33;4;37;15
Pinky;1949;Rotten;54;70;7;6;13;2
Pinocchio;1940;Certified-Fresh;100;73;55;0;55;10
Pioneer;2014;Rotten;55;33;24;20;44;18
Pipe Dream;2001;Fresh;72;31;13;5;18;8
Piranha Part Two: The Spawning;1981;Rotten;6;11;1;17;18;2
Piranha 3-D;2010;Certified-Fresh;74;43;96;33;129;24
Piranha 3DD;2012;Rotten;13;22;7;45;52;13
Piranhas (La paranza dei bambini);2019;Rotten;58;55;19;14;33;11
The Pirate;1948;Fresh;73;75;11;4;15;0
Pirate Radio (The Boat That Rocked);2009;Fresh;61;71;100;64;164;44
Pirates of Silicon Valley;1999;Fresh;90;88;9;1;10;3
Pirates of the Caribbean: At World's End;2007;Rotten;44;72;101;127;228;48
Pirates of the Caribbean: Dead Man's Chest;2006;Rotten;53;72;121;107;228;48
Pirates of the Caribbean: Dead Men Tell No Tales;2017;Rotten;29;61;83;202;285;45
Pirates of the Caribbean: On Stranger Tides;2011;Rotten;33;54;91;186;277;52
Pirates of the Caribbean: The Curse of the Black Pearl;2003;Certified-Fresh;79;86;173;46;219;45
The Pirates Who Don't Do Anything: A VeggieTales Movie;2008;Rotten;43;61;15;20;35;14
Pit Stop;2013;Fresh;100;50;5;0;5;0
Pitch Black;2000;Rotten;59;77;66;45;111;31
Pitch Perfect;2012;Certified-Fresh;80;83;122;30;152;45
Pitch Perfect 2;2015;Fresh;65;64;141;75;216;49
Pitch Perfect 3;2017;Rotten;28;44;42;106;148;31
Pixels;2015;Rotten;17;46;34;168;201;42
A Place in the Sun;1951;Fresh;77;84;24;7;31;9
Places in the Heart;1984;Fresh;89;83;34;4;38;11
Plagues & Pleasures on the Salton Sea;2004;Certified-Fresh;96;86;51;2;53;17
Plan 9 from Outer Space;1959;Fresh;67;46;24;12;36;3
Planeat;2011;Rotten;40;71;2;3;5;2
Planes;2013;Rotten;25;49;31;91;122;31
Planes: Fire And Rescue;2014;Rotten;45;56;42;52;94;26
Planes, Trains and Automobiles;1987;Certified-Fresh;91;87;52;5;57;12
Planet 51;2009;Rotten;23;40;25;84;109;31
Planet B-Boy;2007;Certified-Fresh;83;91;34;7;41;18
Planet of Snail;2012;Fresh;100;73;29;0;29;14
Terrore nello spazio (Planet of the Vampires);1965;Fresh;69;52;9;4;13;0
Planet Terror (Grindhouse Presents: Robert Rodriguez's Planet Terror);2007;Fresh;74;77;20;7;27;7
Plastic Planet;2011;Rotten;58;63;7;5;12;3
Plastic;2014;Rotten;17;33;5;25;30;9
Platoon;1986;Certified-Fresh;88;93;59;8;67;18
Play It Again, Sam;1972;Fresh;97;89;34;1;35;3
Play It to the Bone;1999;Rotten;11;25;9;70;79;25
Play Misty for Me;1971;Fresh;82;72;27;6;33;6
Play The Game;2009;Rotten;28;61;9;23;32;14
Playback;2012;Rotten;0;76;0;6;6;0
The Players Club;1998;Rotten;31;85;5;11;16;6
Playing by Heart;1998;Fresh;60;79;32;21;53;14
Playing for Keeps;2012;Rotten;4;41;4;87;91;33
Playing God;1997;Rotten;13;33;4;27;31;9
Playing It Cool;2015;Rotten;14;33;4;24;28;8
Playing Mona Lisa;2000;Fresh;64;58;9;5;14;1
Playmobil: The Movie;2019;Rotten;18;62;11;50;61;11
Playtime;1973;Certified-Fresh;98;90;48;1;49;13
Plaza Suite;1971;Fresh;63;56;5;3;8;1
Pleasantville;1998;Certified-Fresh;85;79;82;14;96;25
Please Don't Eat the Daisies;1960;Rotten;57;60;4;3;7;0
Please Stand By;2018;Rotten;58;70;22;16;38;10
Wedding Daze;2007;Rotten;33;38;4;8;12;1
Pledge;2019;Fresh;76;70;22;7;29;4
Plot for Peace;2014;Fresh;76;82;13;4;17;10
Plus One;2019;Certified-Fresh;88;80;56;8;64;15
Plush;2013;Rotten;33;31;2;4;6;1
Plynace wiezowce (Floating Skyscrapers);1900;Fresh;78;43;7;2;9;3
Pocahontas II: Journey to a New World;1998;Rotten;29;28;2;5;7;0
Pocket Money;1972;Rotten;57;30;4;3;7;2
Pocketful of Miracles;1961;Rotten;50;72;5;5;10;0
Pod;1900;Fresh;80;25;8;2;10;2
Poetic Justice;1993;Rotten;34;83;11;21;32;11
Poetry;2011;Certified-Fresh;100;86;72;0;72;24
Point and Shoot;2014;Certified-Fresh;72;71;39;15;54;23
Point Blank;2011;Certified-Fresh;91;76;72;7;79;30
Point Blank;1900;Rotten;38;30;13;21;34;4
Point Break;1991;Fresh;70;79;42;18;60;11
Point Break;2015;Rotten;11;29;12;98;110;21
Poison Ivy II;1995;Rotten;14;37;1;6;7;0
Pokemon 3: The Movie;2001;Rotten;21;54;12;45;57;18
Pokemon 4Ever;2002;Rotten;16;54;6;32;38;18
Pokemon Detective Pikachu;2019;Fresh;68;79;206;97;303;35
Pokemon the First Movie - Mewtwo vs. Mew;1999;Rotten;15;63;13;76;89;28
Pokemon The Movie: I Choose You!;2017;Rotten;33;63;3;6;9;1
Pokemon the Movie: Mewtwo Strikes Back Evolution;1900;Rotten;44;43;4;5;9;1
Pokemon the Movie: The Power of Us;2018;Fresh;71;65;5;2;7;1
Poker Night;2014;Rotten;50;42;5;5;10;2
Polar;1900;Rotten;19;62;9;38;47;9
The Polar Express;2004;Rotten;56;63;116;92;208;49
Polaroid;2019;Rotten;0;29;0;5;5;0
Police Academy;1984;Rotten;54;64;15;13;28;7
Police Academy 2: Their First Assignment;1985;Rotten;31;43;5;11;16;1
Police Academy 3: Back in Training;1986;Rotten;40;39;4;6;10;1
Police Academy 4 - Citizens on Patrol;1987;Rotten;0;38;0;20;20;6
Police Academy 5: Assignment Miami Beach;1988;Rotten;0;33;0;7;7;3
Police Academy 6 - City Under Siege;1989;Rotten;0;28;0;7;7;0
Police Academy 7: Mission to Moscow;1994;Rotten;0;22;0;7;7;2
Politist, adj. (Police, Adjective);2009;Certified-Fresh;79;60;60;16;76;28
Police Story (Ging chaat goo si) (Police Force);1985;Fresh;93;88;26;2;28;5
Police Story 2 (Ging chaat goo si juk jaap) (Police Force II);1988;Fresh;83;77;15;3;18;0
Polina (Polina, danser sa vie);2017;Certified-Fresh;84;61;43;8;51;13
Polisse;2012;Certified-Fresh;87;79;73;11;84;28
Pollock;2000;Certified-Fresh;81;74;87;21;108;33
Poltergeist;2015;Rotten;31;22;41;93;134;23
Poltergeist III;1900;Rotten;17;22;3;15;18;0
Polyester;1981;Fresh;93;81;25;2;27;3
POM Wonderful Presents: The Greatest Movie Ever Sold;2011;Certified-Fresh;72;64;95;37;132;40
Pompeii;2014;Rotten;28;34;46;121;167;35
Poms;2019;Rotten;35;74;30;55;85;20
Pontypool;2009;Certified-Fresh;84;68;73;14;87;24
Ponyo;2009;Certified-Fresh;92;83;155;14;169;49
Pooh's Grand Adventure: The Search for Christopher Robin;1997;Rotten;33;71;3;6;9;0
Pooh's Heffalump Movie;2005;Certified-Fresh;80;69;71;18;89;29
Pootie Tang;2001;Rotten;27;63;12;32;44;20
Pope Francis - A Man of His Word;2018;Certified-Fresh;82;75;63;14;77;21
Popstar: Never Stop Never Stopping;2016;Certified-Fresh;79;65;134;36;169;46
Porcile;1969;Rotten;56;65;5;4;9;2
Porco Rosso (Kurenai no buta);1992;Fresh;95;87;19;1;20;1
Pork Chop Hill;1900;Fresh;83;71;5;1;6;0
Porno;2020;Certified-Fresh;81;34;35;8;43;5
The Pornographer;2001;Rotten;33;36;4;8;12;3
Pornography: A Thriller;2010;Rotten;29;18;2;5;7;3
Portals;2019;Rotten;0;14;0;11;11;4
Porto;2017;Rotten;52;40;16;15;31;11
Portrait of a Lady on Fire (Portrait de la jeune fille en feu);2020;Certified-Fresh;98;92;295;7;302;46
Portrait of Wally;2012;Fresh;90;74;28;3;31;13
Poseidon;2006;Rotten;33;43;68;135;203;46
Possession;2002;Fresh;64;58;100;57;157;36
Possum;2018;Certified-Fresh;90;52;36;4;40;6
Post Grad;2009;Rotten;8;27;8;92;100;36
Post Mortem;2012;Fresh;88;61;30;4;34;13
Post Tenebras Lux;2013;Rotten;53;49;31;27;58;25
Postal;2007;Rotten;9;34;4;42;46;13
Postcards From London;2018;Rotten;50;32;8;8;16;9
Postcards from the Edge;;Fresh;84;66;27;5;32;9
Poster Boy;2006;Rotten;30;47;6;14;20;10
The Postman;1997;Rotten;8;50;3;33;36;9
Postman Pat: The Movie;2014;Rotten;43;47;12;16;28;8
Potiche;2011;Certified-Fresh;83;61;98;20;118;38
Poultrygeist: Night of the Chicken Dead;2006;Fresh;65;65;17;9;26;8
Pound Of Flesh;2015;Rotten;15;20;2;11;13;2
Powaqqatsi;1988;Rotten;56;81;5;4;9;2
Powder;1995;Rotten;50;69;10;10;20;5
Power and Terror: Noam Chomsky in Our Times;2002;Fresh;72;68;18;7;25;11
The Power of One;1992;Rotten;39;87;7;11;18;8
Power Trip;2003;Fresh;94;92;31;2;33;11
Practical Magic;1998;Rotten;22;73;20;73;93;30
A Prairie Home Companion;2006;Certified-Fresh;82;59;161;36;197;47
Prancer;1989;Fresh;67;58;16;8;24;7
Pray the Devil Back to Hell;2008;Fresh;100;86;36;0;36;15
Prayers for Bobby;2009;Fresh;73;86;11;4;15;9
Preacher's Kid;2010;Rotten;57;63;4;3;7;1
The Preacher's Wife;1996;Fresh;60;52;27;18;45;11
Precious: Based on the Novel Push by Sapphire;2009;Certified-Fresh;92;81;216;20;236;54
Precious Cargo;2016;Rotten;0;22;0;21;21;7
Precious Life;2011;Fresh;100;88;10;0;10;3
Predator;1987;Certified-Fresh;81;87;39;9;48;6
Predator 2;;Rotten;31;44;9;20;29;2
Predestination;2015;Certified-Fresh;83;75;91;18;109;29
Prefontaine;1997;Rotten;56;78;20;16;36;14
Preggoland;2015;Rotten;44;36;8;10;18;8
Premature;2014;Rotten;48;39;10;11;21;9
Premature;2020;Certified-Fresh;92;68;46;4;50;15
Premium;2007;Fresh;100;64;7;0;7;3
Premium Rush;2012;Certified-Fresh;74;60;119;42;161;44
Premonition;2007;Rotten;8;50;13;150;163;44
Presenting Princess Shaw;2016;Certified-Fresh;91;65;42;4;46;20
Preservation;2015;Rotten;58;23;7;5;12;5
The President's Analyst;1967;Fresh;81;78;17;4;21;7
The President's Last Bang;2005;Fresh;82;72;28;6;34;11
The Presidio;1988;Rotten;53;33;8;7;15;1
Pressing On: The Letterpress Film;1900;Fresh;86;;6;1;7;1
Pressure Cooker;2009;Fresh;92;82;23;2;25;10
The Prestige;2006;Certified-Fresh;76;92;152;49;201;48
Presumed Innocent;;Certified-Fresh;87;67;48;7;55;19
Pretenders;2019;Rotten;20;42;2;8;10;4
Pretending I'm a Superman: The Tony Hawk Video Game Story;1900;Fresh;100;79;13;0;13;0
Pretty Baby;1978;Fresh;71;59;20;8;28;6
Pretty Bird;2008;Rotten;20;16;1;4;5;2
Pretty in Pink;1986;Certified-Fresh;75;81;39;13;52;13
Pretty Maids All in a Row;1971;Rotten;8;49;1;11;12;1
Pretty Persuasion;2005;Rotten;33;62;26;53;79;28
Pretty Poison;1968;Fresh;100;71;7;0;7;3
Pretty Woman;;Fresh;63;68;43;25;68;15
Prey;2019;Rotten;13;18;1;7;8;1
Prey for Rock & Roll;2003;Rotten;56;63;27;21;48;15
A Price Above Rubies;1998;Rotten;57;55;17;13;30;6
Price Check;2012;Fresh;64;30;14;8;22;12
Priceless;2006;Certified-Fresh;82;75;63;14;77;21
Priceless;2016;Rotten;40;77;2;3;5;2
Pride;2007;Rotten;46;72;51;59;110;38
Pride;2014;Certified-Fresh;91;89;135;13;148;49
Pride and Glory;2008;Rotten;35;49;54;101;155;44
Pride and Prejudice and Zombies;2016;Rotten;45;45;86;106;191;43
The Pride and the Passion;1957;Rotten;22;25;2;7;9;2
The Pride of the Yankees;1942;Fresh;93;89;27;2;29;5
Primal;2019;Rotten;38;24;15;24;39;9
Primal;1900;Fresh;75;25;6;2;8;0
Primary;1960;Fresh;100;69;6;0;6;0
Primary Colors;1998;Certified-Fresh;81;64;64;15;79;25
Prime;2005;Rotten;50;52;59;59;118;33
Primer;2004;Fresh;73;79;93;35;128;34
Primeval;2007;Rotten;19;32;11;46;57;14
Prince;2015;Fresh;71;55;15;6;21;7
The Prince and the Showgirl;1957;Fresh;63;56;5;3;8;0
Prince Avalanche;2013;Certified-Fresh;82;53;101;22;123;33
Prince of Central Park;2000;Rotten;20;36;0;0;5;0
Prince of Darkness;1987;Rotten;58;60;21;15;36;8
The Prince of Egypt;1998;Certified-Fresh;80;76;70;18;88;26
The Prince of Pennsylvania;1988;Rotten;14;49;1;6;7;4
Prince of Persia: The Sands of Time;2010;Rotten;37;58;84;143;227;43
Prince of the City;1981;Fresh;91;82;21;2;23;4
The Prince of Tides;1991;Fresh;69;70;22;10;32;9
Princess Ka'iulani;2010;Rotten;18;45;7;31;38;14
The Princess Bride;1987;Certified-Fresh;97;94;75;2;77;18
Princess Caraboo;1994;Fresh;63;50;10;6;16;3
The Princess Diaries;2001;Rotten;48;68;55;60;115;31
The Princess Diaries 2 - Royal Engagement;2004;Rotten;26;59;31;89;120;29
Princess Mononoke (Mononoke-hime);1999;Certified-Fresh;93;94;102;8;110;36
Princess Protection Program;2009;Fresh;60;60;3;2;5;1
The Prisoner of Second Avenue;1975;Rotten;57;67;4;3;7;0
Prisoners;2013;Certified-Fresh;81;87;204;48;252;59
Private Benjamin;1980;Fresh;82;60;27;6;33;5
Private Life;2018;Certified-Fresh;94;78;98;6;104;29
The Private Life of Henry VIII;1933;Fresh;100;74;16;0;16;0
The Private Lives of Pippa Lee;2009;Fresh;69;50;52;23;75;25
The Private Life of Sherlock Holmes;1970;Fresh;92;73;24;2;26;10
Private Peaceful;2014;Fresh;63;57;17;10;27;10
Private Resort;1985;Rotten;14;39;1;6;7;0
Private Romeo;2012;Rotten;50;66;5;5;10;6
The Prize Winner of Defiance, Ohio;2005;Fresh;60;74;50;34;84;30
Problem Child;;Rotten;0;41;0;29;29;8
Problem Child 2;1900;Rotten;7;42;2;25;27;9
Prodigy;1900;Fresh;73;72;16;6;22;0
The Producers;2005;Rotten;51;63;78;76;154;41
The Professionals;1966;Fresh;88;82;15;2;17;3
Professor Marston & The Wonder Women;2017;Certified-Fresh;87;77;155;24;179;40
The Program;1993;Rotten;43;80;9;12;21;8
Jackie Chan's Project A ('A' gai wak) (Pirate Patrol);1983;Fresh;77;83;10;3;13;1
Project Almanac;2015;Rotten;36;45;35;62;97;28
Project Nim;2011;Certified-Fresh;97;84;140;4;144;43
Rebirth;2011;Fresh;92;79;12;1;13;7
Project Wild Thing;1900;Fresh;67;73;4;2;6;4
Project X;2012;Rotten;28;61;39;99;138;28
Prom;2011;Rotten;36;39;32;58;90;33
Prom Night;2008;Rotten;7;38;5;62;67;14
Promare;2019;Fresh;97;93;28;1;29;6
Prometheus;2012;Certified-Fresh;73;68;223;82;305;59
Promised Land;1988;Fresh;73;44;8;3;11;5
Proof;2005;Fresh;62;59;90;55;145;42
Proof;1991;Fresh;94;80;15;1;16;4
Proof of Life;2000;Rotten;39;43;46;71;117;33
The Prophecy 3: The Ascent;2000;Rotten;17;41;1;5;6;0
The Proposition;2005;Certified-Fresh;85;85;110;19;129;38
Prospect;2018;Certified-Fresh;88;70;43;6;49;6
Protagonist;2007;Fresh;82;83;28;6;34;15
The Protector (Tom yum goong) (Warrior King);2005;Rotten;53;76;48;42;90;28
Protektor;2011;Fresh;63;69;5;3;8;4
Proteus: A Nineteenth Century Vision;2004;Rotten;28;50;5;13;18;9
Protocol;1984;Rotten;25;38;2;6;8;2
Proud Mary;2018;Rotten;25;46;19;56;75;16
Provoked;2007;Rotten;28;70;10;26;36;16
Proximity;2020;;;;9;14;;3
Proxy;2014;Fresh;64;38;17;9;25;10
Prozac Nation;2005;Rotten;28;58;7;18;25;7
P.S. I Love You;2007;Rotten;25;80;26;78;104;30
Psycho;1960;Certified-Fresh;96;95;98;4;102;22
Psycho II;1983;Rotten;59;53;20;14;34;6
Psycho III;1986;Rotten;58;29;11;8;19;4
Psycho Beach Party;2000;Rotten;55;66;18;15;33;7
Psychokinesis;1900;Fresh;80;58;8;2;10;1
Psychopathia Sexualis;2006;Rotten;23;28;3;10;13;7
Psychopaths;2017;Rotten;24;8;4;13;17;4
PT 109;1963;Fresh;64;53;7;4;11;0
Pu-239;1900;Rotten;57;66;4;3;7;2
Public Access;1993;Rotten;58;27;7;5;12;2
The Public Eye;1992;Fresh;65;52;11;6;17;4
Puccini for Beginners;2007;Rotten;50;45;32;32;64;29
Puerto Ricans In Paris;2016;Rotten;33;36;8;16;24;10
Pulling Strings;2013;Rotten;58;71;7;5;12;4
Pulp Fiction;1994;Certified-Fresh;92;96;97;9;106;32
Pulse;2006;Rotten;11;27;8;65;73;22
Octane (Pulse);2004;Rotten;17;23;1;5;6;1
Pulse (Kairo);2005;Fresh;74;60;40;14;54;15
Pumping Iron;1900;Fresh;91;84;32;3;35;7
Pumpkin;2002;Rotten;37;56;28;47;75;22
The Pumpkin Eater;1964;Fresh;67;72;10;5;15;4
Pumpkinhead;1988;Fresh;65;48;15;8;23;2
Pumpkinhead II: Blood Wings;1994;Rotten;13;19;1;7;8;0
Punch;2002;Rotten;29;17;2;5;7;2
Punch-Drunk Love;2002;Certified-Fresh;79;77;154;40;194;41
Punching the Clown;2010;Fresh;87;84;13;2;15;7
Punching Henry;2017;Fresh;77;63;10;3;13;6
Punchline;1988;Rotten;56;42;10;8;18;1
Puncture;2011;Rotten;52;54;22;20;42;17
Punisher: War Zone;2008;Rotten;29;42;32;78;110;28
Punishment Park;1971;Fresh;92;88;11;1;12;2
Punk's Not Dead;2007;Fresh;90;77;19;2;21;10
Puppet Master;1989;Rotten;50;40;4;4;8;0
Puppet Master II;;Rotten;43;38;3;4;7;0
Puppet Master: The Littlest Reich;2018;Fresh;70;49;32;14;46;8
The Puppet Masters;1994;Rotten;26;32;6;17;23;7
Pure Country;1992;Rotten;41;90;9;13;22;9
Pure Luck;1900;Rotten;9;60;1;10;11;3
Purgatory House;2003;Fresh;80;51;4;1;5;0
Purple Butterfly (Zi hudie);2004;Rotten;43;45;9;12;21;9
Purple Noon (Plein soleil);1961;Fresh;95;92;35;2;37;10
Purple Rain;1984;Fresh;70;78;39;17;56;10
The Purple Rose of Cairo;1985;Fresh;92;88;35;3;38;2
The Pursuit of Happyness;2006;Fresh;67;87;118;58;176;49
Pusher;1999;Fresh;83;85;15;3;18;4
Pusher;2012;Rotten;48;34;23;25;48;22
Pusher II: With Blood On My Hands;2004;Fresh;100;85;10;0;10;2
Pusher III: I'm the Angel of Death;2005;Fresh;93;82;14;1;15;3
Pushing Tin;1999;Rotten;48;42;32;35;67;18
Pushover;1954;Fresh;86;43;6;1;7;3
Pussy Riot- - A Punk Prayer;2013;Fresh;83;73;30;6;36;15
Putin's Kiss;2012;Fresh;81;61;13;3;16;7
Putney Swope;1969;Fresh;69;76;9;4;13;3
Putty Hill;2011;Fresh;74;53;25;9;34;14
Pyaar Impossible;2010;Rotten;40;46;2;3;5;2
Pyewacket;2018;Fresh;82;54;28;6;34;5
A Pyromaniac's Love Story;1995;Rotten;0;53;0;11;11;4
Q;1982;Fresh;69;42;18;8;26;4
Q & A;;Fresh;87;60;20;3;23;5
Millennium Mambo (Qianxi Manbo);2001;Fresh;81;70;26;6;32;9
QT8: The First Eight;2019;Fresh;91;94;21;2;23;2
Quadrophenia;1979;Fresh;100;82;12;0;12;0
Quai des Orfevres (Quay of the Goldsmiths) (Jenny Lamour);1948;Fresh;100;89;32;0;32;12
Quality Street;1937;Fresh;67;31;4;2;6;0
Quantum of Solace;2008;Fresh;65;58;190;104;294;58
Quarantine 2: Terminal;1900;Fresh;75;34;6;2;8;1
Quartet;1981;Rotten;44;32;7;9;16;5
Quartet;2013;Certified-Fresh;80;66;117;29;145;50
The Queen;2006;Certified-Fresh;96;76;191;7;198;51
Queen and Country;2015;Certified-Fresh;77;46;70;21;91;35
Queen & Slim;2019;Certified-Fresh;82;92;178;39;217;39
Queen Christina;1933;Fresh;90;84;19;2;21;3
Queen - Hungarian Rhapsody: Live In Budapest '86;2012;Fresh;86;92;6;1;7;4
Queen Kelly;1929;Fresh;100;78;7;0;7;0
Queen Margot (La Reine Margot);1994;Fresh;81;88;26;6;32;7
Queen of Blood;1966;Rotten;17;20;1;5;6;0
Queen of Earth;2015;Certified-Fresh;93;58;76;6;82;20
Queen of Hearts;2019;Fresh;96;82;25;1;26;6
Queen of Outer Space;1958;Rotten;17;22;2;10;12;0
Queen of the Damned;2002;Rotten;17;66;22;108;130;35
Queen of the Desert;2017;Rotten;18;34;14;65;79;23
Queen of the Lot;2010;Rotten;36;63;5;9;14;8
Queen Of The Sun: What are the Bees Telling Us?;2011;Fresh;94;83;31;2;33;16
Reinas (Queens);2006;Rotten;45;60;14;17;31;17
Quest For Camelot;1998;Rotten;45;59;13;16;29;9
Quest for Fire;1981;Fresh;86;75;19;3;22;5
Quick Change;;Fresh;82;71;27;6;33;11
Quicksilver;1986;Rotten;13;37;2;13;15;3
The Quiet Earth;1985;Fresh;71;69;12;5;17;4
The Quiet Man;1952;Certified-Fresh;91;91;41;4;45;8
Quigley Down Under;;Rotten;59;74;10;7;17;3
Quill: The Life of a Guide Dog;2012;Fresh;81;81;17;4;21;11
Quills;2000;Certified-Fresh;75;83;95;31;126;40
Quinceanera;2006;Certified-Fresh;86;72;83;13;96;36
Quincy;2018;Fresh;82;85;27;6;33;11
Quintet;1979;Rotten;20;37;2;8;10;2
Quitters;2016;Rotten;44;55;4;5;9;5
Quiz Show;1994;Certified-Fresh;96;87;54;2;56;15
'R Xmas;2001;Fresh;65;43;17;9;26;6
R100;2015;Fresh;71;50;20;8;28;9
Raaz 3: The Third Dimension 3D;2012;Fresh;60;31;3;2;5;2
Rabbit Hole;2010;Certified-Fresh;87;72;173;27;200;57
Rabbit-Proof Fence;2002;Certified-Fresh;87;86;124;18;142;30
Rabid;1979;Fresh;73;46;19;7;26;3
Rabid;2019;Rotten;55;35;17;14;31;5
Rabid Dogs (Enrages);2016;Fresh;71;48;5;2;7;2
Rabies;1900;Fresh;82;48;9;2;11;1
Rabin, the Last Day;2016;Fresh;68;43;13;6;19;7
Race You to the Bottom;2005;Rotten;54;34;7;6;13;5
Race;2016;Fresh;62;77;97;59;156;40
Race the Sun;1996;Rotten;22;41;2;7;9;3
Race to Nowhere;2010;Fresh;71;71;5;2;7;2
Race to Witch Mountain;2009;Rotten;43;44;66;89;155;39
Race with the Devil;1975;Fresh;64;54;9;5;14;3
Rachel Getting Married;2008;Certified-Fresh;84;62;170;32;202;55
Rachel, Rachel;1968;Fresh;86;77;6;1;7;0
Racing Dreams;2010;Fresh;100;76;27;0;27;7
Racing Stripes;2005;Rotten;35;42;35;65;100;29
Racing With the Moon;1984;Fresh;60;62;6;4;10;4
The Racket;1951;Rotten;43;46;3;4;7;2
RAD;1986;Rotten;40;90;4;6;10;2
Radio;2003;Rotten;35;79;43;79;122;35
Radio Days;1987;Fresh;90;84;26;3;29;6
Radio Flyer;1992;Rotten;33;73;13;26;39;13
Radio Free Albemuth;2014;Rotten;33;54;4;8;12;5
Radio Unnameable;2012;Fresh;100;64;13;0;13;7
Radioflash;2019;Rotten;0;49;0;12;12;3
Radioland Murders;1994;Rotten;24;59;4;13;17;3
Radius;1900;Fresh;93;61;13;1;14;1
Rag Doll;2020;Rotten;40;100;2;3;5;0
The Rage: Carrie 2;1999;Rotten;19;33;7;29;36;6
A Rage in Harlem;1991;Fresh;65;51;22;12;34;15
Raggedy Man;1981;Fresh;83;57;5;1;6;1
Raging Bull;1980;Certified-Fresh;93;93;69;5;74;19
Ragtime;1981;Fresh;92;77;12;1;13;1
Raiders of the Lost Ark;1981;Certified-Fresh;95;96;76;4;80;19
Raiders!: The Story of the Greatest Fan Film Ever Made;2016;Certified-Fresh;91;78;49;5;54;17
Railroad Tigers;2017;Rotten;38;46;13;21;34;10
Railroaded;2003;Fresh;80;53;4;1;5;0
Rain Man;1988;Certified-Fresh;89;90;71;9;80;17
The Rain People;1969;Fresh;83;62;10;2;12;4
Rain Without Thunder;1992;Rotten;50;64;3;3;6;2
Rainbow Brite and the Star Stealer;1985;Rotten;0;79;0;7;7;3
Rainbow Time;2016;Fresh;67;48;10;5;15;6
Raise Ravens (Cria Cuervos);1976;Fresh;100;94;16;0;16;5
Raise the Titanic;1980;Rotten;38;28;3;5;8;2
Raise Your Voice;2004;Rotten;15;71;13;72;85;30
Raising Arizona;1987;Certified-Fresh;91;85;52;5;57;9
Raising Cain;1992;Rotten;58;41;21;15;36;6
Raising Helen;2004;Rotten;25;61;33;100;133;37
Raising Victor Vargas;2003;Certified-Fresh;96;83;106;4;110;35
Raja;2004;Fresh;71;46;10;4;14;5
Rajma Chawal;2018;Fresh;60;;3;2;5;1
Raajneeti;2010;Rotten;13;65;1;7;8;3
Ralph Breaks the Internet;2018;Certified-Fresh;88;65;239;33;272;41
Ram Dass: Fierce Grace;2001;Fresh;83;80;19;4;23;8
Rambling Rose;1991;Fresh;100;53;19;0;19;7
Rambo: First Blood Part II;1985;Rotten;35;60;15;28;43;6
Rambo III;1988;Rotten;39;45;14;22;36;5
Rambo: Last Blood;2019;Rotten;26;82;45;125;170;25
Ramen Heads;2018;Fresh;65;88;11;6;17;8
Rammbock: Berlin Undead;2011;Fresh;89;59;8;1;9;2
Ramona and Beezus;2010;Certified-Fresh;70;71;64;27;91;35
Rampage;2018;Rotten;51;71;140;135;275;48
Rampart;1900;Certified-Fresh;74;35;110;39;149;42
Ran;1985;Certified-Fresh;97;95;84;3;87;26
Rancho Deluxe;1975;Fresh;69;36;9;4;13;5
Random Harvest;1942;Fresh;90;88;9;1;10;0
Random Hearts;1999;Rotten;15;24;13;74;87;28
Rang De Basanti (Paint it Yellow);2006;Fresh;86;94;6;1;7;3
Range Runners;1900;Rotten;20;86;1;4;5;0
Rango;2011;Certified-Fresh;88;69;195;27;222;45
Rapt;2011;Fresh;97;66;34;1;35;13
The Rapture;1991;Fresh;67;62;20;10;30;5
Rapture-Palooza;2013;Rotten;24;29;5;16;21;6
Rare Birds;2001;Rotten;54;69;7;6;13;4
Rare Exports: A Christmas Tale;2010;Certified-Fresh;90;70;94;11;105;26
Rashomon;1951;Certified-Fresh;98;93;54;1;55;12
Rasputin and the Empress;1933;Fresh;60;48;3;2;5;0
Rat Race;2001;Rotten;44;64;56;72;128;30
Ratatouille;2007;Certified-Fresh;96;87;239;11;250;54
Ratchet & Clank;2016;Rotten;21;42;17;63;80;21
Ratter;2016;Fresh;60;66;3;2;5;1
Rattlesnake;1900;Rotten;28;15;5;13;18;3
Ravenous;1999;Rotten;48;78;29;32;61;16
Ravenous (Les affames);2018;Fresh;87;60;27;4;31;3
Raw;2017;Certified-Fresh;92;76;174;15;189;35
Raw Faith;2011;Fresh;100;72;7;0;7;3
Rawhead Rex;1987;Rotten;25;39;2;6;8;0
Ray;2004;Certified-Fresh;80;87;164;42;206;43
Ray Harryhausen: Special Effects Titan;2011;Fresh;92;71;11;1;12;4
Ray Romano: Right Here, Around the Corner;1900;Rotten;57;;4;3;7;2
Raze;2014;Rotten;45;29;15;18;33;15
Razorback;1984;Rotten;58;48;7;5;12;4
RBG;1900;Certified-Fresh;94;78;165;11;176;38
Reach Me;2014;Rotten;4;48;1;22;23;12
The Reader;2008;Fresh;63;79;127;75;202;51
Ready;2011;Rotten;30;47;3;7;10;3
Ready or Not;2019;Certified-Fresh;88;78;263;36;299;32
Ready Player One;2018;Certified-Fresh;72;77;310;123;433;56
Ready to Mingle (Bachelorettes) (Solteras);1900;Rotten;44;48;4;5;9;0
Ready to Rumble;2000;Rotten;23;52;16;54;70;18
Ready to Wear (Pret-a-Porter);1994;Rotten;24;27;6;19;25;7
Real Genius;1985;Fresh;73;83;22;8;30;6
Real Life;1979;Fresh;81;82;17;4;21;4
Real Steel;2011;Fresh;60;73;140;93;233;51
Real Women Have Curves;2002;Certified-Fresh;84;75;73;14;87;26
Reality;2013;Certified-Fresh;80;69;63;16;79;28
Reality (Realite);2015;Fresh;64;66;16;9;25;9
Reality Bites;1993;Fresh;66;74;38;20;58;18
Reality Queen!;2020;Rotten;36;;4;7;11;1
Realive;2017;Fresh;77;52;24;7;31;7
Re-Animator;1985;Certified-Fresh;93;82;57;4;61;8
Reap the Wild Wind;1900;Fresh;80;56;8;2;10;1
The Reaping;2007;Rotten;8;49;11;123;134;31
Reasonable Doubt;2014;Rotten;22;31;2;7;9;4
Rebel in the Rye;2017;Rotten;30;61;26;62;88;28
Rebel Without a Cause;1955;Certified-Fresh;94;88;47;3;50;11
Rebels of the Neon God;2015;Fresh;100;76;33;0;33;13
Rebound;2005;Rotten;14;38;13;79;92;32
Rebuilding Paradise;2020;Certified-Fresh;92;;54;5;59;13
[Rec] 2;2010;Fresh;68;60;49;23;72;18
[REC] 3 Genesis;2012;Rotten;40;27;19;28;47;10
[REC] 4: Apocalypse;2015;Fresh;68;34;15;7;22;4
Allegiance;2012;Rotten;29;41;4;10;14;5
Recess: School's Out;2001;Fresh;60;56;42;28;70;23
Reclaim;2014;Rotten;0;28;0;10;10;5
Recovery Boys;2018;Fresh;100;79;11;0;11;3
The Recruit;2003;Rotten;43;58;71;96;167;39
Red;2010;Certified-Fresh;72;72;151;59;210;44
Red Tails;2012;Rotten;40;58;54;80;134;35
Red 2;2013;Rotten;44;63;66;85;151;40
Csillagosok, katonak (The Red and The White);1967;Fresh;93;86;14;1;15;4
Red Army;2015;Certified-Fresh;92;85;93;8;101;32
The Red Badge of Courage;1951;Fresh;83;70;10;2;12;1
Red Christmas;2017;Rotten;48;18;10;11;21;4
Red Cliff (Chi Bi);2009;;;;106;11;;38
Red Corner;1997;Rotten;30;48;7;16;23;6
Red Dawn;2012;Rotten;15;51;21;122;143;38
Red Dog;1900;Fresh;83;80;30;6;36;7
Red Dog: True Blue;1900;Fresh;100;67;13;0;13;3
Red Dragon;2002;Fresh;68;74;130;60;190;42
Red Hill;2010;Certified-Fresh;79;57;54;14;68;18
Red Hollywood;2014;Fresh;75;40;6;2;8;5
Red Hook Summer;2012;Rotten;58;34;38;28;66;27
The Red House;1947;Fresh;83;68;5;1;6;0
Red Joan;2019;Rotten;30;55;44;105;149;26
Red Knot;2014;Fresh;89;45;8;1;9;4
Red Letter Day;1900;Fresh;67;12;4;2;6;0
Red Lights;2004;Certified-Fresh;83;65;72;15;87;35
Red Lights;2012;Rotten;30;36;28;65;93;32
Red Obsession;2013;Fresh;86;70;19;3;22;8
Red Penguins;1900;Certified-Fresh;98;100;40;1;41;10
Red Planet;2000;Rotten;14;28;14;88;102;31
Red Riding: 1980;2010;Fresh;92;74;11;1;12;1
Red Riding: 1983;2009;Fresh;91;76;10;1;11;1
Red River;1900;Fresh;100;87;29;0;29;6
Red Road;2007;Certified-Fresh;88;71;77;11;88;28
Red Rock West;1900;Fresh;95;75;35;2;37;9
Red Scorpion;1989;Rotten;17;36;2;10;12;3
Red Sparrow;2018;Rotten;45;49;133;163;296;53
Red State;2011;Fresh;60;54;55;36;91;15
Red Trees;2017;Rotten;56;;5;4;9;3
Red Trousers: The Life of the Hong Kong Stuntmen;2003;Rotten;24;33;4;13;17;8
Red White & Blue;2010;Fresh;81;66;21;5;26;9
Redacted;2007;Rotten;45;45;49;60;109;40
Redbelt;2008;Fresh;68;65;98;47;145;43
Redemption Road;2011;Rotten;57;59;4;3;7;2
Redline;2007;Rotten;0;47;0;27;27;13
Redline;2011;Fresh;67;84;6;3;9;2
Reds;1981;Certified-Fresh;89;83;39;5;44;5
Redwood Highway;2014;Fresh;80;52;8;2;10;3
I'm Reed Fish;2007;Rotten;52;41;11;10;21;8
Reefer Madness (Tell Your Children) (Doped Youth);1900;Rotten;39;37;11;17;28;3
Reel Injun;2010;Fresh;88;85;15;2;17;6
Reel Paradise;2005;Fresh;69;61;33;15;48;18
The Ref;1994;Certified-Fresh;72;73;39;15;54;14
The Reflecting Pool;1900;Rotten;43;50;3;4;7;3
Reflections in a Golden Eye;1967;Rotten;55;59;12;10;22;5
Reform School Girls;1986;Rotten;25;64;2;6;8;0
Refuge;2014;Rotten;33;50;3;6;9;4
Regarding Henry;1991;Rotten;41;63;12;17;29;4
ReGeneration;1900;Fresh;67;58;4;2;6;0
Regression;2016;Rotten;15;21;6;35;41;10
Reign of Fire;2002;Rotten;42;49;74;102;176;42
Reign Over Me;2007;Fresh;64;81;99;55;154;43
Reincarnated;2013;Rotten;28;41;8;21;29;14
Reindeer Games (Deception);2000;Rotten;25;27;22;66;88;27
The Reivers;1969;Fresh;80;49;4;1;5;1
Rejoice & Shout;2011;Fresh;76;58;29;9;38;15
Relative Values;2000;Rotten;20;63;1;4;5;2
Relentless;1989;Rotten;33;33;2;4;6;0
The Relic;1997;Rotten;36;34;12;21;33;6
Relic;2020;Certified-Fresh;91;49;176;17;193;28
Religulous;2008;Fresh;69;78;107;49;156;48
The Remains of the Day;1993;Certified-Fresh;95;89;40;2;42;10
ReMastered: The Two Killings of Sam Cooke;1900;Fresh;100;;5;0;5;0
Nightwatching;2007;Fresh;85;61;23;4;27;10
Remember;2016;Fresh;70;79;67;29;96;24
Remember the Daze;2008;Rotten;0;47;0;6;6;4
Remember the Titans;2000;Fresh;73;93;98;37;135;35
Rememory;2017;Rotten;25;43;5;15;20;7
Remo Williams - The Adventure Begins;1985;Rotten;39;58;7;11;18;2
Renaissance;2006;Rotten;49;59;38;39;77;22
Renaissance Man;1994;Rotten;12;53;3;22;25;9
Rendition;2007;Rotten;47;62;72;82;154;47
Renegade;2004;Rotten;22;49;2;7;9;2
Reno 911!: Miami;2007;Rotten;34;51;33;65;98;32
Renoir;2013;Fresh;72;53;50;19;69;27
Rent-A-Pal;1900;Fresh;67;74;32;16;48;4
Rent-A-Cop;1988;Rotten;15;18;2;11;13;2
Repentance;2014;Rotten;20;42;1;4;5;1
The Replacement Killers;1998;Rotten;36;47;13;23;36;7
The Replacements;2000;Rotten;41;66;44;64;108;32
Replicant;2001;Rotten;27;37;3;8;11;0
Replicas;2019;Rotten;11;33;6;50;56;8
Repo Man;1984;Certified-Fresh;98;78;45;1;46;5
Repo! The Genetic Opera;2008;Rotten;40;73;24;36;60;18
Repossessed;;Rotten;0;36;0;7;7;0
Reprisal;2018;Rotten;8;17;1;12;13;5
The Reptile;1966;Fresh;71;39;5;2;7;0
Reptilicus;1963;Rotten;25;25;2;6;8;0
The Republic of Love;2004;Rotten;44;48;4;5;9;2
Repulsion;1965;Certified-Fresh;95;86;61;3;64;13
Requiem for a Dream;2000;Certified-Fresh;79;93;109;29;138;37
Requiem For The American Dream;2016;Fresh;92;84;23;2;25;9
Rescue Dawn;2007;Certified-Fresh;90;75;146;17;163;50
The Rescuers Down Under;;Fresh;70;68;19;8;27;6
Reservation Road;2007;Rotten;38;52;42;70;112;36
Reservoir Dogs;1992;Certified-Fresh;92;94;65;6;71;24
Reset (Releve: Histoire d'une creation);2017;Fresh;71;44;12;5;17;9
Reset;2017;Rotten;50;57;4;4;8;4
Resident Evil;2002;Rotten;36;67;46;83;129;26
Resident Evil: Afterlife;2010;Rotten;22;48;23;82;105;16
Resident Evil: Apocalypse;2004;Rotten;20;60;26;106;132;28
Resident Evil: Damnation;1900;Fresh;100;70;5;0;5;0
Resident Evil: Degeneration;2008;Fresh;67;57;4;2;6;0
Resident Evil: Extinction;2007;Rotten;24;58;24;75;99;19
Resident Evil: Retribution;2012;Rotten;29;51;21;52;73;12
Resident Evil: The Final Chapter;2017;Rotten;37;48;37;63;100;17
Resident Evil: Vendetta;2017;Rotten;43;47;3;4;7;0
Resistance;1900;Fresh;65;16;11;6;17;4
Resistance;2020;Rotten;56;60;49;38;87;17
Resolution;2013;Fresh;85;64;11;2;13;5
Breathe;2015;Certified-Fresh;92;78;48;4;52;16
Restless;2011;Rotten;38;48;42;70;112;39
Restless City;2012;Rotten;45;26;5;6;11;5
Restrepo;2010;Certified-Fresh;96;88;113;5;118;34
Results;2015;Certified-Fresh;84;36;80;15;95;30
Resurrect Dead: The Mystery of the Toynbee Tiles;2011;Fresh;65;81;13;7;20;12
Resurrecting the Champ;2007;Fresh;60;60;72;48;120;34
Retaliation (Romans);2020;Fresh;80;52;16;4;20;5
Retreat;2011;Fresh;62;41;8;5;13;3
The Return;2006;Rotten;16;32;9;47;56;19
Return of the Blind Dead (El Ataque de los muertos sin ojos) (Return of the Evil Dead);1900;Rotten;25;50;2;6;8;0
Return of the Secaucus Seven;1980;Fresh;81;74;13;3;16;1
Return;2012;Certified-Fresh;83;42;34;7;41;16
Return from Witch Mountain;1978;Rotten;50;40;5;5;10;1
The Return of a Man Called Horse;1976;Fresh;60;47;6;4;10;1
The Return of Frank James;1940;Fresh;83;48;5;1;6;0
The Return of Swamp Thing;1989;Rotten;44;28;4;5;9;0
Return of the Dragon (The Way of the Dragon);1974;Fresh;92;86;12;1;13;2
Return of the Fly;1959;Rotten;36;26;5;9;14;0
Return of the Killer Tomatoes!;1988;Rotten;0;49;0;6;6;0
The Return of the Living Dead;1985;Fresh;91;79;40;4;44;4
Return of the Living Dead Part II;1988;Rotten;0;44;0;20;20;3
Return of the Living Dead 3;1993;Rotten;58;40;7;5;12;0
The Return of the Pink Panther;1975;Fresh;84;82;16;3;19;0
Return of the Seven;1966;Rotten;13;35;1;7;8;0
Return to Hardwick;1900;Fresh;100;100;5;0;5;1
Return to House on Haunted Hill;1900;Rotten;43;20;3;4;7;0
Return to Me;2000;Fresh;62;79;61;38;99;28
Return to Never Land;2002;Rotten;45;38;43;52;95;24
Return to Nuke 'Em High;2014;Rotten;57;55;8;6;14;6
Return to Sender;2015;Rotten;14;24;5;30;35;10
Return to the Blue Lagoon;1991;Rotten;0;42;0;31;31;10
Reuniting The Rubins;2012;Rotten;0;39;0;18;18;8
They Came Back;2004;Fresh;78;42;7;2;9;0
Revenge;2018;Certified-Fresh;93;57;123;9;132;26
The Revenge of Frankenstein;1958;Fresh;87;67;13;2;15;2
Revenge of the Creature;1955;Rotten;22;31;2;7;9;0
Revenge of the Electric Car;2011;Fresh;69;70;29;13;42;22
Revenge of the Green Dragons;2014;Rotten;15;31;4;22;26;8
Revenge of the Nerds II: Nerds in Paradise;1987;Rotten;7;34;2;25;27;8
The Revenge of the Pink Panther;1978;Fresh;78;70;14;4;18;1
Revenger;1900;Rotten;40;50;2;3;5;0
Reverb;2007;Rotten;9;16;1;10;11;5
Reversal of Fortune;;Certified-Fresh;92;77;46;4;50;13
Reversing Roe;1900;Fresh;88;62;7;1;8;4
Revolution #9;2001;Fresh;76;69;19;6;25;5
Revolution O.S.;2002;Rotten;43;77;6;8;14;3
Revolutionary Road;2008;Fresh;67;71;143;69;212;48
Revolver;2005;Rotten;15;56;10;57;67;24
Rewind;2020;Certified-Fresh;100;95;42;0;42;13
Rewind This!;2013;Fresh;100;74;21;0;21;3
Rhapsody in Blue;2001;Rotten;20;60;1;4;5;0
Rhyme & Reason;1997;Fresh;60;79;0;0;5;0
Rhythm 'N' Bayous: A Road Map To Louisiana Music;1900;Rotten;40;;2;3;5;1
Rich Hill;2014;Certified-Fresh;84;81;42;8;50;22
The Rich Man's Wife;1996;Rotten;13;38;2;13;15;4
Richard III;1956;Fresh;84;79;16;3;19;4
Richard Jewell;2019;Certified-Fresh;77;96;222;67;289;44
Richard Linklater: Dream Is Destiny;2016;Fresh;94;60;29;2;31;15
Richard Pryor Here and Now;1983;Fresh;83;81;5;1;6;1
Richard Pryor---Live in Concert;1900;Fresh;92;93;11;1;12;0
Richard Pryor Live on the Sunset Strip;2000;;;;13;0;;2
Richard Pryor: Omit The Logic;1900;Fresh;86;75;6;1;7;2
Richie Rich;1994;Rotten;24;31;5;16;21;6
Ricki And The Flash;2015;Fresh;65;43;128;70;198;50
Ricky;2009;Fresh;63;36;10;6;16;5
Ricky Gervais: Humanity;1900;Rotten;47;89;7;8;15;10
Riddick;2013;Rotten;57;56;97;73;170;38
Ride Lonesome;1959;Fresh;86;72;6;1;7;2
Ride Along 2;2016;Rotten;13;48;16;104;120;31
Ride Along;2014;Rotten;18;58;24;110;134;45
Ride in the Whirlwind;1967;Fresh;92;62;11;1;12;0
Ride, Rise, Roar;1900;Fresh;75;71;6;2;8;3
Ride the High Country;1900;Fresh;93;84;14;1;15;1
Ride the Pink Horse;1947;Fresh;100;85;8;0;8;0
Ride With the Devil;1999;Fresh;64;66;42;24;66;18
Ride Your Wave;2020;Fresh;93;100;27;2;29;7
Rider on the Rain;1970;Fresh;80;65;4;1;5;0
Riding the Bullet;2004;Rotten;26;34;6;17;23;7
Riding Alone for Thousands of Miles;2006;Certified-Fresh;80;81;60;15;75;24
Riding Giants;2004;Certified-Fresh;93;94;89;7;96;33
Riding in Cars With Boys;2001;Rotten;49;66;53;56;109;33
Rift (Rokkur);1900;Fresh;93;63;13;1;14;1
Right at Your Door;2007;Fresh;69;54;40;18;58;16
Righteous Kill;2008;Rotten;18;37;27;119;146;38
Rigor Mortis;2014;Fresh;68;58;15;7;22;10
Riki-Oh: The Story of Ricky;2002;Fresh;89;85;8;1;9;2
Rim of the World;1900;Rotten;23;47;3;10;13;1
The Ring;2002;Fresh;71;48;146;61;207;48
Ring of Fire;1900;Rotten;33;42;3;6;9;7
The Ring Two;2005;Rotten;20;33;38;151;189;39
Ringmaster;1998;Rotten;21;18;5;19;24;4
Rings;2017;Rotten;8;23;9;104;113;19
Ringu (Ring);1900;Fresh;97;81;38;1;39;11
Ringu 2 (Ring 2);2005;Rotten;0;51;0;13;13;6
Rio;2011;Fresh;72;71;107;42;149;38
Rio Breaks;1900;Fresh;100;86;11;0;11;7
Rio 2;2014;Rotten;48;58;55;60;115;32
Rio Bravo;1959;Certified-Fresh;100;91;43;0;43;9
Rio Conchos;1964;Rotten;50;48;3;3;6;0
Rio Grande;1950;Fresh;77;70;10;3;13;0
Rio Lobo;1971;Fresh;68;72;15;7;22;5
Riot Girls;2019;Fresh;90;43;18;2;20;4
Riot in Cell Block 11;1954;Fresh;100;76;14;0;14;5
RiP: A Remix Manifesto;2009;Rotten;42;74;5;7;12;3
R.I.P.D.;2013;Rotten;13;38;13;91;104;28
Ripe;1900;Rotten;0;46;0;0;6;0
Ripley's Game;2003;Fresh;92;67;22;2;24;6
Rise of the Footsoldier;2007;Rotten;14;83;1;6;7;2
The Rise and Fall of Legs Diamond;1960;Fresh;71;85;5;2;7;1
Rise of the Guardians;2012;Certified-Fresh;75;80;120;41;161;38
Rise of the Legend (Huang feihong zhi yingxiong you meng );2016;Fresh;63;56;5;3;8;4
Rise of the Planet of the Apes;2011;Certified-Fresh;82;77;220;49;269;55
Risen;2016;Rotten;53;70;69;61;130;29
Rising From Ashes;2013;Fresh;79;84;19;5;24;12
Rising High (Betonrausch);1900;Rotten;33;47;3;6;9;4
Rising Sun;1993;Rotten;33;40;13;27;40;14
Ritchie Boys;2006;Fresh;100;69;10;0;10;5
Riten (The Rite) (The Ritual);1969;Fresh;71;71;5;2;7;2
Kinyarwanda;2011;Fresh;100;78;14;0;14;7
The Satanic Rites of Dracula;1974;Rotten;20;30;1;4;5;0
Rites of Spring;2012;Rotten;11;14;1;8;9;2
The Ritz;1976;Rotten;56;81;5;4;9;1
River;2016;Fresh;85;53;11;2;13;5
River of Grass;1995;Fresh;95;55;18;1;19;5
River of No Return;1954;Rotten;57;53;8;6;14;4
River Runs Red;2018;Rotten;22;76;2;7;9;3
A River Runs Through It;1992;Certified-Fresh;80;83;36;9;45;14
The River Wild;1994;Rotten;56;51;18;14;32;8
Rivers and Tides: Andy Goldsworthy Working With Time;2002;Certified-Fresh;99;90;70;1;71;23
River's Edge;1987;Fresh;87;76;34;5;39;9
River's Edge (Ribazu ejji);1900;Fresh;71;;5;2;7;1
Rize;2005;Certified-Fresh;84;85;78;15;93;32
Road, Movie;2010;Fresh;67;50;6;3;9;4
Road Games;1981;Fresh;91;62;10;1;11;4
Road Games;2016;Fresh;84;44;16;3;19;4
Road Hard;2015;Rotten;50;76;11;11;22;13
Road to Bali;1952;Fresh;71;63;5;2;7;1
The Road to El Dorado;2000;Rotten;48;66;50;55;105;30
The Road To Guantanamo;2006;Certified-Fresh;86;83;83;14;97;33
The Road to Love;2001;Rotten;40;56;2;3;5;3
Road to Morocco;1900;Fresh;92;77;11;1;12;0
Road To Nowhere;2011;Fresh;73;39;19;7;26;11
Road to Paloma;2014;Rotten;57;55;8;6;14;5
Road to Perdition;2002;Certified-Fresh;81;86;174;42;216;45
Road to Singapore;1940;Fresh;100;68;9;0;9;0
Road to Utopia;1945;Fresh;100;75;6;0;6;0
Road to Zanzibar;1941;Fresh;89;62;8;1;9;0
Roadie;2012;Fresh;68;31;19;9;28;13
Roadside Prophets;1900;Fresh;83;63;5;1;6;0
Roadside Romeo;2008;Rotten;50;48;3;3;6;1
Roar;1981;Fresh;71;52;17;7;24;5
The Roaring Twenties;1939;Fresh;100;89;14;0;14;1
Rob the Mob;2014;Certified-Fresh;81;57;34;8;42;15
The Robe;1953;Rotten;33;69;6;12;18;4
Robert the Bruce;1900;Rotten;44;67;23;29;52;9
Roberta;1935;Fresh;86;65;6;1;7;0
Robin and Marian;1976;Fresh;73;53;24;9;33;6
Robin and the Seven Hoods;1964;Rotten;40;70;4;6;10;0
Robin Hood;2010;Rotten;43;58;107;142;249;50
Robin Hood;2018;Rotten;15;41;25;140;165;29
Robin Hood: Men in Tights;1993;Rotten;40;81;17;25;42;12
Robin Hood: Prince of Thieves;1991;Rotten;51;72;28;27;55;14
Robin's Wish;1900;;;;38;6;;8
Robinson Crusoe on Mars;1964;Fresh;94;62;16;1;17;1
Robocop 2;;Rotten;30;36;11;26;37;7
RoboCop 3;1993;Rotten;6;15;2;29;31;7
Robot & Frank;2012;Certified-Fresh;86;75;120;19;139;41
Robot Overlords;2015;Fresh;61;24;11;7;18;5
Robot Stories;2004;Fresh;74;54;32;11;43;15
Robots;2005;Fresh;64;53;116;66;182;38
Robyn Hitchcock - Storefront Hitchcock;1998;Fresh;88;77;7;1;8;0
Rocco and His Brothers (Rocco e i suoi fratelli);1961;Fresh;89;94;25;3;28;8
Rock-a-Doodle;1992;Rotten;20;55;3;12;15;2
Rock Dog;2017;Rotten;47;47;27;30;57;18
Rock 'N' Roll Frankenstein;1900;Fresh;60;30;3;2;5;0
Rock of Ages;2012;Rotten;43;55;98;132;230;50
Rock Rubber 45s;2018;Fresh;100;80;8;0;8;3
Rock Star;2001;Rotten;53;59;68;61;129;38
Rock the Bells;2007;Fresh;83;85;15;3;18;10
Rock the Kasbah;2015;Rotten;7;28;9;114;123;40
Rock-a-Bye Baby;1958;Fresh;63;84;5;3;8;2
Rockaway;2019;Fresh;64;98;7;4;11;2
Rockers;1980;Fresh;86;95;6;1;7;5
Rocket Science;2007;Certified-Fresh;84;72;94;18;112;44
Rocket Singh - Salesman of the Year;2009;Fresh;88;67;7;1;8;1
The Rocketeer;1991;Fresh;65;65;41;22;63;11
RocketMan;1997;Rotten;25;72;5;15;20;7
Rocketman;2019;Certified-Fresh;89;88;335;42;377;46
The Rocking Horse Winner;1949;Fresh;83;69;5;1;6;0
RocknRolla;2008;Fresh;60;71;88;59;147;48
Rocko's Modern Life: Static Cling;1900;Fresh;92;67;22;2;24;3
Rockstar;2011;Fresh;83;66;5;1;6;2
Rocky Balboa;2006;Certified-Fresh;77;76;140;42;182;44
The Rocky Horror Picture Show;1975;Certified-Fresh;80;85;35;9;44;6
Rocky II;1979;Fresh;71;82;22;9;31;6
Rocky III;1982;Fresh;63;74;24;14;38;8
Rocky IV;1985;Rotten;40;79;19;29;48;11
Rocky Road to Dublin;1968;Fresh;89;75;8;1;9;5
Rocky V;;Rotten;29;31;10;25;35;8
Rodan;1956;Fresh;70;56;7;3;10;0
Rodents of Unusual Size;2018;Certified-Fresh;98;91;44;1;45;8
Rodin;2018;Rotten;32;21;13;28;41;13
Rodney King;2017;Fresh;100;56;9;0;9;5
Roger & Me;1989;Fresh;100;79;31;0;31;0
Roger Corman's Death Race 2050;1900;Fresh;88;33;7;1;8;0
Roger Dodger;2002;Certified-Fresh;88;76;108;15;123;33
Roger Waters The Wall;2015;Fresh;100;94;6;0;6;2
Rogue;2020;Fresh;71;17;5;2;7;0
Rogue One: A Star Wars Story;2016;Certified-Fresh;84;86;373;73;446;67
Role Models;2008;Certified-Fresh;77;74;125;38;163;45
Roll Bounce;2005;Fresh;65;70;59;32;91;30
Rollerball;1975;Fresh;66;61;21;11;32;7
Rollerball;2002;Rotten;3;14;4;114;118;35
Rollercoaster;1900;Rotten;17;;0;0;6;0
Rolling Family;2006;Rotten;59;70;10;7;17;10
Rolling Thunder Revue: A Bob Dylan Story By Martin Scorsese;1900;Certified-Fresh;92;79;81;7;88;26
Rollover;1981;Fresh;78;34;7;2;9;2
Roma;2018;Certified-Fresh;96;72;370;17;387;56
Roman de gare;2007;Certified-Fresh;87;76;65;10;75;30
Roman Holiday;1953;Certified-Fresh;97;93;57;2;59;11
Roman J. Israel, Esq.;2017;Rotten;54;53;93;80;173;41
Roman Polanski: Wanted and Desired;2008;Certified-Fresh;85;78;41;7;48;16
Romance & Cigarettes;2007;Rotten;52;56;31;29;60;26
Romance on the High Seas;1948;Fresh;88;60;7;1;8;0
Romancing the Stone;1984;Certified-Fresh;85;69;44;8;52;7
Romantico;2006;Fresh;96;95;23;1;24;13
Romantics Anonymous;2011;Fresh;86;73;30;5;35;9
Romeo and Juliet;2013;Rotten;23;46;21;69;90;36
Romeo And Juliet (Broadway Hd);2014;Fresh;71;;5;2;7;3
Romeo & Juliet in Yiddish;2011;Fresh;75;;9;3;12;6
Romeo and Juliet: Sealed With a Kiss;2006;Rotten;20;53;1;4;5;1
Romeo Is Bleeding;1993;Rotten;26;62;10;29;39;12
Romeo Must Die;2000;Rotten;32;61;30;63;93;25
Romero;1989;Fresh;78;80;7;2;9;1
Romper Stomper;1993;Fresh;79;73;22;6;28;6
Romulus, My Father;2008;Rotten;55;65;6;5;11;5
Romy and Michele's High School Reunion;1997;Fresh;73;65;43;16;59;18
Rondo;2018;Fresh;80;50;8;2;10;0
Ronin;1998;Fresh;68;80;46;22;68;15
Rookie of the Year;1900;Rotten;35;52;7;13;20;2
Room;2015;Certified-Fresh;93;93;292;21;312;55
Room 237;2013;Certified-Fresh;94;55;123;8;131;38
Room 6;2006;Rotten;33;19;2;4;6;0
Room For Rent;1900;Fresh;88;53;7;1;8;0
Room for Rent;1900;Fresh;82;45;9;2;11;1
Roommates;1995;Rotten;29;57;4;10;14;3
Rooster Cogburn;1975;Rotten;44;70;4;5;9;1
Rope;1948;Certified-Fresh;94;90;45;3;48;8
Rory O'Shea Was Here;2005;Rotten;49;88;34;35;69;25
Rory Scovel Tries Stand-up For The First Time;1900;Fresh;89;;8;1;9;4
Rose Marie;1936;Fresh;83;73;5;1;6;0
The Rose Tattoo;1955;Fresh;67;74;4;2;6;0
Roseanne for President!;2016;Fresh;60;32;6;4;10;6
Rosemary's Baby;1968;Certified-Fresh;96;87;69;3;72;17
Rosencrantz and Guildenstern Are Dead;1991;Fresh;60;87;18;12;30;6
Rosencrantz and Guildenstern Are Undead;2010;Rotten;40;35;6;9;15;6
Rosenstrasse;2004;Rotten;55;68;34;28;62;27
Rosewater;2014;Certified-Fresh;76;68;116;36;152;52
Rosewood;1997;Certified-Fresh;87;83;48;7;55;15
Rough Night;2017;Rotten;44;29;76;94;169;36
'Round Midnight;1986;Fresh;100;89;20;0;20;8
Roustabout;1964;Rotten;56;57;5;4;9;0
Roving Mars;2006;Fresh;71;78;27;11;38;18
Roxanne;1987;Certified-Fresh;88;63;35;5;40;8
Roxanne Roxanne;1900;Fresh;70;62;21;9;30;10
Roxie Hart;1900;Fresh;82;56;9;2;11;1
Royal Wedding;1951;Fresh;92;69;22;2;24;5
Rubber;2011;Fresh;69;46;60;27;87;21
Ruby Bridges;1997;Fresh;83;86;5;1;6;1
Ruby Sparks;2012;Certified-Fresh;79;75;141;38;179;49
Rudderless;2014;Fresh;64;83;30;17;47;17
Rudo y Cursi;2009;Fresh;73;66;82;30;112;40
Rudolph and Frosty: Christmas in July;1979;Rotten;20;35;1;4;5;1
Rudy;1993;Certified-Fresh;78;90;36;10;46;14
Rugrats Go Wild;2003;Rotten;39;39;35;54;89;31
Rugrats in Paris - The Movie;2000;Certified-Fresh;76;56;56;18;74;25
The Rugrats Movie;1998;Rotten;59;50;30;21;51;13
Ruin Me;1900;Fresh;83;38;10;2;12;1
Rules Don't Apply;2016;Rotten;54;33;97;81;178;43
The Rules of Attraction;2002;Rotten;43;71;60;80;140;33
Rules of Engagement;2000;Rotten;36;55;35;61;96;25
Rumble Fish;1983;Fresh;73;80;24;9;33;6
Rumble in the Bronx;1995;Certified-Fresh;80;65;44;11;55;17
RUMBLE: The Indians Who Rocked the World;2017;Certified-Fresh;91;87;41;4;45;15
Rumor Has It;2005;Rotten;19;41;22;91;113;34
Run for Cover;1995;Fresh;83;60;5;1;6;2
Run All Night;2015;Rotten;59;56;108;76;184;37
Run & Jump;2014;Fresh;89;54;32;4;36;16
Run for the Money;2002;Rotten;0;21;0;5;5;0
Run Lola Run;1999;Certified-Fresh;93;90;77;6;83;20
The Run of the Country;1995;Rotten;50;78;4;4;8;3
Run Ronnie Run!;2002;Fresh;71;72;5;2;7;2
Run Silent, Run Deep;1958;Fresh;100;79;9;0;9;0
Run the Race;2019;Rotten;40;84;4;6;10;3
Run the Tide;2016;Rotten;9;51;1;10;11;4
Run This Town;2020;Rotten;47;28;17;19;36;8
Run with the Hunted;1900;Rotten;0;40;0;11;11;2
Runaway Bride;1999;Rotten;46;53;40;47;87;28
Runaway Jury;2003;Fresh;73;75;119;43;162;42
Runaway Train;1985;Fresh;85;76;29;5;34;6
Rundskop (Bullhead);2012;Certified-Fresh;87;80;65;10;75;25
Runner Runner;2013;Rotten;8;33;9;111;119;36
Runnin' Down a Dream: Tom Petty and the Heartbreakers;2008;Fresh;100;92;5;0;5;1
Running From Crazy;2013;Rotten;58;47;11;8;19;11
The Running Man;1987;Fresh;64;60;27;15;42;7
Running on Empty;1988;Fresh;85;68;11;2;13;2
Running With Scissors;2006;Rotten;31;56;41;91;132;41
Running with the Devil;2019;Rotten;24;39;6;19;25;5
Runoff;2015;Fresh;83;79;15;3;18;9
Rupture;2017;Rotten;18;16;6;28;34;7
Rush;2013;Certified-Fresh;88;88;204;27;231;51
Rush: Beyond the Lighted Stage;2010;Fresh;90;94;9;1;10;3
Rush Hour;1998;Fresh;61;78;45;29;74;18
Rush Hour 2;2001;Rotten;52;74;66;61;127;35
Rush Hour 3;2007;Rotten;18;63;28;130;158;41
Rushlights;2013;Rotten;26;64;5;14;19;8
Rushmore;1998;Certified-Fresh;89;91;92;11;103;28
Russell Mulcahy's Tale of the Mummy;1999;Rotten;17;16;1;5;6;0
The Russia House;;Fresh;72;50;13;5;18;3
Russian Dolls (Les Poupees Russes);2006;Fresh;72;78;34;13;47;22
The Russians Are Coming, the Russians Are Coming;1966;Fresh;86;75;18;3;21;2
Russkies;1987;Rotten;14;43;1;6;7;1
Rust Creek;2019;Certified-Fresh;84;66;37;7;44;8
Rustlers' Rhapsody;1985;Rotten;17;86;2;10;12;5
Ruthless People;1986;Fresh;94;72;33;2;35;9
RV;2006;Rotten;23;45;29;95;124;35
Ryan's Daughter;1970;Rotten;50;73;9;9;18;7
S. Darko: A Donnie Darko Tale;2009;Rotten;13;18;1;7;8;0
S&Man;2010;Fresh;82;55;9;2;11;3
V/H/S/2;2013;Fresh;70;51;45;19;64;19
Saban's Power Rangers;2017;Rotten;49;65;87;89;176;31
Sabotage;2014;Rotten;22;36;25;88;113;35
Saboteur;1942;Fresh;81;71;22;5;27;8
Sabretooth;2002;Rotten;20;14;1;4;5;0
Sacco and Vanzetti;2007;Fresh;86;76;25;4;29;12
Sacred;2017;Fresh;92;;11;1;12;4
Sacred Stage: The Mariinski Theater;2005;Rotten;33;;2;4;6;1
The Saddest Music in the World;2004;Certified-Fresh;79;79;81;22;103;30
The Sadist;1900;Fresh;100;68;5;0;5;0
Safe;1995;Certified-Fresh;86;75;50;8;58;13
Safe;2012;Rotten;58;59;63;46;109;32
Safe Haven;2013;Rotten;13;67;19;127;146;42
Safe House;2012;Rotten;53;63;101;91;192;40
Safe Men;1998;Rotten;57;54;12;9;21;4
Safelight;2015;Rotten;0;35;0;17;17;7
Safety Last!;1923;Fresh;97;93;34;1;35;6
Safety Not Guaranteed;2012;Certified-Fresh;91;80;136;14;150;39
Sagrada: The Mystery of Creation;2014;Rotten;54;63;7;6;13;8
The Sailor Who Fell From Grace With the Sea;1976;Fresh;75;50;6;2;8;0
The Saint;1997;Rotten;30;63;14;32;46;17
Saint Misbehavin': The Wavy Gravy Movie;2010;Fresh;73;88;11;4;15;6
Saint Frances;2020;Certified-Fresh;99;79;83;1;84;21
Saint Jack;1979;Fresh;67;75;10;5;15;4
Saint John of Las Vegas;2010;Rotten;23;28;12;40;52;22
Saint Laurent;2015;Fresh;60;40;52;34;86;32
Saints and Soldiers;2004;Fresh;66;77;23;12;35;14
Salem's Lot;1979;Fresh;88;64;15;2;17;1
Salesman;1968;Fresh;100;89;25;0;25;6
Salmon Fishing in the Yemen;2012;Fresh;67;64;98;49;147;40
Salome's Last Dance;1987;Rotten;43;84;3;4;7;1
Salon Kitty (Edited Version);1976;Rotten;29;53;2;5;7;1
Salt of the Earth;1954;Fresh;100;83;12;0;12;3
The Salton Sea;2002;Fresh;64;82;54;31;85;26
Saludos Amigos;1943;Fresh;83;41;10;2;12;2
Salvador;1986;Fresh;88;86;23;3;26;4
Salvage;2009;Fresh;86;20;6;1;7;3
Salvation Army;2015;Fresh;75;41;9;3;12;4
Salvation Boulevard;2011;Rotten;23;23;8;27;35;18
Salvo;2014;Fresh;75;47;18;6;24;7
Samaritan Girl (Samaria);2004;Rotten;50;75;4;4;8;2
Samba;2015;Fresh;62;54;42;26;68;25
Same Boat;1900;Fresh;64;100;7;4;11;3
Same Kind of Different As Me;2017;Rotten;40;86;4;6;10;6
Sami Blood;2017;Fresh;96;82;27;1;28;7
Sammy's Adventures 2 (Sammy's avonturen 2);1900;Rotten;20;33;2;8;10;2
Sample This;2013;Fresh;93;63;13;1;14;8
SamSam;2020;Rotten;20;;1;4;5;0
Samsara;2012;Certified-Fresh;76;87;60;19;79;30
Samson;2018;Rotten;25;49;4;12;16;4
Samurai Marathon;1900;Fresh;75;;6;2;8;0
San Andreas;2015;Rotten;50;52;122;123;245;50
San Francisco;1936;Fresh;100;70;11;0;11;0
Sanctum;2011;Rotten;29;37;50;120;170;43
Sand Castle;2017;Rotten;47;44;8;9;17;3
Sand Dollars (Dolares de Arena);2015;Fresh;94;46;15;1;16;5
The Sand Pebbles;1966;Fresh;89;88;16;2;18;0
The Sandlot;1993;Fresh;63;89;35;21;56;14
The Sandlot 2;2005;Rotten;40;41;2;3;5;0
The Sandpiper;1965;Rotten;9;43;1;10;11;6
Sands of Iwo Jima;1950;Fresh;100;80;10;0;10;0
Sandy Wexler;1900;Rotten;27;39;6;16;22;6
Sangre De Mi Sangre;2007;Fresh;79;75;30;8;38;19
Sanjuro (Tsubaki Sanjuro);1963;Fresh;100;95;23;0;23;4
Santa & Andres;2017;Fresh;88;;7;1;8;4
Santa Buddies;2009;Rotten;20;56;1;4;5;0
Santa Claus Conquers the Martians;1964;Rotten;23;28;5;17;22;3
Santa Claus Is Comin' to Town;1970;Fresh;93;82;13;1;14;4
Santa Claus: The Movie;1985;Rotten;20;66;4;16;20;3
The Santa Clause 3: The Escape Clause;2006;Rotten;17;39;11;55;66;21
Santa Fe Trail;1940;Fresh;83;51;5;1;6;0
Santa Sangre;;Certified-Fresh;86;87;36;6;42;14
Santa's Apprentice (L'apprenti Pere Noel);1900;Fresh;80;39;8;2;10;2
Santoalla;2017;Fresh;85;85;11;2;13;7
The Saphead;1920;Rotten;50;48;3;3;6;2
Saraband;2003;Certified-Fresh;91;87;77;8;85;31
Sarafina!;1992;Fresh;60;88;6;4;10;1
Sarah Landon and the Paranormal Hour;2007;Rotten;0;25;0;12;12;3
Sarah Silverman: A Speck of Dust;2017;Fresh;100;49;10;0;10;5
Sarah Silverman: Jesus Is Magic;2005;Fresh;65;65;66;36;102;33
Sarah Silverman: We are Miracles;1900;Fresh;80;51;4;1;5;3
Sarah's Key;2011;Certified-Fresh;72;82;84;33;117;41
Sassy Pants;2012;Rotten;50;48;3;3;6;5
Satan Hates You;2011;Rotten;33;0;2;4;6;3
Satanic Panic;2019;Fresh;62;47;38;23;61;6
Satan's Playground;2006;Fresh;67;26;4;2;6;1
Saturday Church;2018;Fresh;93;75;27;2;29;9
Saturday Night And Sunday Morning;1961;Fresh;93;87;13;1;14;1
Saturday Night Fever;1977;Certified-Fresh;82;71;41;9;50;9
Saturday the 14th;1981;Rotten;10;31;1;9;10;0
Saturn 3;1900;Rotten;25;31;3;9;12;1
Sausage Party;2016;Certified-Fresh;82;50;191;42;233;44
Savage Dog;2017;Fresh;69;42;9;4;13;3
Savage Grace;2007;Rotten;38;38;36;58;94;32
Savage Sam;1963;Rotten;50;47;3;3;6;0
The Savages;2007;Certified-Fresh;89;74;152;18;170;44
Savages;2012;Rotten;50;54;97;96;193;52
Savannah;2013;Rotten;13;35;2;13;15;6
Save Me;2008;Fresh;68;67;21;10;31;12
Save The Date;2012;Rotten;47;36;14;16;30;14
Save the Last Dance;2001;Rotten;53;59;52;47;99;32
Save the Tiger;1973;Fresh;85;74;11;2;13;1
Saved!;2004;Fresh;61;78;89;57;146;39
Saving Shiloh;2006;Rotten;36;74;8;14;22;10
Saving Capitalism;2017;Fresh;100;64;5;0;5;1
Saving Face;2005;Certified-Fresh;86;88;74;12;86;28
Saving Grace B. Jones;2012;Rotten;14;54;1;6;7;5
Saving Mr. Banks;2013;Certified-Fresh;79;84;206;55;260;53
Saving Private Ryan;1998;Certified-Fresh;93;95;132;10;142;42
Saving Santa;1900;Rotten;17;40;1;5;6;1
Saving Silverman;2001;Rotten;19;51;19;82;101;35
Saving Zoe;2019;Rotten;0;49;0;6;6;1
Saw;2004;Rotten;49;84;91;93;184;44
Saw 3D;2010;Rotten;10;42;8;72;80;17
Saw III;2006;Rotten;28;71;26;66;92;23
Saw IV;2007;Rotten;19;62;16;67;83;20
Saw VI;2009;Rotten;39;55;29;45;74;14
Saw II;2005;Rotten;37;59;45;77;122;30
Saw V;2008;Rotten;13;52;10;67;77;17
Sawdust and Tinsel;1953;Fresh;100;84;9;0;9;2
Say Anything...;1989;Certified-Fresh;98;85;45;1;46;8
Say Her Name: The Life and Death of Sandra Bland;1900;Fresh;100;58;10;0;10;5
Say It Isn't So;2001;Rotten;9;32;9;96;105;35
Say Uncle;2006;Rotten;17;41;3;15;18;7
Scaffolding;2018;Fresh;83;80;10;2;12;4
Scalene;2012;Fresh;78;52;7;2;9;3
The Scalphunters;1968;Fresh;70;56;7;3;10;4
A Scandal in Paris;1946;Fresh;71;64;5;2;7;1
A Scanner Darkly;2006;Fresh;68;74;126;60;186;46
Scarborough;2019;Fresh;60;;6;4;10;2
Scarecrows;1988;Rotten;42;37;5;7;12;1
Scared to Death;1947;Fresh;63;16;5;3;8;0
Scarface;1983;Certified-Fresh;82;93;58;13;71;15
Scarlet Diva;2000;Rotten;52;52;13;12;25;8
Scarlet Street;1900;Fresh;100;88;15;0;15;0
Scarred Hearts;2018;Fresh;78;86;14;4;18;5
Scars of Dracula;1970;Rotten;33;43;2;4;6;0
Scary Movie;2000;Rotten;53;43;61;55;116;32
Scary Movie 2;2001;Rotten;15;52;16;93;109;31
Scary Movie 3;2003;Rotten;35;54;46;85;131;35
Scary Movie 4;2006;Rotten;35;51;45;83;128;27
Scary Movie 5;2013;Rotten;4;38;2;50;52;14
Scary Stories;2019;Fresh;82;67;9;2;11;1
Scary Stories to Tell in the Dark;2019;Certified-Fresh;78;72;178;51;229;27
Scatter My Ashes At Bergdorf's;2013;Rotten;50;42;23;23;46;23
Scenes from a Mall;1991;Rotten;32;25;8;17;25;8
Scenes from a Marriage (Scener ur ett aktenskap);1974;Fresh;90;95;19;2;21;4
Scenic Route;2013;Fresh;67;50;14;7;21;9
Scheme Birds;1900;Fresh;91;;10;1;11;2
Schindler's List;1993;Certified-Fresh;97;97;97;3;100;24
Schizopolis;1996;Fresh;61;81;11;7;18;3
Schlock;1973;Fresh;71;42;5;2;7;0
Schneider vs. Bax;1900;Fresh;63;50;5;3;8;0
School Daze;1988;Rotten;56;80;15;12;27;5
School for Scoundrels;2006;Rotten;26;52;36;104;140;40
School Life (La vie scolaire);1900;Fresh;89;76;8;1;9;2
School of Rock;2003;Certified-Fresh;91;64;182;17;199;43
School Ties;1992;Fresh;60;68;24;16;40;9
Schultze Gets the Blues;2005;Fresh;71;73;45;18;63;22
Scoob!;2020;Rotten;48;55;70;75;145;24
Scooby-Doo 2: Monsters Unleashed;2004;Rotten;22;39;26;93;119;29
Scooby-Doo and the Alien Invaders;1900;Fresh;80;57;4;1;5;0
Scooby-Doo on Zombie Island;1998;Fresh;86;78;6;1;7;0
Scooby-Doo and the Cyber Chase;1900;Fresh;60;65;3;2;5;0
Scooby-Doo and the Reluctant Werewolf;1900;Rotten;20;61;1;4;5;0
Scooby-Doo and the Witch's Ghost;1900;Rotten;50;73;3;3;6;0
Scoop;2006;Rotten;41;55;61;88;149;40
Scorched Earth;2018;Rotten;18;40;2;9;11;3
SCORE: A Film Music Documentary;2017;Fresh;91;83;30;3;33;14
The Scorpion King;2002;Rotten;41;38;56;82;138;30
Scotch: A Golden Dream;1900;Fresh;67;92;6;3;9;3
Scott Walker: 30 Century Man;2006;Fresh;87;80;27;4;31;16
Scott Pilgrim vs. the World;2010;Certified-Fresh;82;84;222;49;271;48
The Scout;1994;Rotten;22;22;5;18;23;8
Scouts Guide to the Zombie Apocalypse;2015;Rotten;44;48;42;54;96;21
Scratch;2002;Certified-Fresh;93;93;43;3;46;16
Scream 4;2011;Fresh;60;55;110;74;184;44
Scream 2;1997;Certified-Fresh;81;57;63;15;78;19
Scream 3;2000;Rotten;39;37;48;74;122;30
Scream, Blacula, Scream;1973;Rotten;29;37;2;5;7;0
Scream, Queen! My Nightmare on Elm Street;1900;Fresh;100;94;28;0;28;4
Screened Out;1900;Fresh;78;;14;4;18;5
Screwball;2019;Fresh;94;93;30;2;32;9
Screwed;2011;Rotten;36;28;5;9;14;5
Scrooged;1988;Fresh;71;71;34;14;48;11
Scumrock;2004;Fresh;60;29;6;4;10;4
Sea Fever;2020;Certified-Fresh;86;47;87;14;101;15
Sea Fog (Haemoo);1900;Fresh;77;66;10;3;13;2
The Sea Inside (Mar Adentro) (The Sea Within);2004;Certified-Fresh;84;92;114;21;135;40
The Sea of Grass;1947;Rotten;14;35;1;6;7;3
Sea of Love;1989;Fresh;76;66;22;7;29;5
Seabiscuit;2003;Certified-Fresh;78;76;159;46;205;47
The Seagull's Laughter (Mavahlatur);2001;Fresh;84;69;27;5;32;13
Seahorse: The Dad Who Gave Birth;1900;Fresh;100;;16;0;16;4
Seal Team 6: The Raid on Osama Bin Laden;1900;Rotten;50;45;3;3;6;3
Search Party;2016;Rotten;11;31;2;17;19;10
The Searchers;1956;Certified-Fresh;98;88;46;1;47;9
Searching;2018;Certified-Fresh;92;87;228;20;248;35
Searching for Bobby Fischer;1993;Certified-Fresh;100;86;44;0;44;13
Searching for Sugar Man;2012;Certified-Fresh;95;92;123;7;130;41
Seasons (Les saisons);2016;Fresh;97;70;28;1;29;12
Sebastiane;1976;Fresh;86;56;6;1;7;0
Second Act;2018;Rotten;44;43;48;62;110;28
Second Coming;1900;Fresh;76;39;16;5;21;10
Second Opinion: Laetrile at Sloan-Kettering;2014;Rotten;58;73;7;5;12;5
Secondhand Lions;2003;Fresh;60;84;82;55;137;34
Seconds;1966;Fresh;89;87;31;4;35;3
Secrecy;2008;Fresh;94;56;16;1;17;10
Secret Ballot;2002;Certified-Fresh;82;63;47;10;57;20
Secret Honor;1984;Fresh;77;79;10;3;13;3
The Secret in Their Eyes (El Secreto de Sus Ojos);2010;Certified-Fresh;89;93;125;15;140;38
Secret in Their Eyes;2015;Rotten;39;41;58;90;148;34
The Secret Life of Bees;2008;Rotten;59;78;82;57;139;39
Daltry Calhoun;2005;Rotten;7;39;2;26;28;10
The Secret Life of Walter Mitty;1947;Fresh;71;81;5;2;7;0
Secret Obsession;1900;Rotten;29;9;5;12;17;1
The Secret of Moonacre;2008;Rotten;23;45;5;17;22;6
The Secret of My Success;1987;Rotten;57;58;12;9;21;4
The Secret of NIMH;1982;Fresh;93;85;26;2;28;11
The Secret of Santa Vittoria;1969;Fresh;67;82;4;2;6;3
Secret of the Wings;2012;Fresh;62;78;13;8;21;3
Secret Things;2003;Rotten;50;37;25;25;50;19
Secret Window;2004;Rotten;46;65;75;88;163;40
Secretariat;2010;Fresh;63;76;98;57;155;39
Secretary;2002;Certified-Fresh;76;82;119;37;156;38
Secuestro Express;2005;Rotten;52;75;22;20;42;14
Seducing Charlie Barker;2011;Rotten;56;42;5;4;9;5
See No Evil 2;1900;Fresh;60;31;3;2;5;0
See No Evil, Hear No Evil;1989;Rotten;28;72;8;21;29;10
See Spot Run;2001;Rotten;23;44;18;59;77;28
See You in the Morning;1989;Rotten;55;21;6;5;11;2
See You in Valhalla;2015;Rotten;0;33;0;6;6;2
See You Next Tuesday;2014;Fresh;89;91;8;1;9;6
See You Soon;2019;Rotten;33;62;2;4;6;2
See You Yesterday;1900;Certified-Fresh;95;37;37;2;39;8
Seed of Chucky;2004;Rotten;33;38;25;51;76;18
SEED: The Untold Story;2016;Fresh;93;84;13;1;14;4
Seeds;2019;Rotten;42;25;5;7;12;2
Seeds Of Time;2015;Fresh;67;50;4;2;6;4
Seeing Allred;2018;Fresh;100;76;15;0;15;7
The Seeker: The Dark Is Rising;2007;Rotten;14;33;13;80;93;29
Seeking a Friend for the End of the World;2012;Rotten;55;53;95;77;172;45
Seems Like Old Times;1980;Fresh;72;64;13;5;18;4
Self Medicated;2006;Rotten;37;51;14;24;38;16
Self/Less;2015;Rotten;19;46;27;115;142;36
Selma;2014;Certified-Fresh;99;86;304;4;308;61
Sembene!;2015;Fresh;91;37;21;2;23;9
Semi-Pro;2008;Rotten;22;38;36;126;162;40
Semi-Tough;1977;Fresh;89;31;8;1;9;5
Semper Fi;2019;Rotten;19;71;3;13;16;6
Semper Fi: Always Faithful;1900;Fresh;100;92;11;0;11;2
Send Me No Flowers;1964;Rotten;57;75;8;6;14;4
Senior Love Triangle;1900;Fresh;88;;7;1;8;0
Senna;2011;Certified-Fresh;93;95;113;9;122;43
The Sentinel;2006;Rotten;35;40;47;89;136;37
The Isle;2000;Fresh;78;73;28;8;36;11
Seoul Station;1900;Fresh;100;37;23;0;23;3
Separate Lies;2005;Fresh;71;47;62;25;87;32
September;1987;Fresh;67;52;10;5;15;2
September Dawn;2007;Rotten;16;49;9;46;55;20
The September Issue;2009;Certified-Fresh;83;71;95;19;114;42
September Tapes;2004;Rotten;21;64;7;27;34;13
Septic Man;2014;Rotten;16;15;3;16;19;4
Septien;2011;Rotten;56;43;9;7;16;8
Seraphim Falls;2007;Rotten;55;53;47;38;85;32
Seraphine;2009;Certified-Fresh;88;80;84;11;95;38
Serbis (Service);2008;Fresh;83;51;24;5;29;9
Serena;2015;Rotten;16;23;18;92;110;37
Serendipity;2001;Rotten;58;79;80;58;138;36
Serendipity;2019;Fresh;77;;10;3;13;5
Serenity;2005;Certified-Fresh;82;91;153;34;187;39
Serenity;2019;Rotten;20;29;39;155;194;43
Sergeant Rutledge;1960;Fresh;88;89;7;1;8;0
Sergeant York;1941;Fresh;86;87;19;3;22;3
Sergio;2020;Rotten;43;51;20;26;46;14
Serial Mom;1994;Fresh;63;72;31;18;49;10
Serious Moonlight;2009;Rotten;22;25;8;29;37;16
The Serpent and the Rainbow;1987;Fresh;65;56;22;12;34;7
Serpico;1973;Certified-Fresh;90;88;37;4;41;6
The Servant;1964;Fresh;87;90;34;5;39;13
Serving Sara;2002;Rotten;4;26;5;109;114;28
Sesame Street Presents: Follow That Bird;1985;Fresh;92;71;11;1;12;1
Session 9;2001;Fresh;64;63;45;25;70;17
Set Fire To The Stars;2015;Rotten;58;37;25;18;43;17
Set It Off;1996;Fresh;68;90;19;9;28;7
Set It Up;2018;Certified-Fresh;92;68;54;5;59;14
The Set-Up;1949;Fresh;78;89;7;2;9;0
Seve the Movie;2016;Fresh;73;69;8;3;11;5
Seven Chances;1925;Fresh;100;90;17;0;17;0
Seven Beauties (Pasqualino Settebellezze);1976;Fresh;71;88;12;5;17;1
Seven Brides for Seven Brothers;1954;Fresh;88;87;23;3;26;5
Seven Days in May;1964;Fresh;91;89;20;2;22;4
Seven Days In Utopia;2011;Rotten;21;67;12;44;56;19
Seven Faces of Dr. Lao;1964;Fresh;83;78;5;1;6;0
Seven Girlfriends;1999;Rotten;50;53;3;3;6;0
Seven Men From Now;1956;Fresh;100;81;5;0;5;0
Seven Pounds;2008;Rotten;26;75;51;143;194;48
Seven Psychopaths;2012;Certified-Fresh;83;71;180;38;218;56
Seven Samurai (Shichinin no Samurai);1956;Certified-Fresh;100;97;65;0;65;12
Seven Stages to Achieve Eternal Bliss;2020;Fresh;65;86;11;6;17;2
Chat gim (The Seven Swords);1900;Rotten;25;55;4;12;16;7
The Seven Year Itch;1955;Fresh;87;76;26;4;30;6
Seventeen (Diecisiete);1900;Fresh;82;83;9;2;11;0
The Seventh Seal (Det Sjunde inseglet);1957;Certified-Fresh;93;93;54;4;58;16
The Seventh Sign;1988;Rotten;15;50;3;17;20;1
Seventh Son;2015;Rotten;12;34;14;105;119;35
The Seventh Victim;1943;Fresh;93;63;14;1;15;3
The 7th Voyage of Sinbad;1958;Fresh;100;76;16;0;16;1
Severance;2006;Fresh;66;61;60;31;91;34
Severe Clear;2010;Fresh;78;75;7;2;9;5
Severed Ways: The Norse Discovery of America;2009;Rotten;35;38;7;13;20;8
Sex & Drugs & Rock & Roll;2010;Certified-Fresh;73;66;37;14;51;15
Sex Addict;2008;Fresh;100;36;5;0;5;1
Sex and Breakfast;2007;Rotten;8;21;1;11;12;4
Sex and Death 101;2007;Rotten;27;42;11;30;41;16
Sex and Lucia;2002;Fresh;71;86;50;20;70;25
Sex and the City;2008;Rotten;50;77;90;91;181;48
Sex and the City 2;2010;Rotten;16;43;34;183;217;47
Sex and the Single Girl;1964;Rotten;50;56;3;3;6;3
Sex, Death And Bowling;2015;Rotten;17;72;1;5;6;3
Sex Doll;2017;Rotten;0;40;0;5;5;4
Sex Drive;2008;Rotten;45;58;50;60;110;34
Sex, Drugs, Rock & Roll;1991;Fresh;91;50;10;1;11;3
Sex Is Comedy;2004;Fresh;68;47;32;15;47;21
Sex, Lies, and Videotape;1989;Certified-Fresh;96;79;46;2;48;9
The Sex Monster;2000;Rotten;33;45;0;0;6;0
Sex, Politics & Cocktails;2002;Rotten;0;33;0;11;11;6
Sex Positive;2009;Fresh;81;60;13;3;16;9
Sex Tape;2014;Rotten;16;33;25;129;154;42
Sextette;1978;Rotten;18;26;2;9;11;2
Sextuplets;1900;Rotten;14;36;2;12;14;4
Sexy Beast;2000;Certified-Fresh;87;85;117;18;135;36
Seymour: An Introduction;2015;Certified-Fresh;100;78;68;0;68;29
Sgt. Pepper's Lonely Hearts Club Band;1978;Rotten;12;44;3;23;26;6
Sgt. Bilko;1996;Rotten;31;47;12;27;39;13
Sgt. Stubby: An American Hero;2018;Fresh;89;92;41;5;46;14
Sgt. Will Gardner;2019;Rotten;22;88;2;7;9;5
Shackleton;2002;Fresh;80;77;4;1;5;3
Shade;2003;Fresh;67;58;10;5;15;4
Shadow;2011;Fresh;71;29;5;2;7;3
Shadow;2019;Certified-Fresh;94;79;96;6;102;16
Shadow Company;2007;Fresh;86;85;12;2;14;8
Shadow Conspiracy;1997;Rotten;0;18;0;28;28;11
Shadow Dancer;2013;Certified-Fresh;84;52;76;15;91;30
Shadow: Dead Riot;2005;Rotten;33;21;2;4;6;3
Shadow of the Thin Man;1941;Fresh;83;79;5;1;6;0
Shadow of the Vampire;2000;Certified-Fresh;82;74;113;25;138;36
Shadowboxer;2005;Rotten;19;38;11;47;58;23
Shadowlands;1993;Fresh;97;89;29;1;30;8
Shadows of Forgotten Ancestors (Tini zabutykh predkiv);1967;Fresh;100;89;19;0;19;8
Shadows and Fog;1992;Rotten;52;55;14;13;27;2
Shadows & Lies;1900;Rotten;0;21;0;5;5;2
Shadows in the Sun;2005;Rotten;43;61;3;4;7;1
Shadrach;1998;Rotten;50;65;8;8;16;5
Shaft;2019;Rotten;33;94;42;85;127;23
Shaft in Africa;1973;Fresh;60;52;6;4;10;1
Shaft's Big Score!;1972;Rotten;58;47;7;5;12;2
The Shaggy D.A.;1976;Rotten;50;43;4;4;8;1
The Shaggy Dog;2006;Rotten;26;39;27;78;105;33
Shahid;2013;Fresh;100;93;5;0;5;1
Shakes the Clown;1992;Rotten;43;49;9;12;21;2
Shakespeare Behind Bars;2005;Fresh;93;84;25;2;27;14
Shakespeare High;2012;Fresh;88;78;14;2;16;8
Shakespeare in Love;1998;Certified-Fresh;92;80;130;11;141;44
Shakespeare Wallah;1966;Fresh;89;62;8;1;9;4
Shall We Dance;2004;Rotten;46;57;73;84;157;41
Un Baiser s'il vous plait (Shall We Kiss?);2009;Certified-Fresh;78;62;58;16;74;28
Shallow Ground;2004;Rotten;57;33;4;3;7;0
Shallow Hal;2001;Rotten;50;45;64;65;129;34
Skammen (Shame);1968;Fresh;65;88;15;8;23;5
Shame;2011;Certified-Fresh;79;75;176;47;223;52
Shampoo;1975;Fresh;60;52;21;14;35;8
Shane;1953;Fresh;97;81;35;1;36;5
Shanghai;2015;Rotten;4;36;1;23;24;11
Shanghai Calling;2013;Rotten;53;56;8;7;15;10
Shanghai Knights;2003;Fresh;66;54;99;52;151;33
Shanghai Noon;2000;Certified-Fresh;79;65;106;28;134;32
Shanghai Surprise;1986;Rotten;13;15;1;7;8;0
Shanghai Triad (Yao a yao yao dao waipo qiao);1995;Fresh;90;71;26;3;29;6
Shank;2010;Rotten;0;32;0;10;10;2
Shaolin;2011;Fresh;74;71;20;7;27;12
Shaolin Soccer;2004;Certified-Fresh;90;84;84;9;93;32
Shark Attack 3: Megalodon;2004;Rotten;20;50;1;4;5;0
Shark Night 3D;2011;Rotten;18;22;13;58;71;11
Shark Tale;2004;Rotten;36;49;65;118;183;39
Sharknado;2013;Fresh;78;33;14;4;18;7
Sharknado 2: The Second One;2014;Fresh;61;31;19;12;31;15
Sharknado 3: Oh Hell No!;1900;Rotten;36;28;12;21;33;17
Sharknado 5: Global Swarming;1900;Rotten;30;38;3;7;10;4
Sharknado: The 4th Awakens;2016;Rotten;14;24;2;12;14;3
Sharktopus;2010;Rotten;57;24;4;3;7;0
Sharkwater;2007;Certified-Fresh;80;88;32;8;40;16
Sharky's Machine;1981;Fresh;86;62;19;3;22;6
Sharpay's Fabulous Adventure;1900;Fresh;60;43;3;2;5;0
Shattered Glass;2003;Certified-Fresh;92;79;153;13;166;43
Shaun of the Dead;2004;Certified-Fresh;91;93;192;18;210;46
Shaun the Sheep Movie;2015;Certified-Fresh;99;81;168;1;169;38
The Shawshank Redemption;1994;Certified-Fresh;91;98;68;7;75;19
Shazam!;2019;Certified-Fresh;90;82;362;42;404;48
She Dies Tomorrow;2020;Certified-Fresh;84;23;135;25;160;26
She Done Him Wrong;1933;Fresh;91;53;20;2;22;4
She Gets What She Wants;2005;Rotten;36;38;9;16;25;4
She Hate Me;2004;Rotten;19;60;20;83;103;40
She Wore a Yellow Ribbon;1949;Fresh;95;80;21;1;22;3
She-Devil;1989;Rotten;40;48;8;12;20;2
Sheena;1984;Rotten;30;32;3;7;10;0
Sheitan;1900;Rotten;53;52;9;8;17;6
Shelley;2016;Fresh;91;38;10;1;11;2
The Sheltering Sky;;Rotten;50;79;13;13;26;9
Shenandoah;1965;Fresh;100;79;5;0;5;0
Shepard & Dark;2013;Fresh;86;71;12;2;14;9
Shepherds and Butchers;1900;Rotten;56;51;5;4;9;4
Sherlock Jr.;1924;Fresh;96;95;22;1;23;7
Sherlock Gnomes;2018;Rotten;27;35;18;48;66;12
Sherlock Holmes;2009;Fresh;69;77;170;75;245;56
Sherlock Holmes: A Game of Shadows;2011;Rotten;59;77;135;92;227;49
Sherlock Holmes and the Woman in Green;1945;Fresh;100;58;8;0;8;0
Sherlock Holmes - Dressed to Kill;1946;Fresh;80;66;4;1;5;0
Terror by Night;1946;Fresh;75;63;6;2;8;0
Sherpa;2015;Certified-Fresh;98;81;40;1;41;12
Sherrybaby;2006;Certified-Fresh;75;57;50;17;67;23
She's All That;1999;Rotten;41;55;25;36;61;15
She's Allergic to Cats;1900;Fresh;85;;11;2;13;1
She's Funny That Way;2015;Rotten;44;35;42;54;96;31
She's Gotta Have It;1986;Fresh;91;73;29;3;32;4
She's Having a Baby;1988;Rotten;40;52;16;24;40;12
She's Just a Shadow;2019;Rotten;17;40;1;5;6;3
She's Missing;2019;Fresh;67;29;10;5;15;2
She's Out of Control;1989;Rotten;11;52;2;17;19;7
She's Out of My League;2010;Rotten;58;59;77;55;132;38
She's So Lovely;1997;Fresh;66;62;27;14;41;8
She's the Man;2006;Rotten;43;79;49;64;113;34
She's the One;1996;Fresh;61;41;31;20;51;14
She-Wolf of London (The Curse of the Allenbys);1946;Rotten;17;21;1;5;6;0
Shifty;2008;Fresh;96;67;26;1;27;8
Shiloh 2: Shiloh Season;1999;Fresh;70;62;14;6;20;2
Shimmer Lake;2017;Fresh;60;58;6;4;10;1
Shine;1996;Certified-Fresh;91;90;40;4;44;11
Shine a Light;2008;Certified-Fresh;86;74;108;18;126;41
A Shine of Rainbows;2010;Rotten;50;70;5;5;10;2
The Shining;1980;Certified-Fresh;84;93;78;15;93;18
Shining Through;1992;Rotten;44;72;7;9;16;3
San suk si gin (The Shinjuku Incident);2009;Fresh;60;67;3;2;5;3
Ship of Fools;1965;Fresh;72;78;13;5;18;4
The Shipping News;2001;Rotten;55;61;72;60;132;33
Shiri;2002;Rotten;59;69;22;15;37;15
Shirin In Love;2014;Rotten;21;52;3;11;14;7
Shirkers;2018;Certified-Fresh;100;78;66;0;66;19
Shirley;2020;Certified-Fresh;88;56;190;26;216;36
Shirley Valentine;1989;Fresh;73;86;11;4;15;2
Shock and Awe;2018;Rotten;30;38;14;32;46;16
Shock Corridor;1963;Fresh;95;82;18;1;19;1
The Shock Doctrine;2009;Rotten;58;64;7;5;12;1
Shock to the System: A Donald Strachey Mystery;2006;Rotten;50;53;4;4;8;5
Shock Wave;1900;Fresh;67;58;6;3;9;2
Shocker;1989;Rotten;24;31;5;16;21;1
Shockproof;1949;Fresh;89;46;8;1;9;2
The Shoes of the Fisherman;1968;Rotten;43;75;3;4;7;1
Shoeshine (Sciuscia);1947;Fresh;100;92;6;0;6;1
Sholem Aleichem: Laughing in the Darkness;2011;Certified-Fresh;100;68;43;0;43;17
Shoot 'Em Up;2007;Fresh;67;65;108;53;161;42
Shoot the Moon;1982;Fresh;85;75;11;2;13;3
Shoot the Piano Player (Tirez sur le pianiste);1962;Fresh;90;89;26;3;29;9
Shoot to Marry;2020;Fresh;76;;13;4;17;1
Shooter;2007;Rotten;47;80;70;79;149;47
Shooting Heroin;1900;Rotten;59;95;10;7;17;3
Shooting Robert King;2009;Fresh;100;;5;0;5;2
Shooting the Mafia;2019;Fresh;74;58;32;11;43;13
The Shootist;1976;Fresh;86;88;19;3;22;4
The Shop Around the Corner;1940;Fresh;100;91;32;0;32;6
Shopgirl;2005;Fresh;60;58;93;61;154;41
Shoplifters (Manbiki kazoku);2018;Certified-Fresh;99;91;224;2;226;37
Shopping for Fangs;1998;Rotten;50;20;3;3;6;1
Short Cut to Nirvana: Kumbh Mela;2004;Fresh;71;75;25;10;35;13
Short Circuit 2;1988;Rotten;38;54;5;8;13;0
Short Eyes;1977;Fresh;90;83;9;1;10;2
Short Term 12;2013;Certified-Fresh;98;92;170;3;173;48
Shorts: The Adventures of the Wishing Rock;2009;Rotten;46;32;47;55;102;30
Shot Caller;2017;Fresh;69;80;33;15;48;13
SHOT!: The Psycho-Spiritual Mantra of Rock;2017;Fresh;94;45;16;1;17;7
Shotgun Stories;2007;Certified-Fresh;90;80;44;5;49;18
Shottas;2006;Rotten;19;91;3;13;16;8
Shoujyo: An Adolescent;2005;Rotten;50;81;4;4;8;5
Shout at the Devil;1976;Rotten;50;33;4;4;8;1
Show Dogs;2018;Rotten;16;25;10;53;63;17
Showdown in Little Tokyo;1900;Rotten;33;51;3;6;9;0
Showdown in Manila;2018;Rotten;0;22;0;6;6;3
Showgirls;1995;Rotten;21;37;13;48;61;17
Showrunners: The Art of Running a TV Show;2014;Fresh;67;61;4;2;6;2
Shrek;2001;Certified-Fresh;88;90;180;25;205;50
Shrek 2;2004;Certified-Fresh;89;69;209;27;236;53
Shrek the Third;2007;Rotten;41;52;88;125;213;52
Shrek Forever After;2010;Rotten;58;54;115;84;199;43
Shriek If You Know What I Did Last Friday the 13th;2000;Rotten;14;31;1;6;7;0
Shrooms;2008;Rotten;22;27;4;14;18;6
Shut In;2016;Rotten;7;22;3;41;44;11
Shut Up and Play the Hits;2012;Fresh;85;84;23;4;27;13
Shut Up Little Man!;2011;Fresh;68;62;21;10;31;12
Shutter;2004;Rotten;59;77;16;11;27;8
Siam Sunset;2003;Fresh;67;58;6;3;9;3
Siberia;2018;Rotten;12;17;6;43;49;13
Sicario;2015;Certified-Fresh;92;85;250;22;272;49
Sicario: Day of the Soldado;2018;Fresh;62;65;177;108;285;52
Sick: The Life and Death of Bob Flanagan, Supermasochist;1997;Fresh;91;88;21;2;23;6
Sicko;2007;Certified-Fresh;92;87;200;18;218;58
Siddharth;2014;Certified-Fresh;90;77;37;4;41;12
Side by Side;2012;Certified-Fresh;93;86;63;5;68;24
Side Effects;2005;Rotten;11;29;1;8;9;2
Side Effects;2013;Certified-Fresh;82;70;181;41;222;58
Sidekick;2005;Fresh;100;37;14;0;14;0
Sidewalk Stories;1989;Fresh;100;74;6;0;6;2
Sidewalls;2011;Fresh;67;82;6;3;9;5
Sideways;2004;Certified-Fresh;97;79;225;8;233;50
Sierra Burgess Is a Loser;2018;Fresh;61;30;23;15;38;11
Sightseers;2013;Certified-Fresh;85;62;91;16;107;28
The Signal;2008;Rotten;59;58;41;29;70;18
Signs;2002;Certified-Fresh;74;67;174;62;236;44
Sikandar (Foot Soldier);2009;Rotten;50;53;4;4;8;3
Silence;1900;Fresh;91;;10;1;11;6
Silence;2017;Certified-Fresh;83;69;233;48;281;50
The Silence of the Lambs;1991;Certified-Fresh;96;95;97;4;101;28
Silent Fall;1994;Rotten;22;39;4;14;18;7
Silent Hill;2006;Rotten;31;63;31;70;101;21
Silent Hill: Revelation;2012;Rotten;10;35;6;54;60;12
Silent House;2012;Rotten;43;30;58;77;135;35
Silent Light (Stellet licht);2007;Fresh;88;69;21;3;24;10
Silent Night;2012;Fresh;64;32;7;4;11;5
Silent Rage;1982;Fresh;80;39;4;1;5;0
Silent Running;1972;Fresh;68;66;19;9;28;5
Silent Souls;2011;Certified-Fresh;96;76;45;2;47;18
Silent Tongue;1994;Rotten;38;47;6;10;16;9
Silk Stockings;1957;Fresh;100;68;5;0;5;0
The Silver Chalice;1954;Rotten;13;19;1;7;8;2
Silver City;2004;Rotten;48;32;62;66;128;42
Silver Linings Playbook;2012;Certified-Fresh;92;86;236;21;256;57
Silverado;1985;Fresh;76;80;26;8;34;8
The Simian Line;2000;Rotten;22;70;4;14;18;8
Simon and the Oaks;2012;Rotten;56;56;19;15;34;14
Simon Birch;1998;Rotten;44;77;14;18;32;6
Simon Killer;2013;Certified-Fresh;77;51;47;14;61;23
Simon Sez;1999;Rotten;0;17;0;20;20;7
Simone;2002;Rotten;50;35;80;79;159;38
Simpatico;1999;Rotten;25;14;15;46;61;18
Simple Men;1992;Fresh;91;89;10;1;11;2
A Simple Plan;1998;Certified-Fresh;90;81;65;7;72;11
A Simple Twist of Fate;1994;Rotten;43;57;9;12;21;4
A Simple Wish;1997;Rotten;25;41;4;12;16;3
Simply Irresistible;1999;Rotten;16;54;5;26;31;6
The Simpsons Movie;2007;Certified-Fresh;88;77;195;27;222;50
Sin Alas;2015;Fresh;64;100;7;4;11;4
Sin City;2005;Certified-Fresh;77;78;194;58;252;50
Sin noticias de Dios (Don't Tempt Me);2003;Rotten;38;66;11;18;29;9
Sinbad and the Eye of the Tiger;1977;Fresh;60;55;6;4;10;0
Sinbad: Legend of the Seven Seas;2003;Rotten;45;56;57;71;128;39
Since You've Been Gone;1998;Rotten;20;34;1;4;5;0
Sing;2016;Fresh;72;72;132;51;183;35
Sing Street;2016;Certified-Fresh;95;92;197;10;207;43
Sing Your Song;2012;Certified-Fresh;95;79;38;2;40;21
Singin' in the Rain;1900;Certified-Fresh;100;95;63;0;63;16
The Singing Detective;2003;Rotten;39;40;42;66;108;29
Single White Female;1992;Rotten;54;44;26;22;48;11
Sinister 2;2015;Rotten;16;31;14;76;90;19
Sinister;2012;Fresh;63;61;97;57;154;31
Saint;1900;Rotten;55;29;6;5;11;1
Sione's Wedding (Samoan Wedding);2006;Fresh;83;80;5;1;6;2
Sir! No Sir!;2006;Certified-Fresh;89;83;47;6;53;20
SiREN;2016;Fresh;65;41;13;7;20;5
Sister Act;1992;Fresh;74;65;20;7;27;6
Sister Act 2: Back in the Habit;1993;Rotten;17;61;6;30;36;12
Sister Aimee;2019;Fresh;65;73;13;7;20;7
Sister Helen;2002;Fresh;92;88;12;1;13;4
The Sisterhood of the Traveling Pants;2005;Certified-Fresh;77;78;103;31;134;35
The Sisterhood of the Traveling Pants 2;2008;Fresh;66;66;65;34;99;35
Sisters;1973;Fresh;87;72;33;5;38;8
Sisters;2015;Fresh;60;52;105;71;176;41
Sita Sings the Blues;2008;Fresh;100;85;32;0;32;9
Six Days, Seven Nights;1998;Rotten;36;36;14;25;39;7
Six Degrees of Separation;1993;Fresh;88;71;28;4;32;5
Six Million and One;2012;Fresh;90;80;9;1;10;5
Six Sex Scenes and a Murder;2008;Rotten;17;38;1;5;6;3
Sixteen Candles;1984;Certified-Fresh;84;85;36;7;43;8
The 6th Day;2000;Rotten;40;32;47;70;117;33
The Sixth Man;1997;Rotten;23;58;3;10;13;4
The Sixth Sense;1999;Certified-Fresh;86;90;136;22;158;38
Skate Kitchen;2018;Certified-Fresh;89;78;81;10;91;29
Skateland;2011;Rotten;47;36;14;16;30;11
Skeletons;2010;Fresh;82;71;14;3;17;5
Skeletons in the Closet;2001;Rotten;40;35;2;3;5;0
Sket;1900;Rotten;50;23;4;4;8;4
Sketches of Frank Gehry;2006;Certified-Fresh;82;71;64;14;78;35
Skills Like This;2007;Rotten;59;67;17;12;29;12
Skin;2019;Certified-Fresh;76;83;61;19;80;17
Skin: A History of Nudity in the Movies;1900;;;;30;6;;8
Skin in the Game;2019;Fresh;67;62;4;2;6;2
Skin Trade;2015;Rotten;25;30;4;12;16;4
Skins;2002;Rotten;59;85;34;24;58;21
Skinwalkers;2007;Rotten;13;25;5;33;38;11
Skiptrace;2016;Rotten;38;27;12;20;32;6
Beauty (Skoonheid);1900;Fresh;84;59;16;3;19;4
The Skulls;2000;Rotten;9;43;8;77;85;33
Sky;2016;Rotten;50;48;3;3;6;3
Sky Captain and the World of Tomorrow;2004;Fresh;70;46;149;63;212;43
Sky Ladder: The Art of Cai Guo-Qiang;2016;Fresh;100;83;24;0;24;10
Skyfall;2012;Certified-Fresh;92;86;346;31;377;62
Skyline;2010;Rotten;16;18;13;70;83;18
Skyman;2020;Fresh;63;100;10;6;16;4
Skyscraper;2018;Rotten;48;62;136;150;286;43
Slacker;1991;Fresh;85;77;33;6;39;8
Slackers;2002;Rotten;10;51;11;96;107;33
Slam;1998;Fresh;61;84;14;9;23;8
Slam Dance;1987;Rotten;20;54;1;4;5;1
Slam Dunk Ernest;1995;Rotten;20;31;1;4;5;0
The Slammin' Salmon;2009;Rotten;35;47;9;17;26;10
Slap Shot;1977;Fresh;85;89;28;5;33;6
Slap Shot 2: Breaking the Ice;2001;Rotten;0;36;0;5;5;0
Slappy and the Stinkers;1997;Rotten;0;61;0;5;5;0
Slash;2016;Fresh;92;57;23;2;25;7
Slaughter High;1986;Rotten;0;33;0;5;5;0
The Slaughter Rule;2002;Fresh;74;43;23;8;31;11
Slaughterhouse-Five;1972;Fresh;81;67;13;3;16;0
Slaughterhouse Rulez;1900;Rotten;39;55;13;20;33;8
Slaves of New York;1989;Rotten;22;69;2;7;9;1
Slay the Dragon;2020;Certified-Fresh;100;72;47;0;47;13
SLC Punk;1998;Fresh;63;89;20;12;32;5
Sleep Dealer;2009;Fresh;70;50;23;10;33;13
sleep furiously.;2011;Fresh;71;67;20;8;28;13
Sleep Tight;2012;Fresh;91;78;32;3;35;10
Sleepaway Camp;1983;Fresh;78;60;18;5;23;0
Sleepaway Camp II: Unhappy Campers;1988;Rotten;55;42;6;5;11;0
Sleepaway Camp III: Teenage Wasteland;1989;Rotten;13;30;1;7;8;0
Sleeping Beauty;2011;Rotten;48;32;47;50;97;31
Sleeping Giant;2015;Fresh;87;76;20;3;23;5
Sleeping with Other People;2015;Fresh;63;57;83;48;131;35
Sleeping with the Enemy;1991;Rotten;20;61;7;28;35;10
Sleepless;2017;Rotten;25;37;15;46;61;15
Sleepless Night;2012;Fresh;97;72;31;1;32;14
Sleepover;2004;Rotten;15;54;15;86;101;34
Sleepwalk With Me;2012;Certified-Fresh;84;71;97;18;115;32
Stephen King's 'Sleepwalkers';1992;Rotten;29;31;5;12;17;0
Sleepwalking;2008;Rotten;17;43;10;50;60;27
Sleepy Hollow;1999;Fresh;69;80;84;38;122;32
Sleight;2017;Certified-Fresh;78;52;35;10;45;11
Slender Man;2018;Rotten;8;17;6;73;79;13
Sleuth;2007;Rotten;36;51;44;78;122;40
Slice;2018;Rotten;59;36;13;9;22;3
Sliding Doors;1998;Fresh;64;77;34;19;53;12
Sling Blade;1996;Certified-Fresh;96;92;54;2;56;16
Slingshot;1993;Fresh;89;65;8;1;9;1
Slither;2006;Certified-Fresh;86;63;121;19;140;38
Sliver;1993;Rotten;11;28;3;24;27;4
Slow Burn;2007;Rotten;11;55;4;31;35;12
Slow Learners;2015;Fresh;73;52;8;3;11;6
Slow West;2015;Certified-Fresh;92;74;123;11;134;32
The Slugger's Wife;1985;Rotten;0;21;0;9;9;2
Slugs;1987;Rotten;33;31;3;6;9;0
Slumber;2017;Rotten;0;19;0;7;7;3
The Slumber Party Massacre;1982;Rotten;38;44;6;10;16;0
Slumdog Millionaire;2008;Certified-Fresh;91;90;263;25;288;53
Slums of Beverly Hills;1998;Certified-Fresh;81;68;50;12;62;16
Slutty Summer;2004;Rotten;11;36;1;8;9;5
Small Apartments;2013;Rotten;30;40;3;7;10;2
Small, Beautifully Moving Parts;2012;Rotten;50;50;6;6;12;8
Small Crimes;1900;Rotten;59;30;10;7;17;4
Small Soldiers;1998;Rotten;48;45;21;23;44;12
Small Time;2014;Rotten;54;41;13;11;24;9
Small Time Crooks;2000;Fresh;66;57;66;34;100;24
Small Town Crime;2018;Fresh;77;67;27;8;35;9
Small Town Gay Bar;2007;Fresh;100;69;6;0;6;1
Small Town Murder Songs;2011;Fresh;79;48;15;4;19;9
Smallfoot;2018;Certified-Fresh;75;62;95;31;126;23
Smash His Camera;2010;Fresh;78;63;18;5;23;6
Smash Palace;1900;Fresh;100;81;6;0;6;1
Smashed;2012;Certified-Fresh;83;68;89;18;107;38
Smiles of a Summer Night;1955;Fresh;100;89;15;0;15;1
Smiley;2012;Rotten;18;30;4;18;22;6
Smiley Face;2007;Fresh;67;44;24;12;36;10
Smithereens;1982;Fresh;100;60;9;0;9;0
Smoke Signals;1998;Fresh;83;82;25;5;30;5
Smokey and the Bandit;1977;Fresh;80;85;24;6;30;3
Smokey and the Bandit II;1980;Rotten;14;44;1;6;7;2
Smokin' Aces;2007;Rotten;30;62;48;110;158;44
Smokin' Aces 2: Assassin's Ball;2010;Rotten;44;22;4;5;9;0
Smother;2007;Rotten;38;20;3;5;8;1
Smurfs: The Lost Village;2017;Rotten;40;54;39;58;97;22
Snabba cash (Easy Money);2012;Certified-Fresh;86;63;59;10;69;32
Snake & Mongoo$e;2013;Fresh;80;71;4;1;5;3
Snake Eyes;1998;Rotten;41;35;27;39;66;16
The Snake Pit;1948;Fresh;100;83;8;0;8;2
Snakes on a Plane;2006;Fresh;69;49;122;55;177;43
The Snapper;1993;Fresh;97;86;32;1;33;10
Snapshots;2018;Fresh;71;94;5;2;7;3
Snatch;2001;Fresh;73;93;104;38;142;37
Snatched;2017;Rotten;36;29;76;135;211;48
Snatchers;1900;Fresh;100;60;16;0;16;2
Sneakers;1992;Certified-Fresh;79;80;41;11;52;11
Snitch;2013;Rotten;57;61;85;64;149;35
Snoopy, Come Home;1972;Fresh;93;84;13;1;14;2
Snow Angels;2007;Fresh;68;67;76;36;112;34
Snow Day;2000;Rotten;29;27;19;47;66;20
Snow Dogs;2002;Rotten;25;39;21;62;83;21
Snow Falling on Cedars;1999;Rotten;39;68;36;56;92;27
Snow Flower And The Secret Fan;2011;Rotten;21;47;19;70;89;35
Snow White: A Tale of Terror;1997;Rotten;55;57;6;5;11;0
Snow White and the Huntsman;2012;Rotten;49;52;117;120;237;51
Snowden;2016;Fresh;61;70;156;101;257;54
Snowmen;2011;Fresh;67;62;6;3;9;1
Snowpiercer;2014;Certified-Fresh;94;72;237;16;253;47
The Snows of Kilimanjaro;1952;Fresh;100;52;5;0;5;1
So B. It;2017;Rotten;45;90;5;6;11;4
So Close;2003;Fresh;82;77;31;7;38;11
...So Goes the Nation;2006;Fresh;91;76;21;2;23;14
So I Married an Axe Murderer;1993;Rotten;53;68;20;18;38;10
So Much So Fast;2006;Fresh;96;85;22;1;23;8
So Undercover;2012;Rotten;6;49;1;15;16;4
Soaked In Bleach;2015;Rotten;30;76;3;7;10;5
Soapdish;1991;Fresh;69;63;25;11;36;10
S.O.B.;1981;Fresh;82;63;18;4;22;3
Sobibor;1900;Fresh;75;45;12;4;16;1
Social Animals;2018;Rotten;38;43;3;5;8;2
Social Animals;1900;Fresh;88;71;15;2;17;1
Society;1989;Fresh;62;52;8;5;13;0
Socrates;2019;Fresh;89;86;25;3;28;7
La Peau douce (The Soft Skin);1964;Fresh;89;86;24;3;27;8
Softness of Bodies;2018;Fresh;100;67;7;0;7;1
Solace;2016;Rotten;25;43;13;38;51;13
Solarbabies;1986;Rotten;0;43;0;9;9;2
Solaris;2002;Fresh;66;59;138;70;208;44
Soldier Blue;1900;Rotten;38;71;3;5;8;1
Soldiers of Fortune;2012;Rotten;14;9;1;6;7;3
A Soldier's Story;1984;Fresh;90;81;18;2;20;3
The Solid Gold Cadillac;1956;Fresh;100;67;6;0;6;0
Solis;2018;Rotten;0;26;0;5;5;1
Solitary Man;2010;Certified-Fresh;79;50;77;21;98;31
Solitude;2002;Fresh;67;;4;2;6;1
Sollers Point;2018;Fresh;85;58;23;4;27;11
Solo;1996;Rotten;8;26;3;33;36;15
Solo: A Star Wars Story;2018;Fresh;70;64;330;144;474;59
Solo Con Tu Pareja;1991;Fresh;67;70;8;4;12;6
The Soloist;2009;Rotten;56;56;116;90;206;54
Solomon and Sheba;1900;Rotten;14;56;1;6;7;0
Solomon Kane;2012;Fresh;67;49;32;16;48;14
Some Came Running;1959;Fresh;83;76;10;2;12;0
Some Days Are Better Than Others;2011;Rotten;50;36;6;6;12;6
Some Freaks;2017;Fresh;92;71;11;1;12;4
Some Girls;1988;Rotten;50;41;3;3;6;3
Some Girl(s);2013;Rotten;57;15;17;13;30;11
Some Guy Who Kills People;1900;Fresh;80;58;8;2;10;4
Some Kind of Beautiful;2015;Rotten;6;30;2;32;34;10
Some Kind of Hero;1982;Rotten;40;27;2;3;5;3
Some Kind of Wonderful;1987;Certified-Fresh;78;80;32;9;41;9
Some Like It Hot;1959;Certified-Fresh;95;94;60;3;63;15
Some Mother's Son;1996;Fresh;69;87;11;5;16;7
Some Velvet Morning;2013;Rotten;54;37;20;17;37;16
Somebody Up There Likes Me;1956;Fresh;83;86;10;2;12;4
Somebody Up There Likes Me;2013;Fresh;68;50;19;9;28;10
Someday This Pain Will Be Useful to You;2012;Rotten;9;36;1;10;11;6
Someone Great;1900;Certified-Fresh;82;64;42;9;51;14
Someone to Love;1988;Fresh;71;55;5;2;7;1
Someone to Watch over Me;1987;Fresh;67;41;20;10;30;7
Somers Town;2009;Certified-Fresh;96;75;53;2;55;22
Somersault;2004;Certified-Fresh;84;72;56;11;67;23
Something;2019;Rotten;50;62;3;3;6;2
Something Borrowed;2011;Rotten;15;48;17;100;117;35
Something from Nothing: The Art of Rap;2012;Fresh;86;77;24;4;28;14
Something in the Air;2013;Certified-Fresh;81;47;61;14;75;29
Something Like Happiness;2005;Fresh;78;82;7;2;9;4
Something New;2006;Fresh;61;72;66;43;109;32
Something of Value (Africa Ablaze);1957;Rotten;40;52;2;3;5;2
Something to Cheer About;2001;Rotten;43;60;6;8;14;8
Something to Talk About;1995;Rotten;39;52;11;17;28;10
Something Wild;1986;Certified-Fresh;91;69;41;4;45;10
Something's Gotta Give;2003;Fresh;72;69;123;48;171;42
Sometimes a Great Notion (Never Give an Inch);1971;Fresh;100;76;14;0;14;6
Sometimes They Come Back;1991;Fresh;67;50;8;4;12;4
Sometimes They Come Back...for More;1999;Rotten;0;25;0;5;5;0
Somewhere;2010;Certified-Fresh;71;48;138;57;195;53
Somewhere Between;2012;Fresh;88;86;21;3;24;14
Somewhere in the Night;1946;Fresh;89;62;8;1;9;4
Somewhere in Time;1980;Fresh;61;88;11;7;18;5
Sommersby;1993;Fresh;62;60;16;10;26;8
Son of Godzilla;1967;Fresh;60;30;9;6;15;1
Son-in-Law;1993;Rotten;21;58;4;15;19;4
Son of a Gun;2015;Fresh;62;63;47;29;76;20
Son of Batman;1900;Fresh;64;72;7;4;11;1
Son of Bigfoot;2018;Fresh;76;41;16;5;21;5
Son of Flubber;1963;Fresh;86;47;6;1;7;0
Son of Frankenstein;1939;Fresh;95;71;36;2;38;8
Son Of God;2014;Rotten;21;73;15;58;73;27
Son of Kong;1933;Rotten;36;28;4;7;11;0
Son of Man;2006;Fresh;86;82;6;1;7;3
Son of Rambow;2007;Certified-Fresh;73;79;86;32;118;34
Son of Saul;2015;Certified-Fresh;96;79;220;10;230;52
Son of the Mask;2005;Rotten;6;16;6;99;105;31
Son of the Pink Panther;1993;Rotten;6;19;2;32;34;10
Sonatine;1993;Fresh;88;89;22;3;25;6
The Song of Bernadette;1943;Fresh;87;80;13;2;15;1
Song of Granite;2017;Fresh;85;55;23;4;27;7
Avaze gonjeshk-ha (The Song of Sparrows);2009;Certified-Fresh;98;87;41;1;42;18
Song Of The Sea;2014;Certified-Fresh;99;92;95;1;96;29
Song of the Thin Man;1947;Fresh;80;70;8;2;10;0
Song One;2015;Rotten;33;29;17;35;51;21
The Song Remains The Same;1976;Fresh;77;88;10;3;13;0
Song to Song;2017;Rotten;44;36;57;74;131;39
Song Without End;1960;Fresh;83;38;5;1;6;2
Songcatcher;2001;Fresh;74;78;65;23;88;29
Songs From The North;2015;Fresh;100;42;6;0;6;3
Songs My Brothers Taught Me;2016;Fresh;91;66;21;2;23;9
Soni;1900;Fresh;88;75;14;2;16;3
Sonic the Hedgehog;2020;Fresh;63;93;149;88;237;31
The Sons of Katie Elder;1965;Fresh;100;81;12;0;12;0
Sons of Perdition;2011;Fresh;83;76;5;1;6;3
Sophie and the Rising Sun;2017;Fresh;64;60;7;4;11;6
Sophie's Choice;1982;Certified-Fresh;78;85;32;9;41;8
The Sorcerers;1967;Fresh;100;59;13;0;13;2
The Sorcerer's Apprentice;2010;Rotten;40;53;69;103;172;40
Sordid Lives;2000;Rotten;37;85;10;17;27;9
Sorority Boys;2002;Rotten;12;54;8;57;65;17
Sorority Row;2009;Rotten;25;31;20;61;81;17
Sorry, Haters;2005;Rotten;37;47;14;24;38;15
Sorry to Bother You;2018;Certified-Fresh;93;70;281;21;302;55
Soul Boys Of The Western World;2015;Fresh;72;58;13;5;18;10
Soul Food;1997;Certified-Fresh;81;86;34;8;42;14
Soul Man;1986;Rotten;13;33;3;20;23;5
Soul on a String;2017;Fresh;89;33;8;1;9;2
Soul Plane;2004;Rotten;18;51;18;83;101;30
Soul Power;2009;Certified-Fresh;84;79;63;12;75;29
Soul Surfer;2011;Rotten;45;75;48;58;106;34
Soul Survivors;2000;Rotten;4;26;2;46;48;14
SoulMate;2016;Fresh;100;78;10;0;10;1
Sound and Fury;2000;Fresh;96;88;27;1;28;6
Sound City;2013;Certified-Fresh;100;90;46;0;45;19
The Sound of Music;1965;Certified-Fresh;83;91;59;12;71;14
Sound of My Voice;2012;Certified-Fresh;75;66;81;27;108;40
Sound of Noise;2012;Fresh;91;77;21;2;23;10
Sound of Redemption: The Frank Morgan Story;2015;Fresh;100;;9;0;9;6
A Sound of Thunder;2005;Rotten;6;18;6;93;99;25
Soundtrack For A Revolution;2009;Fresh;81;78;13;3;16;8
Soundwave;2018;Fresh;85;;17;3;20;0
Sour Grapes;1998;Rotten;21;37;3;11;14;4
Source Code;2011;Certified-Fresh;92;82;240;22;262;56
South Central;1992;Fresh;100;83;6;0;6;3
South of Heaven, West of Hell;2000;Rotten;14;28;1;6;7;0
South of the Border;2010;Rotten;52;69;29;27;56;21
South Pacific;1958;Fresh;82;69;9;2;11;0
South Park: Bigger, Longer & Uncut;1999;Certified-Fresh;80;88;76;19;95;26
Southbound;2016;Certified-Fresh;81;51;42;10;52;14
Southern Baptist Sissies;2014;Fresh;67;83;4;2;6;2
The Southerner;1945;Fresh;92;79;12;1;13;4
Southie;1998;Rotten;38;50;3;5;8;0
Southland Tales;2007;Rotten;39;41;40;62;102;31
Southlander: Diary of a Desperate Musician;2001;Rotten;50;53;4;4;8;4
Southpaw;2015;Rotten;59;75;141;96;237;55
Southside With You;2016;Certified-Fresh;92;71;146;13;159;47
Soylent Green;1973;Fresh;72;70;28;11;39;6
Space Chimps 2: Zartog Strikes Back;2010;Rotten;0;34;0;8;8;0
Space Cowboys;2000;Certified-Fresh;78;53;93;26;119;29
Space Jam;1996;Rotten;43;63;33;43;76;23
Space Station 76;2014;Fresh;68;30;17;8;25;9
Space Truckers;1997;Rotten;15;29;2;11;13;0
Spaceballs;1987;Rotten;58;83;23;17;40;8
Spaced Invaders;;Rotten;8;51;1;11;12;3
Spacehunter: Adventures in the Forbidden Zone;1983;Rotten;23;37;3;10;13;3
Spaceman;2016;Rotten;0;40;0;8;8;3
Spaceship Earth;2020;Certified-Fresh;87;62;93;14;107;24
Spanglish;2004;Rotten;53;60;90;79;169;43
Spanish Lake;2014;Fresh;80;67;4;1;5;4
The Spanish Prisoner;1997;Certified-Fresh;89;80;54;7;61;15
Spare Parts;2015;Rotten;56;82;18;14;32;14
Spark: A Burning Man Story;2013;Fresh;67;51;12;6;18;6
Spark: A Space Tail;2017;Rotten;14;35;3;19;22;9
Sparkle;2010;Fresh;78;;14;4;18;10
Sparkle;2012;Rotten;56;44;53;41;94;32
Sparks;2014;Fresh;83;76;5;1;6;2
Spartan;2004;Fresh;65;62;87;47;134;41
Spawn;1997;Rotten;17;36;8;38;46;11
Speak;2012;Fresh;60;78;3;2;5;4
Speak The Music: Robert Mann And The Mysteries Of Chamber Music;2014;Fresh;100;;5;0;5;2
Special;2006;Rotten;58;63;19;14;33;12
Special Correspondents;1900;Rotten;17;29;6;30;36;15
Una Giornata Particolare (A Special Day);1977;Fresh;100;91;9;0;9;1
Special Effects;1984;Rotten;50;29;3;3;6;1
Special Forces;2012;Rotten;15;52;2;11;13;6
Special ID;2014;Rotten;56;25;5;4;9;4
Special Treatment;2011;Rotten;39;33;7;11;18;8
Species;1995;Rotten;43;31;28;37;65;17
Species II;1998;Rotten;9;18;3;30;33;2
Species III;2004;Rotten;33;17;2;4;6;0
Spectre;2015;Fresh;63;61;226;133;359;56
Speech & Debate;2017;Rotten;55;47;6;5;11;5
Speed;1994;Certified-Fresh;94;76;62;4;66;20
Speed 2 - Cruise Control;1997;Rotten;4;16;3;69;72;23
Speed-Dating;2010;Rotten;25;40;2;6;8;4
Speed Kills;2018;Rotten;0;30;0;16;16;4
Speed of Life;1900;Fresh;78;50;7;2;9;0
Speed Racer;2008;Rotten;40;60;87;129;216;50
Speed Sisters;2017;Fresh;92;83;22;2;24;7
Speedway Junky;2002;Rotten;29;55;2;5;7;3
Speedy;1928;Fresh;100;89;6;0;6;0
Breakaway;2011;Rotten;20;37;1;4;5;3
Spenser Confidential;2020;Rotten;37;53;30;52;82;19
Sphere;1998;Rotten;11;38;6;47;53;15
Spice World;1998;Rotten;34;45;22;42;64;22
Spider Baby;1968;Fresh;94;76;15;1;16;1
Spider in the Web;2019;Fresh;75;40;6;2;8;2
Spider-Man: Far From Home;2019;Certified-Fresh;90;95;399;42;441;51
Spider-Man: Homecoming;2017;Certified-Fresh;92;87;359;31;390;53
Spider-Man: Into the Spider-Verse;2018;Certified-Fresh;97;93;373;10;383;44
Spiderhole;2011;Rotten;22;12;2;7;9;1
Spider-Man;2002;Certified-Fresh;90;67;220;25;245;47
Spider-Man 2;2004;Certified-Fresh;93;82;256;18;274;52
Spider-Man 3;2007;Fresh;62;51;163;98;261;58
Spiders;2013;Rotten;13;10;1;7;8;0
Spiders, Part 1: The Golden Lake (Die Spinnen, 1. Teil - Der Goldene See);1919;Fresh;100;54;5;0;5;0
The Spiderwick Chronicles;2008;Certified-Fresh;80;63;118;29;147;40
Spies in Disguise;2019;Certified-Fresh;76;92;90;29;119;22
Spies Like Us;1985;Rotten;32;56;8;17;25;4
Spike Island;2015;Rotten;43;42;12;16;28;9
Spin Out;1900;Rotten;13;47;1;7;8;0
Spine Tingler: The William Castle Story;2007;Fresh;100;89;6;0;6;0
Spinning Into Butter;2009;Rotten;16;32;5;27;32;15
Spinning Man;2018;Rotten;42;36;5;7;12;5
Spinning Plates;2013;Fresh;85;84;29;5;34;16
Spiral;2018;Rotten;40;62;4;6;10;5
Spiral Farm;2019;Fresh;100;;6;0;6;1
The Spirit of '76;;Fresh;80;54;4;1;5;0
The Spirit of St. Louis;1957;Fresh;85;75;17;3;20;4
Spirit - Stallion of the Cimarron;2002;Fresh;70;77;89;39;128;33
Spirit Trap;2006;Rotten;20;26;1;4;5;0
Spirited Away;2002;Certified-Fresh;97;96;182;5;187;45
The Spitfire Grill;1996;Rotten;33;76;9;18;27;7
Splendor in the Grass;1961;Fresh;82;90;18;4;22;5
Splintered;1900;Rotten;25;10;2;6;8;3
Splinters;2012;Fresh;82;80;9;2;11;7
Split;2017;Certified-Fresh;77;79;234;71;305;54
Spoken Word;2010;Rotten;46;39;6;7;13;4
The SpongeBob SquarePants Movie;2004;Fresh;68;78;88;41;129;40
Spork;2011;Rotten;55;72;6;5;11;5
Spotlight;2015;Certified-Fresh;97;93;355;12;367;59
Spread;2009;Rotten;21;28;13;48;61;22
Spree;2020;Fresh;63;64;44;26;70;12
Spring;2015;Certified-Fresh;84;70;47;9;56;16
Spring Breakdown;2009;Rotten;55;27;6;5;11;0
Spring Breakers;2013;Fresh;67;38;130;63;193;49
Spring Forward;2000;Fresh;88;81;21;3;24;3
Spring, Summer, Fall, Winter...and Spring;2003;Certified-Fresh;94;93;94;6;100;31
Springsteen And I;2013;Fresh;88;79;15;2;17;9
Springsteen on Broadway;1900;Certified-Fresh;96;96;23;1;24;10
Springtime in a Small Town (Xiao cheng zhi chun);2002;Certified-Fresh;86;66;38;6;44;16
Sprinter;2019;Fresh;73;91;8;3;11;4
Spun;2003;Rotten;37;75;29;50;79;26
Sputnik;2020;Certified-Fresh;89;71;93;12;105;11
Spy;2015;Certified-Fresh;95;78;244;13;257;52
Spy Game;2001;Fresh;66;75;88;45;133;32
Spy Hard;1996;Rotten;8;31;3;37;40;14
Spy Intervention;2020;Rotten;33;45;2;4;6;1
Spy Kids;2001;Certified-Fresh;93;46;119;9;128;30
Spy Kids 2: The Island of Lost Dreams;2002;Certified-Fresh;75;39;102;34;136;34
Spy Kids 3-D - Game Over;2003;Rotten;45;25;64;79;143;33
Spy Kids: All the Time in the World in 4D;2011;Rotten;22;37;13;47;60;19
The Spy Next Door;2010;Rotten;12;40;11;79;90;30
The Spy Who Loved Me;1977;Certified-Fresh;80;76;44;11;55;8
Spymate;2004;Rotten;17;38;1;5;6;1
Squanto: A Warrior's Tale;1994;Fresh;60;55;6;4;10;2
Square Grouper: The Godfathers of Ganja;2011;Fresh;75;55;9;3;12;6
The Squid and the Whale;2005;Certified-Fresh;92;81;141;13;154;38
St. Agatha;2019;Fresh;64;36;16;9;25;3
St. Bernard Syndicate;2019;Fresh;83;;5;1;6;2
St. Elmo's Fire;1985;Rotten;44;68;18;23;41;6
St. Ives;1976;Rotten;44;39;4;5;9;1
St. Trinian's;2007;Rotten;31;55;13;29;42;18
St Trinian's II: The Legend of Fritton's Gold;2009;Rotten;14;45;3;18;21;6
St. Vincent;2014;Certified-Fresh;77;78;146;44;190;51
Stage Beauty;2004;Fresh;64;78;81;46;127;42
Stage Door;1937;Fresh;96;87;22;1;23;3
Stage Fright;2014;Rotten;37;27;19;32;51;13
Stake Land;2011;Certified-Fresh;74;62;48;17;65;21
Stalag 17;1953;Fresh;97;93;35;1;36;8
Stalingrad;2014;Rotten;50;41;37;37;74;31
The Stalking Moon;1968;Rotten;40;62;2;3;5;0
Stan Helsing;2009;Rotten;14;18;3;18;21;6
Stand and Deliver;1988;Fresh;82;79;18;4;22;7
Stand by Me;1986;Certified-Fresh;91;94;51;5;56;10
Stand Clear Of The Closing Doors;2014;Fresh;88;54;30;4;34;9
Stand Up Guys;2013;Rotten;36;46;39;69;107;35
Standard Operating Procedure;2008;Certified-Fresh;79;78;85;23;108;39
Standing in the Shadows of Motown;2002;Certified-Fresh;91;89;85;8;93;30
Standing Ovation;2010;Rotten;6;47;1;16;17;6
Standing Up, Falling Down;2020;Certified-Fresh;86;86;44;7;51;13
Standoff;2016;Rotten;56;44;9;7;16;4
Stanley & Iris;;Rotten;33;48;5;10;15;5
Stanley Kubrick: A Life in Pictures;2001;Fresh;86;89;12;2;14;3
Star 80;1983;Fresh;86;70;12;2;14;1
The Star Chamber;1983;Fresh;71;41;10;4;14;1
Star Kid;1997;Rotten;43;36;6;8;14;3
Star Maps;1997;Rotten;35;42;6;11;17;5
Star Trek;2009;Certified-Fresh;94;91;333;20;353;64
Star Trek Beyond;2016;Certified-Fresh;86;80;266;43;309;56
Star Trek: First Contact;1996;Certified-Fresh;92;89;55;5;60;16
Star Trek Generations;1994;Rotten;48;57;28;30;58;16
Star Trek II: The Wrath of Khan;1982;Certified-Fresh;88;90;56;8;64;14
Star Trek III - The Search for Spock;1984;Certified-Fresh;79;61;38;10;48;10
Star Trek: Insurrection;1998;Rotten;54;44;39;33;72;15
Star Trek Into Darkness;2013;Certified-Fresh;84;89;246;46;292;57
Star Trek IV - The Voyage Home;1986;Certified-Fresh;81;81;35;8;43;10
Star Trek - Nemesis;2002;Rotten;38;49;64;105;169;38
Star Trek: The Motion Picture;1979;Rotten;41;42;17;24;41;10
Star Trek V - The Final Frontier;1989;Rotten;21;24;10;38;48;11
Star Trek VI - The Undiscovered Country;1991;Certified-Fresh;82;83;47;10;57;12
Star Wars: Episode IV - A New Hope;1977;Certified-Fresh;92;96;120;10;130;45
Star Wars: Episode I - The Phantom Menace;1999;Rotten;52;59;121;111;232;62
Star Wars: Episode II - Attack of the Clones;2002;Fresh;65;56;165;88;253;53
Star Wars: Episode III - Revenge of the Sith;2005;Certified-Fresh;80;66;239;60;299;59
Star Wars: Episode VI - Return of the Jedi;1983;Certified-Fresh;82;94;78;17;95;28
Star Wars: Episode VII - The Force Awakens;2015;Certified-Fresh;92;86;404;33;437;64
Star Wars: The Last Jedi;2017;Certified-Fresh;90;43;427;46;473;62
Star Wars: The Rise of Skywalker;2019;Rotten;51;86;252;244;496;56
Starbuck;2013;Fresh;65;80;46;25;71;28
Starcrash;1979;Rotten;29;36;2;5;7;0
StarDog and TurboCat;1900;Rotten;50;62;5;5;10;2
Stardust;2007;Certified-Fresh;76;86;147;46;193;49
Stardust Memories;1980;Fresh;68;78;19;9;28;6
Starfish;2019;Fresh;87;47;54;8;62;4
Stargate;1994;Rotten;53;73;25;22;47;8
Stark Raving Mad;2002;Rotten;20;56;1;4;5;1
Starlet;2012;Certified-Fresh;89;68;39;5;44;21
Starman;1984;Fresh;85;69;28;5;33;6
Starred Up;2014;Certified-Fresh;99;84;114;1;114;31
Starry Eyes;2014;Fresh;74;55;17;6;23;6
Stars and Strife;1900;Fresh;89;;8;1;9;0
The Stars Fell on Henrietta;1995;Rotten;50;40;5;5;10;4
Starship Troopers;1997;Fresh;65;70;42;23;65;14
Starship Troopers 2: Hero of the Federation;2004;Rotten;33;12;2;4;6;1
Starship Troopers 3: Marauder;2008;Rotten;50;19;3;3;6;0
Starsky & Hutch;2004;Fresh;62;49;120;73;193;47
Start The Revolution Without Me;1970;Fresh;83;77;5;1;6;0
Starter for 10;2006;Certified-Fresh;90;66;73;8;81;30
Starting Out in the Evening;2007;Certified-Fresh;87;70;87;13;100;37
Starting Over;1979;Fresh;100;58;5;0;5;0
Startup.com;2001;Certified-Fresh;93;73;87;7;94;30
State and Main;2000;Certified-Fresh;86;70;100;16;116;31
State Like Sleep;2019;Rotten;37;16;11;19;30;10
State of the Union;1948;Fresh;80;78;4;1;5;0
State Property;2002;Rotten;0;74;0;12;12;3
State Property 2;2005;Rotten;14;83;2;12;14;10
The Statement;2003;Rotten;23;35;25;82;107;34
Stateside;2004;Rotten;24;60;11;35;46;20
The Station Agent;2003;Certified-Fresh;94;89;150;9;159;38
Stations of the Cross;2015;Fresh;92;74;24;2;26;11
Stations of the Elevated;2014;Fresh;100;33;8;0;8;3
Status Update;2018;Rotten;0;46;0;5;5;3
Stay;2005;Rotten;27;70;33;91;124;36
Stay;2014;Rotten;24;24;4;13;17;7
Stay Cool;2011;Rotten;14;24;1;6;7;1
Stay Human;1900;Fresh;92;100;11;1;12;0
Stay Hungry;1976;Fresh;67;40;10;5;15;4
Stay Tuned;1992;Rotten;47;55;8;9;17;1
Staying Alive;1983;Rotten;0;39;0;26;26;6
Steal a Pencil for Me;2007;Fresh;95;80;21;1;22;9
Steal This Movie;2000;Rotten;51;71;22;21;43;10
Stealing Beauty;1996;Rotten;51;75;26;25;51;15
Stealing Harvard;2002;Rotten;9;39;9;95;104;29
Stealing Home;1988;Rotten;20;78;2;8;10;1
Steam;2007;Rotten;13;33;1;7;8;5
Steamboat Bill Jr.;1928;Fresh;100;91;29;0;29;4
Steamboy;2005;Rotten;59;68;54;37;91;29
Steel City;2007;Fresh;83;54;24;5;29;17
The Steel Helmet;1951;Fresh;100;86;16;0;16;2
Steel Magnolias;1989;Fresh;68;89;21;10;31;5
Steelyard Blues;1973;Fresh;60;33;3;2;5;3
Steep;2007;Rotten;54;70;26;22;48;25
Stella Days;2012;Fresh;60;30;6;4;10;6
Stella Street;2004;Rotten;12;49;2;15;17;9
Stella's Last Weekend;2018;Fresh;65;76;13;7;20;6
La sindrome di Stendhal (The Stendhal Syndrome);1996;Fresh;77;51;10;3;13;0
Step Into Liquid;2003;Certified-Fresh;81;93;65;15;80;30
Step Sisters;2017;Rotten;22;46;2;7;9;2
Step Up;2006;Rotten;21;83;22;85;107;33
Step Up 2 the Streets;2008;Rotten;28;76;18;47;65;22
Step Up 3;2010;Rotten;47;64;58;65;123;31
Step Up: All In;2014;Rotten;42;57;22;30;52;16
Step Up Revolution;2012;Rotten;41;68;40;58;98;27
The Stepfather;1987;Fresh;88;65;28;4;32;8
Stepfather II;1989;Rotten;0;33;0;5;5;0
The Stepford Wives;2004;Rotten;26;30;45;129;174;39
Stephen King's It;;Fresh;67;63;16;8;24;6
Stephen King's A Good Marriage;2014;Rotten;32;21;7;15;22;7
Stephen King's 'Graveyard Shift';;Rotten;13;23;1;7;8;0
Stephen King's 'Silver Bullet';1985;Rotten;45;56;9;11;20;2
Stephen King's 'The Langoliers';1995;Rotten;52;46;12;11;23;7
Stephen Tobolowsky's Birthday Party;2005;Fresh;100;91;12;0;12;1
Stepmom;1998;Rotten;45;75;40;49;89;28
The Sterile Cuckoo (Pookie);1969;Fresh;88;64;7;1;8;1
Steve + Sky;2004;Rotten;8;64;1;11;12;6
Steve Jobs;2015;Certified-Fresh;85;73;266;46;312;61
Steve Jobs: Man in the Machine;2015;Certified-Fresh;77;57;59;19;77;26
Steve Jobs: The Lost Interview;2012;Fresh;100;84;7;0;7;4
Steve Martin and Martin Short: An Evening You Will Forget for the Rest of Your Life;1900;Fresh;100;71;10;0;10;3
Steve McQueen: The Man & Le Mans;2015;Fresh;75;64;24;8;32;10
Steven Tyler: Out on a Limb;1900;Fresh;100;;5;0;5;0
Stevie;2003;Certified-Fresh;91;88;68;7;75;28
Stevie Nicks: In Your Dreams;2013;Rotten;40;74;2;3;5;1
Stick;1985;Rotten;29;36;2;5;7;1
Stick It;2006;Rotten;31;73;31;68;99;30
Stiff Upper Lips;1998;Rotten;38;40;3;5;8;1
Stigmata;1999;Rotten;22;63;20;71;91;25
Still Alice;2015;Certified-Fresh;85;85;173;30;203;46
Still Bill;2010;Fresh;100;93;6;0;6;4
Still Breathing;1998;Fresh;62;77;8;5;13;5
Still Crazy;1998;Fresh;73;84;19;7;26;7
Still Here;2020;;;;2;5;;0
Still Mine;2013;Certified-Fresh;92;82;59;5;64;23
Still of the Night;1982;Fresh;63;49;5;3;8;0
Still Smokin';1983;Rotten;11;65;1;8;9;1
Still/Born;2018;Fresh;65;33;15;8;23;3
The Sting II;1983;Rotten;0;29;0;8;8;3
Stink!;2015;Fresh;89;62;8;1;9;5
Stir Crazy;1980;Fresh;67;75;10;5;15;1
Stir of Echoes;1999;Fresh;67;70;70;34;104;29
Stitch! The Movie;2003;Rotten;20;50;1;4;5;0
Stitches;2013;Rotten;39;40;9;14;23;4
Stoker;2013;Fresh;70;60;141;61;202;52
Stolen;2006;Fresh;67;47;18;9;27;16
Stolen;2012;Rotten;20;34;4;16;20;4
Stolen Seas;2013;Fresh;100;82;8;0;8;7
Stolen Summer;2002;Rotten;36;66;21;37;58;22
Stomp the Yard;2007;Rotten;25;82;22;67;89;33
Stone;2010;Rotten;50;21;51;50;101;27
The Stone Boy;1984;Fresh;67;42;4;2;6;0
Stone Bros;2009;Fresh;90;34;9;1;10;3
Stoned;2005;Rotten;14;45;7;43;50;19
Stonewall;2015;Rotten;9;85;7;68;75;28
The Stoning of Soraya M.;2009;Rotten;59;87;51;35;86;30
Stop-Loss;2008;Fresh;64;26;92;51;143;38
Stop Making Sense;1984;Certified-Fresh;100;98;40;0;40;7
Stop! Or My Mom Will Shoot;1992;Rotten;7;21;2;25;27;7
Stop The Pounding Heart;2014;Fresh;76;39;13;4;17;6
Storage 24;2013;Rotten;42;21;14;19;33;9
Stories We Tell;2013;Certified-Fresh;94;79;136;8;144;45
Storks;2016;Fresh;66;62;91;47;138;34
Storm Surfers 3D;2013;Fresh;86;70;18;3;21;11
Stormy Monday;1988;Fresh;75;47;12;4;16;6
Story of a Love Affair (Cronaca di un amore);1950;Fresh;93;61;13;1;14;5
The Story of Us;1999;Rotten;26;58;31;86;117;41
The Story of Vernon and Irene Castle;1939;Fresh;75;67;6;2;8;1
Storytelling;2002;Rotten;53;67;47;42;89;29
Straight Outta Compton;2015;Certified-Fresh;89;85;217;28;245;53
The Straight Story;1999;Certified-Fresh;95;91;98;5;103;36
Straight Talk;1992;Rotten;42;58;5;7;12;1
Straight Time;1978;Fresh;75;83;6;2;8;1
Straight to Hell;1987;Rotten;33;58;3;6;9;1
Straight Jacket;2004;Rotten;48;45;10;11;21;9
Strait-Jacket;1964;Fresh;88;66;7;1;8;0
Stranded;2013;Rotten;0;9;0;15;15;8
Stranded: I Have Come from a Plane That Crashed on the Mountains;2008;Fresh;92;93;33;3;36;16
The Strange Affair of Uncle Harry (Guilty of Murder?);1945;Fresh;80;65;4;1;5;1
Strange Bedfellows;1900;Fresh;80;58;4;1;5;0
Strange Brew;1983;Fresh;75;81;18;6;24;2
Strange But True;2019;Rotten;54;83;14;12;26;6
Strange Cargo;1940;Fresh;75;59;6;2;8;0
Strange Fits of Passion;2001;Fresh;63;;5;3;8;1
Strange Illusion;1945;Fresh;86;33;6;1;7;0
Strange Invaders;1983;Fresh;63;33;5;3;8;0
The Strange Love of Martha Ivers;1946;Fresh;100;73;10;0;10;2
Strange Magic;2015;Rotten;16;52;10;51;61;16
Strange Powers: Stephin Merritt And The Magnetic Fields;2010;Fresh;77;74;24;7;31;14
Strange Wilderness;2008;Rotten;2;35;1;47;48;11
The Strange Woman;1946;Rotten;40;48;2;3;5;0
Strangeland;1998;Rotten;6;63;1;16;17;3
A Stranger Among Us;1992;Rotten;22;39;9;32;41;15
Stranger by the Lake;2014;Certified-Fresh;94;65;91;6;97;32
Stranger Than Fiction;2006;Certified-Fresh;73;85;127;48;175;46
Stranger Than Paradise;1984;Fresh;96;88;24;1;25;4
Strangerland;2015;Rotten;41;24;28;40;68;18
Stratton;2018;Rotten;0;19;0;36;36;10
The Stratton Story;1949;Fresh;86;80;6;1;7;2
Straw Dogs;2011;Rotten;42;34;53;73;126;31
The Strawberry Blonde;1941;Fresh;100;73;9;0;9;0
Strawberry Flavored Plastic;1900;Fresh;100;;5;0;5;1
Stray;1900;Fresh;100;62;9;0;9;0
Stray;2019;Fresh;63;19;5;3;8;2
Stray Bullets;2017;Fresh;75;15;6;2;8;5
Stray Dolls;2019;Fresh;71;67;17;7;24;7
Streamers;1983;Rotten;56;46;5;4;9;2
The Street Fighter;1974;Fresh;80;81;4;1;5;0
Street Fighter: The Legend of Chun-Li;2009;Rotten;5;18;3;59;62;12
Street Kings;2008;Rotten;36;58;55;97;152;39
Street Smart;1987;Fresh;64;44;9;5;14;5
StreetDance 2;2012;Rotten;41;37;11;16;27;6
Streetlight Harmonies;1900;Fresh;100;100;9;0;9;1
Streets of Blood;2009;Rotten;40;17;2;3;5;0
Streets of Fire;1984;Fresh;67;70;16;8;24;1
Stretch;2014;Fresh;88;63;14;2;16;2
Strictly Business;1991;Rotten;10;57;1;9;10;3
Strike (Stachka);1925;Fresh;100;82;8;0;8;2
Strike;1900;Fresh;83;76;5;1;6;2
Striking Distance;1993;Rotten;17;35;4;20;24;4
Strings;2004;Fresh;80;83;4;1;5;0
Stripes;1981;Fresh;86;79;31;5;36;6
Striptease;1996;Rotten;11;24;8;62;70;23
Stroker Ace;1983;Rotten;20;51;3;12;15;3
Strong Island;2017;Certified-Fresh;100;57;48;0;48;16
Stronger;2017;Certified-Fresh;90;80;172;19;191;44
Strongman;2011;Fresh;100;62;17;0;17;7
Stroszek;1977;Fresh;95;92;18;1;19;5
Struck by Lightning;2013;Rotten;32;52;11;23;34;15
Stuart Little;1999;Fresh;67;41;65;32;97;30
Stuart Little 2;2002;Certified-Fresh;81;41;101;23;124;35
Stuart Saves His Family;1995;Rotten;30;52;8;19;27;12
Stuber;2019;Rotten;41;79;90;131;221;33
Stuck;2008;Certified-Fresh;73;55;66;25;91;28
Stuck Between Stations;2011;Fresh;63;64;5;3;8;3
Stuck in Love;2013;Rotten;57;68;25;19;44;12
Stuck on You;2003;Fresh;61;35;96;62;158;42
Student Bodies;1981;Rotten;25;53;2;6;8;0
Student of the Year;2012;Rotten;50;50;3;3;6;1
The Stuff;1985;Fresh;69;45;10;4;13;2
The Stunt Man;1980;Fresh;89;74;34;4;38;8
Stuntwomen: The Untold Hollywood Story;1900;Fresh;100;;18;0;18;2
The Stupids;1996;Rotten;20;37;3;12;15;3
Storm (Sturm);2009;Fresh;82;66;18;4;22;8
Styx;2019;Certified-Fresh;93;69;38;3;41;12
Subject Two;2006;Rotten;55;47;6;5;11;3
Sublime;2007;Rotten;33;38;2;4;6;1
Submarine;2011;Certified-Fresh;88;82;137;19;156;45
Submerged;2015;Rotten;25;22;2;6;8;3
Submergence;2018;Rotten;23;33;12;41;53;12
Subspecies;1900;Fresh;83;51;5;1;6;0
The Substitute 2: School's Out;1998;Rotten;0;28;0;7;7;0
Suburban Commando;1900;Rotten;15;32;2;11;13;1
Suburban Girl;2007;Rotten;50;31;4;4;8;1
The Suburbans;1999;Rotten;0;22;0;10;10;2
Suburbicon;2017;Rotten;28;25;70;184;254;51
Subway;1985;Fresh;75;75;6;2;8;0
Sucker Punch;2011;Rotten;22;47;48;170;218;43
Sudden Fear;1952;Fresh;100;84;8;0;8;1
Sudden Impact;1983;Rotten;56;54;20;16;36;5
Suddenly, Last Summer;1959;Fresh;65;83;13;7;20;5
Sueno;2005;Rotten;43;36;3;4;7;3
Suffragette;2015;Fresh;73;68;155;58;213;50
Sugar & Spice;2001;Rotten;28;42;21;54;75;20
Sugar Mountain;2016;Rotten;36;36;4;7;11;4
Suicide Kings;1997;Rotten;34;74;10;19;29;6
Suicide Squad;2016;Rotten;26;59;100;279;378;63
Suicide Squad: Hell to Pay;1900;Fresh;88;71;7;1;8;0
Sukai Kurora (The Sky Crawlers);2008;Fresh;80;58;8;2;10;1
Sukiyaki Western Django;2008;Rotten;56;57;31;24;55;17
Sullivan's Travels;1941;Fresh;100;89;34;0;34;4
Sully;2016;Certified-Fresh;85;84;290;52;341;53
The Sum of All Fears;2002;Fresh;60;49;105;71;176;38
Summer Wars (Sama Wozu);2010;Fresh;78;87;18;5;23;15
Summer '04;2007;Fresh;79;55;15;4;19;10
Summer Camp;2016;Rotten;50;38;5;5;10;0
Summer Catch;2001;Rotten;8;41;7;84;91;29
L'Heure d'ete (Summer Hours);2009;Certified-Fresh;94;70;100;6;106;35
Summer in February;2014;Rotten;30;28;13;30;43;9
Summer Love (Dead Man's Bounty);2007;Rotten;33;15;4;8;12;7
Summer Night;2019;Rotten;52;26;11;10;21;4
Summer of '42;1971;Fresh;79;72;19;5;24;6
Summer of Blood;2014;Rotten;50;38;6;6;12;4
Summer of Sam;1999;Rotten;51;60;52;50;102;28
A Summer Place;1959;Fresh;83;70;5;1;6;0
Summer Rental;1985;Rotten;17;51;3;15;18;1
Summer Stock;1950;Fresh;100;83;5;0;5;0
Summerland;2020;Certified-Fresh;77;73;85;26;111;20
Summerland;1900;Fresh;88;82;14;2;16;1
A Summer's Tale;2014;Certified-Fresh;98;83;46;1;47;20
Summertime;1955;Fresh;88;80;15;2;17;6
Sun Choke;2016;Fresh;88;42;22;3;25;2
Sun Dogs;1900;Fresh;80;72;4;1;5;1
Sun Ra: A Joyful Noise;1900;Fresh;100;73;5;0;5;4
Sunday Bloody Sunday;1971;Fresh;86;71;25;4;29;9
Sunday in New York;1963;Fresh;100;78;7;0;7;2
Sunday's Illness (La enfermedad del domingo);1900;Fresh;89;67;17;2;19;4
Sundown;2016;Rotten;9;48;1;10;11;1
Sunlight Jr.;2013;Fresh;63;33;24;14;38;15
Sunrise: A Song of Two Humans;1927;Certified-Fresh;98;92;59;1;60;16
Sunset;1988;Rotten;23;30;3;10;13;5
Sunset;1900;Rotten;33;;3;6;9;0
Sunset Boulevard;1950;Certified-Fresh;99;95;68;1;69;12
Sunset Edge;2015;Fresh;69;66;11;5;16;7
Sunset Park;1996;Rotten;13;83;1;7;8;3
Sunset Song;2016;Certified-Fresh;81;50;93;22;115;37
Sunshine;2007;Certified-Fresh;76;73;130;40;170;44
Sunshine Cleaning;2009;Certified-Fresh;74;63;131;45;176;50
Sunshine State;2002;Certified-Fresh;80;58;87;22;109;32
Sunshine Superman;2015;Certified-Fresh;92;67;55;5;60;25
The Super;1991;Rotten;0;43;0;9;9;2
Super;2011;Rotten;49;56;61;63;124;32
Super High Me;2007;Fresh;63;51;5;3;8;2
Super 8;2011;Certified-Fresh;81;75;233;55;288;57
Superbabies: Baby Geniuses 2;2004;Rotten;0;24;0;46;46;19
Super Capers;2009;Rotten;6;14;1;17;18;6
Super Dark Times;2017;Certified-Fresh;90;72;43;5;48;14
Super Duper Alice Cooper;2014;Rotten;50;74;3;3;6;2
Super Size Me;2004;Certified-Fresh;92;72;158;13;171;40
Super Size Me 2: Holy Chicken!;2019;Fresh;74;74;25;9;34;13
Super Troopers;2002;Rotten;35;90;31;57;88;22
Super Troopers 2;2018;Rotten;36;64;35;63;98;26
Superbad;2007;Certified-Fresh;88;87;183;26;209;56
Supercon;2018;Rotten;23;33;3;10;13;6
Supercop;1996;Certified-Fresh;96;74;47;2;49;17
Supercross;2005;Rotten;5;62;4;70;74;20
Superfly;1972;Fresh;92;70;24;2;26;4
Superfly;2018;Rotten;50;46;51;50;101;34
Supergirl;1984;Rotten;9;26;3;29;32;6
Superman: Doomsday;2007;Rotten;57;56;4;3;7;0
Superman II;1981;Certified-Fresh;87;76;45;7;52;11
Superman III;1983;Rotten;29;23;15;37;52;7
Superman IV: The Quest for Peace;1987;Rotten;11;16;5;41;46;11
Man of Steel;2013;Rotten;56;75;186;148;334;59
Superman: Red Son;1900;Fresh;88;64;14;2;16;1
Superman Returns;2006;Certified-Fresh;75;61;200;67;267;51
Superman;1978;Certified-Fresh;94;86;64;4;68;13
Superman Unbound;1900;Fresh;100;75;5;0;5;0
Superman vs. The Elite;1900;Fresh;80;75;4;1;5;0
Supermensch: The Legend of Shep Gordon;2014;Certified-Fresh;78;83;62;17;79;31
Supervized;2019;Rotten;44;42;4;5;9;3
Support Your Local Gunfighter;1971;Fresh;62;61;8;5;13;1
Support Your Local Sheriff!;1969;Fresh;75;82;12;4;16;1
Supporting Characters;2013;Fresh;86;63;6;1;7;6
Supremacy;2015;Rotten;27;84;3;8;11;4
Surf Nazis Must Die;1987;Rotten;20;31;1;4;5;0
Surfer, Dude;2008;Rotten;0;26;0;18;18;8
Surf's Up;2007;Certified-Fresh;79;70;116;31;147;41
Surfwise;2007;Certified-Fresh;98;66;45;1;46;15
Surrogate Valentine;1900;Fresh;60;57;3;2;5;4
Surveillance;2009;Rotten;55;43;42;34;76;24
Survival of the Dead;2010;Rotten;30;19;27;64;91;21
Survive the Night;2020;Rotten;15;63;2;11;13;3
Surviving Christmas;2004;Rotten;7;29;8;107;115;32
Surviving Picasso;1996;Rotten;32;60;6;13;19;7
Surviving Progress;2012;Fresh;73;80;27;10;37;17
Surviving the Game;1994;Rotten;24;48;4;13;17;2
Survivor;2015;Rotten;8;32;4;47;51;14
The Survivors;1983;Rotten;9;42;1;10;11;4
Survivors Guide to Prison;2018;Fresh;100;70;14;0;14;5
Susan Slept Here;1954;Rotten;43;62;3;4;7;4
Susanne Bartsch: On Top;2018;Fresh;100;75;7;0;7;4
Sushi Girl;2013;Rotten;50;44;3;3;6;1
Sushi: The Global Catch;2012;Fresh;73;63;8;3;11;6
Suspect Zero;2004;Rotten;18;38;23;106;129;34
Suspended Animation;2003;Rotten;52;18;13;12;25;7
Suspiria;2018;Fresh;65;65;212;113;325;48
Suzi Q;2020;Fresh;100;100;28;0;28;7
Swades;2004;Fresh;83;91;5;1;6;3
Swallow;2020;Certified-Fresh;88;71;105;14;119;18
Swamp Thing;1982;Fresh;65;34;24;13;37;5
The Swan Princess;1994;Rotten;50;66;6;6;12;3
The Swarm;1978;Rotten;10;19;2;18;20;3
S.W.A.T.;2003;Rotten;48;52;80;88;168;42
Sweaty Betty;2016;Fresh;89;43;8;1;9;4
Sweeney Todd: The Demon Barber of Fleet Street;2007;Certified-Fresh;86;81;196;33;229;48
Sweet Bean (An);2016;Certified-Fresh;84;86;49;9;58;15
Sweet Hearts Dance;1988;Rotten;50;36;5;5;10;1
The Sweet Hereafter;1997;Certified-Fresh;98;86;58;1;59;18
Sweet Home Alabama;2002;Rotten;38;78;61;98;159;35
Sweet Land;2006;Certified-Fresh;85;83;62;11;73;30
Sweet Sixteen;2003;Certified-Fresh;97;88;85;3;88;30
Sweet Smell of Success;1957;Certified-Fresh;98;92;51;1;52;14
Sweetwater;2013;Rotten;27;36;4;11;15;6
Sweet Virginia;2017;Certified-Fresh;79;58;44;12;56;11
The Sweetest Thing;2002;Rotten;27;65;29;80;109;30
Sweetheart;2019;Fresh;95;52;36;2;38;6
Sweethearts of the Prison Rodeo;2010;Rotten;43;71;3;4;7;3
Sweetie;1989;Fresh;88;74;15;2;17;2
Sweetness in the Belly;1900;Rotten;40;60;4;6;10;3
Swept Away (Travolti da un Insolito Destino nell'Azzurro Mare d'Agosto);1975;Fresh;63;80;12;7;19;2
Swept from the Sea;1998;Rotten;28;76;5;13;18;7
Swerve;2013;Rotten;37;24;11;19;30;10
Swimfan;2002;Rotten;15;32;14;79;93;20
The Swimmer;1968;Fresh;100;82;22;0;22;4
Swimming Pool;2003;Certified-Fresh;83;67;128;26;154;39
Swimming with Men;2018;Rotten;56;57;25;20;45;11
Swimming with Sharks;1995;Fresh;78;79;28;8;36;12
Swing;2004;Rotten;42;;5;7;12;8
Swing;2000;Rotten;43;50;3;4;7;2
Swing Kids;1993;Rotten;56;79;10;8;18;5
Swing Shift;1984;Fresh;87;41;13;2;15;5
Swing Vote;2008;Rotten;39;41;58;92;150;41
Swingers;1996;Certified-Fresh;87;89;47;7;54;13
Swinging Safari;2019;Fresh;75;57;21;7;28;4
Swinging With The Finkels;2011;Rotten;0;20;0;19;19;3
Swiped;1900;Rotten;17;59;1;5;6;0
Swiss Army Man;2016;Fresh;71;72;148;59;207;39
Switch;2012;Rotten;50;23;3;3;6;4
Switchback;1997;Rotten;32;46;8;17;25;6
Switchblade Sisters;1975;Rotten;48;70;10;11;21;7
Switching Goals;2000;Rotten;0;47;0;5;5;0
Swoon;1991;Fresh;70;66;7;3;10;3
The Sword in the Stone;1963;Fresh;66;73;19;10;29;4
Sword Master;2016;Fresh;67;56;8;4;12;3
Sword of Trust;2019;Certified-Fresh;93;62;84;6;90;21
Sword Of Vengeance;2015;Rotten;13;19;1;7;8;4
Swordfish;2001;Rotten;25;59;35;103;138;37
SX_Tape;2014;Rotten;33;8;3;6;9;1
Sydney White;2007;Rotten;35;70;30;55;85;25
Sylvia Scarlett;1935;Fresh;79;47;11;3;14;1
Sympathy for the Devil (One Plus One);1968;Rotten;50;57;5;5;10;1
Sympathy for Delicious;2011;Rotten;33;40;9;18;27;13
Sympathy for Lady Vengeance;2005;Certified-Fresh;76;87;65;21;86;26
Sympathy for Mr. Vengeance;2002;Rotten;54;85;31;26;57;14
Synchronicity;2016;Rotten;50;35;14;14;28;8
Synecdoche, New York;2008;Fresh;69;71;131;60;191;51
Syriana;2005;Certified-Fresh;73;67;144;54;198;50
Syrup;2013;Rotten;25;36;2;6;8;4
System Crasher (Systemsprenger);1900;Fresh;94;;33;2;35;7
T2 Trainspotting;2017;Certified-Fresh;81;78;202;47;249;48
Ta Ra Rum Pum;2007;Rotten;50;72;4;4;8;3
Table 19;2017;Rotten;26;40;30;87;117;30
Tabloid;2011;Certified-Fresh;92;72;109;10;119;43
Tadpole;2002;Certified-Fresh;78;57;83;24;107;32
Tae Guk Gi: The Brotherhood of War;2004;Certified-Fresh;80;93;35;9;44;18
Tag;2018;Rotten;56;56;112;88;200;40
Tai Chi Hero;2013;Rotten;45;48;5;6;11;5
Tai Chi Zero;2012;Fresh;60;52;18;12;30;14
Tail Lights Fade;1999;Rotten;0;27;0;6;6;1
The Tailor of Panama;2001;Certified-Fresh;77;46;89;27;116;36
Take Every Wave: The Life of Laird Hamilton;2017;Fresh;77;78;17;5;22;10
Take Me Home Tonight;2011;Rotten;28;42;32;82;114;35
Take Me Out to the Ball Game;1949;Fresh;93;70;14;1;15;6
Take Me to the River;2014;Fresh;74;60;20;7;27;11
Take Me To The River;2016;Fresh;74;42;26;9;35;18
Take Shelter;2011;Certified-Fresh;92;81;152;13;165;45
Take the Lead;2006;Rotten;44;77;54;68;122;36
Take This Waltz;2012;Certified-Fresh;79;58;111;30;141;41
Take Your Pills;2018;Fresh;62;51;8;5;13;4
Taken;2009;Rotten;58;85;102;73;175;46
Taken 2;2012;Rotten;22;52;38;133;171;41
Taken 3;2015;Rotten;13;44;15;105;120;31
Takers;2010;Rotten;28;62;32;82;114;27
Taking Care of Business;;Rotten;29;52;4;10;14;7
Taking Chance;2009;Rotten;57;83;4;3;7;1
Taking Lives;2004;Rotten;22;55;35;124;159;39
Taking Sides: Le cas Furtwangler;2003;Certified-Fresh;73;72;41;15;56;23
Taking Woodstock;2009;Rotten;48;47;89;95;184;61
Talaash;2012;Fresh;81;64;17;4;21;6
The Tale of Despereaux;2008;Rotten;57;44;63;47;110;34
Tale of Tales (Il racconto dei racconti);2016;Certified-Fresh;83;57;87;18;105;27
The Talent Given Us;2004;Rotten;59;46;30;21;51;20
The Talented Mr. Ripley;1999;Certified-Fresh;83;80;111;22;133;34
Tales from the Crypt Presents Bordello of Blood;1996;Rotten;15;31;5;29;34;7
Tales from the Crypt Presents: Demon Knight;1995;Rotten;36;64;12;21;33;10
Tales from the Darkside: The Movie;;Rotten;43;44;9;12;21;5
Tales from the Golden Age;2011;Fresh;91;78;31;3;34;12
Tales From the Hood;1995;Rotten;47;68;9;10;19;3
Tales from the Hood 2;1900;Fresh;75;27;6;2;8;1
Tales From the Script;2010;Fresh;75;71;15;5;20;7
Tales of the Night;2012;Fresh;80;62;20;5;25;13
Talihina Sky: The Story of Kings of Leon;1900;Rotten;57;68;4;3;7;4
The Talk of the Town;1942;Fresh;94;84;16;1;17;3
Talk Radio;1988;Certified-Fresh;82;81;40;9;49;13
Talk to Her;2002;Certified-Fresh;92;93;123;11;134;37
Talk to Me;2007;Certified-Fresh;82;77;108;23;131;43
Le Grand Blond avec Une Chaussure Noire (The Tall Blond Man with One Black Shoe);1973;Fresh;67;80;4;2;6;3
Tall Girl;1900;;;;4;5;;2
The Tall T;1957;Fresh;100;83;5;0;5;1
Tall Tale;1995;Rotten;50;52;10;10;20;7
Talladega Nights: The Ballad of Ricky Bobby;2006;Certified-Fresh;71;73;134;54;188;47
Tallulah;2016;Certified-Fresh;85;69;46;8;54;19
Tamara;2006;Rotten;32;38;9;19;28;8
Tamara Drewe;2010;Fresh;65;42;82;45;127;38
Tammy;2014;Rotten;24;36;44;138;182;49
Tammy's Always Dying;1900;Fresh;75;98;24;8;32;5
Tampopo;1985;Certified-Fresh;100;93;55;0;55;15
Tangerine;2015;Certified-Fresh;96;76;150;6;156;37
Tangerines;2015;Certified-Fresh;88;89;58;8;66;24
Tangled;2010;Certified-Fresh;89;87;202;24;226;50
Tango & Cash;1989;Rotten;30;52;14;33;47;9
The Tango Lesson;1997;Rotten;53;78;10;9;19;5
Tank Girl;1995;Rotten;40;63;17;26;43;12
Tanna;2016;Fresh;92;76;36;3;39;12
Tanner Hall;2011;Rotten;16;26;3;16;19;9
The Tao of Steve;2000;Certified-Fresh;80;69;39;10;49;11
Tap;1989;Rotten;50;69;4;4;8;2
Tap World;2015;Fresh;86;59;6;1;7;6
Tape;2001;Certified-Fresh;77;76;77;23;100;29
Tape;2020;Fresh;61;29;14;9;23;7
Tapeheads;1988;Fresh;60;46;9;6;15;5
Taps;1981;Fresh;68;67;17;8;25;5
Targets;1968;Fresh;89;81;25;3;28;6
Tarzan;1999;Certified-Fresh;89;75;93;12;105;28
Tarzan;2014;Rotten;20;33;6;24;30;7
Tarzan & Jane;2002;Rotten;17;30;1;5;6;0
Tarzan and the Lost City;1998;Rotten;6;22;1;17;18;5
Tarzan Escapes;1936;Fresh;71;58;5;2;7;0
Tarzan II;2005;Rotten;33;36;2;4;6;0
Tashan;2008;Rotten;50;20;3;3;6;3
A Taste of Honey;1961;Fresh;89;87;17;2;19;6
Taste the Blood of Dracula;1970;Fresh;67;55;8;4;12;0
Tater Tot & Patton;1900;Fresh;86;91;18;3;21;0
Tatsumi;2012;Fresh;94;80;17;1;18;7
Tau;1900;Rotten;25;48;3;9;12;3
Taxi;2004;Rotten;9;43;10;96;106;29
Taxi Driver;1976;Certified-Fresh;96;93;88;4;92;19
Taxi to the Dark Side;2007;Certified-Fresh;100;90;93;0;93;29
Tchoupitoulas;2012;Fresh;82;68;14;3;17;8
Tea With the Dames (Nothing Like a Dame);2018;Certified-Fresh;98;76;85;2;87;19
Teacher;2019;Fresh;100;62;7;0;7;1
Teacher of the Year;2015;Fresh;100;60;7;0;7;1
Teachers;1984;Fresh;67;45;10;5;15;2
Teacher's Pet;2004;Certified-Fresh;76;47;56;18;74;25
Teaching Mrs. Tingle;1999;Rotten;19;31;13;57;70;25
Team America: World Police;2004;Certified-Fresh;77;80;152;46;198;39
Fah talai jone (Tears of the Black Tiger);2007;Certified-Fresh;75;76;47;16;63;25
Tears of the Sun;2003;Rotten;33;69;51;104;155;40
Ted 2;2015;Rotten;45;50;92;114;206;45
Ted;2012;Fresh;69;73;152;68;220;47
Ted Bundy;2002;Rotten;41;45;9;13;22;6
Teddy Bear;2012;Fresh;94;80;15;1;16;9
Teen Beach Movie;1900;Fresh;86;72;6;1;7;4
Teen Spirit;2019;Fresh;71;58;92;37;129;24
Teen Titans Go! To the Movies;2018;Certified-Fresh;91;72;120;12;132;22
Teen Titans: The Judas Contract;1900;Fresh;83;73;5;1;6;0
Teen Witch;1989;Rotten;44;74;4;5;9;0
Teen Wolf;1985;Rotten;42;52;14;19;33;6
Teenage Paparazzo;2010;Fresh;100;94;6;0;6;1
Teenage;2014;Certified-Fresh;77;49;51;15;66;24
Teenage Badass;1900;Fresh;67;100;8;4;12;1
Teenage Cocktail;1900;Fresh;100;51;5;0;5;0
Teenage Mutant Ninja Turtles;2014;Rotten;21;50;34;127;160;44
Teenage Mutant Ninja Turtles II - The Secret of the Ooze;1991;Rotten;35;67;15;28;43;15
Teenage Mutant Ninja Turtles III;1993;Rotten;23;34;7;24;31;7
Teenage Mutant Ninja Turtles: Out of the Shadows;2016;Rotten;37;47;64;107;171;28
Teenage Mutant Ninja Turtles: The Movie;;Rotten;40;81;21;31;52;17
Tees Maar Khan;2010;Rotten;11;18;1;8;9;2
Teeth;2007;Certified-Fresh;80;45;56;14;70;21
Tehran Taboo;2018;Fresh;97;81;35;1;36;12
Tekken;2009;Rotten;0;31;0;6;6;0
Tekkonkinkreet (Tekkon kinkurito);2007;Fresh;75;88;15;5;20;8
Teknolust;2002;Rotten;30;39;10;23;33;7
Tel Aviv on Fire;2019;Certified-Fresh;90;86;54;6;60;17
Tell It to the Bees;2019;Rotten;53;64;29;26;55;12
Tell Me That You Love Me, Junie Moon;1970;Rotten;22;9;2;7;9;5
Tell Me Who I Am;2019;Certified-Fresh;97;88;35;1;36;13
Telling Lies in America;1997;Fresh;61;45;11;7;18;9
Telstar (Telstar: The Joe Meek Story);2009;Fresh;81;69;22;5;27;8
The Temp;1993;Rotten;29;16;6;15;21;5
The Tempest;2010;Rotten;30;28;27;62;89;37
Temple Grandin;2010;Certified-Fresh;100;94;30;0;30;18
Temptation;2013;Rotten;17;66;6;30;36;16
Ten Thousand Saints;2015;Rotten;58;36;21;15;36;14
10 to Midnight;1983;Rotten;40;50;4;6;10;1
Tenacious D in The Pick of Destiny;2006;Rotten;52;67;65;59;124;41
The Tenant;1976;Fresh;88;87;28;4;32;6
Tender Mercies;1983;Fresh;84;82;21;4;25;1
Die Zartlichkeit der Wolfe (The Tenderness of Wolves);1973;;;;5;3;;2
Tequila Sunrise;1988;Rotten;52;40;16;15;31;9
Term Life;2016;Rotten;0;32;0;7;7;4
Terminal;2018;Rotten;21;36;14;53;67;15
Terminal Velocity;1994;Rotten;19;22;5;21;26;5
The Terminator;1984;Certified-Fresh;100;89;64;0;64;14
Terminator 2: Judgment Day;1991;Certified-Fresh;93;94;76;6;82;26
Terminator 3 - Rise of the Machines;2003;Fresh;69;46;142;63;205;42
Terminator Salvation;2009;Rotten;33;54;92;188;280;55
Terminator: Dark Fate;2019;Fresh;70;82;234;101;335;44
Terminator Genisys;2015;Rotten;27;53;73;196;269;45
Terms And Conditions May Apply;2013;Fresh;83;72;25;5;30;11
Terms of Endearment;1983;Certified-Fresh;78;83;42;12;54;11
Terraferma;2013;Fresh;67;57;16;8;24;9
Terri;2011;Certified-Fresh;87;60;85;13;98;35
Terribly Happy (Frygtelig lykkelig);2010;Certified-Fresh;88;73;42;6;48;15
Terrifier;2018;Fresh;64;54;9;5;14;0
Terror in a Texas Town;1958;Fresh;100;68;6;0;6;0
Terror of Mechagodzilla;1900;Rotten;43;60;3;4;7;0
Terror Tract;2000;Fresh;60;35;3;2;5;0
Terror Train;1980;Rotten;36;38;5;9;14;2
Tesla;2020;Fresh;60;43;96;65;161;24
Tess;1979;Fresh;81;78;21;5;26;6
Test;2014;Fresh;82;57;18;4;22;8
Testament;1983;Fresh;82;74;9;2;11;3
Testament Of Youth;2015;Certified-Fresh;84;78;105;20;125;38
Tetro;2009;Fresh;71;70;77;32;109;41
Tetsuo: The Ironman;1989;Fresh;79;76;11;3;14;0
Tex;1982;Fresh;85;66;11;2;13;4
Texas Chainsaw;2013;Rotten;19;40;15;64;79;14
The Texas Chainsaw Massacre;2003;Rotten;37;58;57;99;156;38
The Texas Chainsaw Massacre 2;1986;Rotten;47;44;15;17;32;3
Texas Chainsaw Massacre: The Next Generation;1994;Rotten;14;18;5;31;36;5
Texas Killing Fields;2011;Rotten;37;27;17;29;46;16
Thale;2013;Rotten;55;33;6;5;11;3
Thank God It's Friday;1978;Rotten;30;37;3;7;10;1
Thank You For Playing;2016;Fresh;90;71;9;1;10;5
Thank You for Smoking;2006;Certified-Fresh;86;87;157;25;182;44
Thank You for Your Service;2017;Certified-Fresh;77;72;88;26;114;34
Thanks For Sharing;2013;Rotten;51;43;60;58;117;42
Tharlo;2016;Fresh;90;;9;1;10;3
That Touch of Mink;1962;Fresh;78;70;7;2;9;0
That Awkward Moment;2014;Rotten;22;46;31;110;140;38
That Evening Sun;2009;Fresh;82;76;31;7;38;11
That Man From Rio;1964;Fresh;92;79;12;1;13;4
That Man: Peter Berlin;2006;Fresh;93;60;13;1;14;6
That Night;1993;Fresh;67;80;4;2;6;1
That Obscure Object of Desire;1977;Fresh;100;90;30;0;30;4
That Old Feeling;1997;Rotten;43;59;6;8;14;4
That Sugar Film;2015;Fresh;68;75;26;12;38;16
That Summer;2018;Fresh;82;60;31;7;38;13
That Thing You Do!;1996;Certified-Fresh;93;78;54;4;58;19
That Uncertain Feeling;1941;Fresh;67;57;4;2;6;1
That's Entertainment! III;1994;Fresh;100;82;7;0;7;2
That's Entertainment;1973;Fresh;100;85;14;0;14;2
That's Entertainment, Part 2;1976;Fresh;67;79;4;2;6;0
That's My Boy;2012;Rotten;20;51;23;92;115;30
That's the Way I Like It (Forever Fever);1999;Rotten;47;85;7;8;15;4
That's What I Am;2011;Fresh;60;68;12;8;20;9
That's What She Said;2012;Rotten;8;31;1;11;12;8
The 5,000 Fingers of Dr. T;1953;Fresh;81;75;13;3;16;2
The 9th Company (9 rota);2005;Fresh;69;75;11;5;16;7
The Actress;1953;Fresh;60;45;3;2;5;1
The Adventures of Sharkboy and Lavagirl in 3-D;2005;Rotten;19;33;24;100;124;33
The Amateurs (The Moguls) (Dirty Movie);2005;Rotten;19;54;5;21;26;8
The Baby;1973;Fresh;93;53;14;1;15;1
The Backyard;2002;Fresh;74;54;14;5;19;9
The Best and the Brightest;2011;Rotten;26;30;5;14;19;11
The Blue Tooth Virgin;2009;Fresh;62;52;8;5;13;6
The Bogus Witch Project;2000;Rotten;0;11;0;5;5;0
La demoiselle d'honneur (The Bridesmaid);2004;Certified-Fresh;93;59;50;4;54;21
The Bunker;2004;Fresh;80;34;4;1;5;1
The Cake Eaters;2007;Fresh;64;48;16;9;25;13
The Cheetah Girls 2;1900;Rotten;57;61;4;3;7;3
The Company Men;2011;Fresh;67;55;114;55;169;47
The Crimson Kimono;1959;Fresh;83;71;10;2;12;3
The Croods;2013;Fresh;71;77;102;41;143;37
The Debut;2000;Fresh;74;73;17;6;23;10
The Desert Of Forbidden Art;2011;Fresh;89;88;16;2;18;6
The Eagle;2011;Rotten;39;41;62;95;157;41
The Evil Dead;1981;Certified-Fresh;95;84;59;3;62;6
The Fall;2006;Fresh;61;85;67;43;110;34
The Family That Preys;2008;Rotten;53;61;23;20;43;13
The Fantasticks;1995;Rotten;48;49;12;13;25;2
The Food of the Gods;1976;Rotten;24;26;4;13;17;1
The Foot Fist Way;2006;Rotten;54;46;45;39;84;33
The Gods Must Be Crazy;1980;Fresh;85;84;22;4;26;5
The Great Mouse Detective;1986;Fresh;80;79;20;5;25;6
The Heart Is Deceitful Above All Things;2004;Rotten;41;70;21;30;51;18
The Heart of the Game;2005;Certified-Fresh;87;83;87;13;100;41
The Hero of Color City;2014;Rotten;29;48;6;15;21;12
The House By The Cemetery (Quella villa accanto al cimitero);1981;Rotten;45;49;5;6;11;0
The Killing of John Lennon;2006;Rotten;39;46;14;22;36;18
The Knack...And How to Get It;1965;Fresh;71;70;10;4;14;0
The Last Run;1971;Rotten;40;43;2;3;5;2
The Left Handed Gun;1958;Fresh;90;54;9;1;10;4
The Lightkeepers;2010;Rotten;20;47;1;4;5;1
The Lost;2008;Fresh;83;62;5;1;6;1
The Man;2005;Rotten;12;41;12;90;102;33
The Missing Gun;2003;Rotten;38;67;3;5;8;2
The Navigator;1924;Fresh;100;89;19;0;19;2
The Next Man;1976;Rotten;14;17;1;6;7;3
The Nutcracker;1993;Rotten;50;63;4;4;8;2
The Other Side of the Mirror - Bob Dylan Newport 1963-1965;1900;Fresh;100;96;6;0;6;3
Professione: reporter (The Passenger);1975;Certified-Fresh;88;85;65;9;74;21
The Perfect Host;2011;Rotten;45;55;15;18;33;14
The Pleasure of Being Robbed;2008;Rotten;27;37;3;8;11;5
The Resident;2012;Rotten;35;27;11;20;31;7
The Romantics;2010;Rotten;14;21;5;30;35;17
The Safety of Objects;2001;Rotten;50;65;37;37;74;29
The Scenesters;2011;Rotten;50;69;4;4;8;3
The Scent of Green Papaya (Mui du du xanh - L'odeur de la papaye verte);1993;Fresh;100;82;17;0;17;2
The Secret of Kells;2010;Certified-Fresh;90;85;75;8;83;25
The Secret of Roan Inish;1995;Certified-Fresh;95;87;42;2;44;16
La Siciliana Ribelle (The Sicilian Girl);2010;Rotten;55;61;17;14;31;11
The Singles Ward;2002;Rotten;50;73;4;4;8;1
The Social Network;2010;Certified-Fresh;96;86;307;14;321;59
The Story of O;1975;Rotten;33;44;3;6;9;0
The Tale of Zatoichi;1962;Fresh;100;86;7;0;7;0
The Taqwacores;2010;Rotten;41;49;11;16;27;13
The Terror (The Haunting) (The Castle of Terror);1963;Rotten;36;22;4;7;11;0
Mickey, Donald, Goofy: The Three Musketeers;2004;Rotten;36;49;4;7;11;0
The Tigger Movie;2000;Fresh;62;62;46;28;74;21
The Trotsky;2010;Fresh;79;70;11;3;14;3
The Vanishing of the Bees;2011;Rotten;58;63;11;8;19;5
The War on the War on Drugs;2002;Rotten;22;;2;7;9;5
The War;1994;Rotten;25;73;4;12;16;4
The Warrior's Way;2010;Rotten;31;47;13;29;42;10
The Wide Blue Road (La Grande strada azzurra);2001;Fresh;92;78;12;1;13;2
The Wild and Wonderful Whites of West Virginia;2009;Fresh;60;65;6;4;10;3
The Yakuza;1975;Rotten;59;72;10;7;17;4
The $1,000,000 Duck;1900;Rotten;17;40;1;5;6;2
The 100-Year-Old Man Who Climbed Out the Window and Disappeared;2015;Fresh;68;69;54;26;80;24
The 10th Victim (La Decima vittima) (The Tenth Victim);1965;Fresh;80;79;8;2;10;0
The 12th Man;2018;Fresh;86;79;18;3;21;9
The 15:17 to Paris;2018;Rotten;23;37;38;127;165;33
The 24 Hour War;1900;Fresh;100;86;6;0;6;1
The 24th;2020;Fresh;78;92;21;6;27;10
The 33;2015;Rotten;48;59;74;80;154;36
The 5th Quarter;2011;Rotten;57;62;4;3;7;3
The 9th Life of Louis Drax;2016;Rotten;38;37;25;41;66;18
The Abandoned;2016;Rotten;46;68;6;7;13;5
The ABCs of Death;2013;Rotten;37;23;25;43;68;14
The Absent One (Fasandraeberne);2016;Fresh;92;67;11;1;12;5
The Accompanist;1900;Rotten;0;;0;6;6;0
The Accountant;2016;Rotten;52;76;146;137;282;53
The Act Of Killing;2013;Certified-Fresh;95;85;148;8;156;46
The Addams Family;2019;Rotten;44;69;68;86;154;25
The Adderall Diaries;2016;Rotten;23;28;8;27;35;13
The Adventure Club;2017;Rotten;20;50;1;4;5;1
The Adventurer: The Curse of the Midas Box;2014;Rotten;20;38;3;12;15;3
The Adventurers;2017;Rotten;14;26;1;6;7;3
The Adventures of Buckaroo Banzai;1984;Fresh;68;69;27;13;40;4
The Adventures of Bullwhip Griffin;1967;Rotten;50;48;4;4;8;3
The Adventures of Milo and Otis;1986;Fresh;80;74;8;2;10;0
The Adventures of Tintin;2011;Certified-Fresh;74;74;172;60;232;51
The African Queen;1951;Certified-Fresh;98;86;44;1;45;9
The After Party;2018;Rotten;0;87;0;5;5;0
The Afterlight;2010;Fresh;63;86;5;3;8;6
The Aftermath;2019;Rotten;27;50;41;109;150;34
The Age of Adaline;2015;Rotten;54;67;91;76;167;42
The Age of Stupid;2009;Fresh;73;68;11;4;15;5
The Aggression Scale;1900;Fresh;100;50;5;0;5;0
The Air I Breathe;2008;Rotten;10;61;4;36;40;15
The Air Up There;1994;Rotten;21;35;6;22;28;8
The Amazing Catfish;2014;Fresh;100;80;8;0;8;4
The Amazing Spider-Man;2012;Certified-Fresh;73;77;241;91;332;57
The Amazing Spider-Man 2;2014;Rotten;51;64;158;150;308;62
The Ambassador;2012;Fresh;73;74;27;10;37;17
The American;2010;Fresh;65;39;146;77;223;52
The American Meme;1900;Fresh;94;97;29;2;31;4
The American Side;2016;Fresh;79;80;15;4;19;5
The American Soldier (Der amerikanische Soldat);1976;Fresh;77;55;10;3;13;3
The Amityville Horror;1979;Rotten;27;52;12;32;44;7
The Amityville Murders;2019;Rotten;6;49;1;15;16;2
The Angel;2018;Fresh;75;60;9;3;12;1
The Angels' Share;2013;Certified-Fresh;89;78;91;11;102;32
The Angriest Man in Brooklyn;2014;Rotten;9;30;3;29;32;11
The Angry Birds Movie;2016;Rotten;43;46;69;91;159;29
The Angry Birds Movie 2;2019;Fresh;73;84;80;30;110;19
The Anomaly;2015;Rotten;0;24;0;17;17;4
The Anonymous People;2014;Rotten;43;65;3;4;7;3
The Anthropologist;2016;Fresh;100;74;6;0;6;3
The Apostate (El Apostata);2016;Fresh;79;33;15;4;19;4
The Apparition;2012;Rotten;3;24;2;60;62;11
The Apparition (L'apparition);2018;Fresh;73;64;32;12;44;13
The Arbor;2011;Certified-Fresh;96;74;44;2;46;16
The Archer;1900;Fresh;83;91;5;1;6;1
Ardor;2015;Rotten;36;26;12;21;33;17
The Argument;2020;Fresh;69;33;11;5;16;3
The Armstrong Lie;2013;Certified-Fresh;82;76;98;22;120;44
The Arrangement;1969;Rotten;8;65;1;11;12;2
The Art of Getting By;2011;Rotten;19;46;22;91;113;34
The Art of Racing in the Rain;2019;Rotten;43;96;50;67;117;28
The Art of Self-Defense;2019;Certified-Fresh;84;63;136;26;162;26
The Art of the Steal;2014;Rotten;44;39;22;28;50;18
The Art Star and the Sudanese Twins;2008;Fresh;86;53;6;1;7;3
The Artist;2011;Certified-Fresh;95;87;302;15;317;64
The Aspern Papers;2019;Rotten;18;38;4;18;22;9
The Assassin;2015;Certified-Fresh;81;48;100;24;124;30
The Assignment;2017;Rotten;33;21;20;40;60;15
The Atoning;1900;Fresh;60;45;3;2;5;0
The Attack;2013;Certified-Fresh;87;78;53;8;60;25
The Attorney;2014;Fresh;75;87;9;3;12;7
The Audition (Das Vorspiel);2020;Fresh;78;;25;7;32;7
The Automatic Hate;2016;Fresh;67;47;8;4;12;5
The Autopsy of Jane Doe;2016;Certified-Fresh;87;70;90;14;104;14
The Awakening;2012;Fresh;62;51;45;28;73;25
The Awakening of Motti Wolkenbruch (Wolkenbruchs wunderliche reise in die arme einer schickse);1900;Fresh;63;50;5;3;8;1
The Babadook;2014;Certified-Fresh;98;72;233;5;238;49
The Babymakers;2012;Rotten;8;22;4;47;51;21
The Babysitter;2017;Fresh;72;61;21;8;29;0
The Bachelor and the Bobby-Soxer;1947;Fresh;78;78;7;2;9;1
The Bachelors;2017;Fresh;83;74;15;3;18;4
The Backwoods (Bosque de sombras);2008;Fresh;67;27;6;3;9;1
The Bad Batch;2017;Rotten;47;30;46;52;98;19
The Bag Man;2014;Rotten;11;22;5;41;46;16
The Ballad of Buster Scruggs;2018;Certified-Fresh;90;77;202;22;224;43
The Ballad of Genesis and Lady Jaye;2012;Fresh;67;53;18;9;27;13
The Ballad of Lefty Brown;2017;Fresh;79;54;22;6;28;10
The Banana Splits;1900;Fresh;63;51;12;7;19;1
The Band's Visit;2007;Certified-Fresh;98;86;116;2;118;38
The Banshee Chapter;2014;Fresh;77;42;17;5;22;4
The Barber;2015;Rotten;20;26;2;8;10;7
The Basement;2018;Rotten;11;26;1;8;9;1
Bastards;2013;Fresh;67;37;36;18;54;24
The Bastards' Fig Tree (La higuera de los bastardos);2019;Fresh;73;;8;3;11;1
The Battery;2014;Fresh;80;65;8;2;10;0
The Battle of Algiers (La Battaglia di Algeri);1967;Certified-Fresh;99;95;88;1;89;29
The Battle of Jangsari;2019;Rotten;38;79;3;5;8;1
The Battle of Pussy Willow Creek;2013;Rotten;56;85;5;4;9;6
The Bay;2012;Certified-Fresh;76;43;62;20;82;29
The Bay of Silence;2020;Rotten;50;61;14;14;28;5
The Baytown Outlaws;2013;Rotten;22;54;6;21;27;12
The Beach Bum;2019;Rotten;56;29;67;53;120;30
The Bear;1900;Fresh;93;82;13;1;14;4
The Beast (La bete);2014;Fresh;67;51;14;7;21;6
The Beast in the Cellar;1971;Rotten;17;15;1;5;6;3
The Beast With Five Fingers;1946;Fresh;89;60;16;2;18;4
The Beat Beneath My Feet;2016;Rotten;50;48;4;4;8;4
The Beat Hotel;2012;Rotten;44;65;4;5;9;4
The Beatles: Eight Days a Week - The Touring Years;2016;Certified-Fresh;96;89;99;4;103;29
The Beautiful Person (La Belle Personne);2008;Rotten;50;58;3;3;6;2
The Beaver;2011;Fresh;62;55;113;70;183;55
The Beguiled;2017;Certified-Fresh;79;48;254;68;322;57
The Believer;2002;Certified-Fresh;83;82;77;16;93;28
The Believers;1987;Rotten;39;44;7;11;18;1
The Belko Experiment;2017;Rotten;53;40;56;49;105;18
The Bellmen;1900;Fresh;60;;3;2;5;0
The Benefactor;2016;Rotten;26;23;14;40;54;20
The Berlin File;2013;Rotten;43;58;6;8;14;6
The Best Exotic Marigold Hotel;2012;Certified-Fresh;78;78;131;36;167;42
The Best Man Holiday;2013;Fresh;71;83;68;28;96;33
The Best of Enemies;2019;Rotten;53;76;41;36;77;20
The Best Of Me;2014;Rotten;12;59;10;73;83;26
The Best Offer;2014;Rotten;56;77;19;15;34;14
The Better Angels;2014;Rotten;45;43;22;27;49;20
The BFG;2016;Certified-Fresh;74;57;221;77;297;56
The Big Bang;2011;Rotten;19;25;3;13;16;10
The Big Boss (Tang shan da xiong);1972;Fresh;73;73;11;4;15;0
The Big Day (Jour De Fete);1952;Fresh;100;83;20;0;20;1
The Big Feast (La Grande Bouffe);1973;Fresh;63;82;10;6;16;7
The Big Fix;2011;Fresh;86;84;6;1;7;5
The Big Hangover;1900;Fresh;67;31;4;2;6;4
The Big Kahuna;2000;Certified-Fresh;73;71;58;21;79;26
The Big Lebowski;1998;Certified-Fresh;83;93;87;18;105;20
The Big Parade;1925;Fresh;100;91;12;0;12;0
The Big Picture;2012;Certified-Fresh;86;63;37;6;43;15
The Big Short;2015;Certified-Fresh;88;88;284;38;322;56
The Big Sick;2017;Certified-Fresh;98;88;294;5;299;50
The Big Squeeze;1996;Rotten;43;60;3;4;7;1
The Big Ugly;1900;Rotten;41;65;9;13;22;4
The Big Wedding;2013;Rotten;7;40;8;103;111;36
The Big Year;2011;Rotten;42;40;43;60;103;36
The Bill Murray Stories: Life Lessons Learned from a Mythical Man;1900;Fresh;95;79;20;1;21;3
The Bingo Long Traveling All-Stars & Motor Kings;1976;Fresh;88;68;15;2;17;7
The Birth of a Nation;2016;Certified-Fresh;72;71;193;73;265;55
The Bishop's Wife;1948;Fresh;84;81;21;4;25;7
The Bitter Buddha;2013;Fresh;94;73;15;1;16;8
The Black Cat;1981;Rotten;33;25;2;4;6;0
The Black Godfather;2019;Fresh;100;;7;0;7;4
The Black Panthers: Vanguard Of The Revolution;2015;Certified-Fresh;92;71;59;5;64;21
The Black Power Mixtape 1967-1975;2011;Certified-Fresh;92;86;49;4;53;20
The Black Stallion Returns;1983;Rotten;20;73;1;4;5;1
The Black String;1900;Fresh;86;53;6;1;7;0
The Blackcoat's Daughter (February);2017;Fresh;72;49;48;19;67;16
The Blackout Experiments;2016;Rotten;45;41;5;6;11;5
The Blech Effect;1900;Fresh;67;;6;3;9;1
The Bleeding Edge;2018;Fresh;100;83;19;0;19;10
The Bleeding House;2011;Rotten;40;25;2;3;5;1
The Bling Ring;2013;Rotten;59;33;121;83;204;56
The Blob;1958;Fresh;66;52;21;11;32;3
The Blob;1988;Fresh;62;56;16;10;26;0
The Boat;1900;Fresh;78;62;7;2;9;1
The Body Remembers When the World Broke Open;2019;Fresh;97;58;35;1;36;7
The Bodyguard;1992;Rotten;33;64;15;31;46;9
The Bodyguard (Kaavalan);2011;Rotten;29;44;2;5;7;4
The Book of Eli;2010;Rotten;47;64;96;109;205;51
The Book of Henry;2017;Rotten;22;63;32;114;146;31
The Book of Life;2014;Certified-Fresh;82;77;102;22;124;33
The Book Of Love;2017;Rotten;8;63;1;11;12;5
The Book Thief;2013;Rotten;47;73;70;79;149;45
The Bookshop;2018;Rotten;57;51;60;46;106;22
The Borderlands;2014;Fresh;81;46;13;3;16;7
The Boss;2016;Rotten;21;38;41;153;193;47
The Boss Baby;2017;Rotten;53;51;94;85;179;34
The Bounce Back;2016;Fresh;67;74;4;2;6;1
The Bouncer (Lukas);2019;Fresh;80;44;4;1;5;0
The Bourne Legacy;2012;Rotten;55;58;126;104;230;51
The Boxer;1997;Certified-Fresh;80;74;56;14;70;27
The Boxtrolls;2014;Certified-Fresh;77;63;133;39;172;40
The Boy;2016;Rotten;30;38;18;43;61;8
The Boy;2015;Fresh;67;38;14;7;21;6
The Boy And The Beast (Bakemono No Ko);2016;Certified-Fresh;90;88;61;7;68;15
The Boy Next Door;2015;Rotten;12;33;16;120;136;38
The Boy Who Harnessed the Wind;2019;Certified-Fresh;86;88;54;9;63;20
Jack and the Cuckoo-Clock Heart;2014;Fresh;77;66;10;3;13;2
The Boys and Girl from County Clare;2004;Rotten;46;61;13;15;28;11
The Brady Bunch Movie;1995;Fresh;62;46;26;16;42;14
The Brainwashing of My Dad;2016;Rotten;58;77;7;5;12;4
The Brand New Testament (Le tout nouveau testament);2016;Certified-Fresh;82;68;63;14;77;17
The Brass Teapot;2013;Rotten;32;51;10;21;31;13
The Brave Little Toaster Goes to Mars;1998;Rotten;40;45;2;3;5;0
The Breadwinner;2017;Certified-Fresh;95;87;99;5;104;22
The Breaker Upperers;1900;Certified-Fresh;87;51;41;6;47;6
The Bridge (Die Brucke);1959;Fresh;100;86;9;0;9;1
The Brink;2019;Certified-Fresh;84;55;85;16;101;21
The Broken Circle Breakdown;2013;Certified-Fresh;82;85;84;18;102;30
The Bronze;2016;Rotten;36;44;36;63;99;28
The Brooklyn Banker;2016;Rotten;20;92;1;4;5;4
The Brooklyn Brothers Beat The Best;2012;Rotten;33;62;7;14;21;10
The Brother from Another Planet;1984;Fresh;89;75;25;3;28;6
The Brothers Grimsby;2016;Rotten;37;41;51;86;137;35
The Bubble;2007;Rotten;54;84;22;19;41;21
The Bugs Bunny/Road Runner Movie;1900;Fresh;100;87;6;0;6;3
The 'Burbs;1989;Rotten;53;71;20;18;38;11
The Butcher, The Chef And The Swordsman;2011;Rotten;46;40;6;7;13;6
The Bye Bye Man;2017;Rotten;19;22;17;72;89;17
The Cabin in the Woods;2012;Certified-Fresh;92;74;262;24;286;53
The Cabinet of Dr. Caligari (Das Cabinet des Dr. Caligari);1920;Certified-Fresh;98;89;62;1;62;14
The Cage Fighter;2018;Fresh;94;46;16;1;17;8
The Call;2013;Rotten;44;65;58;74;131;31
The Call of Cthulhu;1969;Fresh;100;85;6;0;6;0
The Calling;2014;Rotten;51;33;23;22;45;14
The Camden 28;2007;Fresh;89;69;24;3;27;11
The Campaign;2012;Fresh;66;51;136;70;206;47
The Canal;2014;Fresh;71;48;17;7;24;5
The Candy Witch;1900;Rotten;17;;1;5;6;0
The Cannibal Club;2019;Rotten;57;64;8;6;14;2
The Canterbury Tales;1971;Rotten;56;63;5;4;9;1
The Canterville Ghost;1944;Fresh;86;72;6;1;7;0
The Canyons;2013;Rotten;21;15;20;75;94;33
The Captain (Der Hauptmann);2018;Certified-Fresh;83;82;44;9;53;18
The Captain;2019;Fresh;75;96;6;2;8;2
The Captive;2014;Rotten;30;36;16;38;54;17
The Car;1977;Rotten;28;52;5;13;18;4
The Cartel;2010;Rotten;48;69;14;15;29;14
The Case for Christ;2017;Rotten;59;87;16;11;27;6
The Cassandra Crossing;1977;Rotten;30;52;3;7;10;0
The Castle;1999;Fresh;87;92;34;5;39;7
The Cat from Outer Space;1978;Fresh;67;59;6;3;9;3
The Cat o' Nine Tails (Il gatto a nove code);1971;Fresh;82;53;18;4;22;1
The Cat Returns;2002;Fresh;90;82;19;2;21;4
The Catcher Was A Spy;2018;Rotten;32;51;24;51;75;28
The Catechism Cataclysm;2011;Rotten;47;44;9;10;19;8
The Catered Affair;1956;Rotten;17;71;1;5;6;3
The Celestine Prophecy;2006;Rotten;4;54;1;22;23;8
The Cell;2000;Rotten;45;57;73;91;164;44
The Challenge;1982;Rotten;57;70;4;3;7;0
The Challenge;2017;Fresh;78;33;14;4;18;4
The Chamber;2018;Rotten;33;14;5;10;15;3
The Change-Up;2011;Rotten;25;47;39;117;156;48
The Changeover;2019;Fresh;69;68;22;10;32;5
The Chaperone;2011;Rotten;29;43;5;12;17;9
The Chaser (Chugyeogja);2008;Fresh;82;89;28;6;34;12
The Chateau;2002;Rotten;51;30;27;26;53;16
The Cherry Orchard;2000;Rotten;54;30;14;12;26;10
The Chess Players (Shatranj Ke Khiladi);1978;Fresh;89;87;8;1;9;3
The Child Remains;2019;Rotten;14;36;1;6;7;2
The Childhood of a Leader;2016;Certified-Fresh;89;54;58;7;65;17
The Children Act;2018;Fresh;74;62;82;29;111;26
The China Hustle;2018;Fresh;78;80;25;7;32;11
The Choice;2016;Rotten;11;62;9;75;84;25
The Christmas Candle;2013;Rotten;21;75;5;19;24;9
The Christmas Chronicles;1900;Fresh;67;77;39;19;58;13
The Chronicle of Anna Magdalena Bach;1968;Fresh;100;65;7;0;7;2
The Church (La Chiesa);1989;Fresh;64;49;7;4;11;0
The Circle;2017;Rotten;15;21;22;120;142;28
The Citadel;1938;Fresh;89;72;8;1;9;4
The Clapper;2018;Rotten;23;31;6;20;26;7
The Class;2008;Certified-Fresh;95;82;153;8;161;53
The Cleanse;2018;Fresh;83;38;19;4;23;6
The Client List;1900;Fresh;83;43;5;1;6;3
The Climbers;2019;Rotten;33;80;2;4;6;3
The Closer You Get;2000;Rotten;32;48;6;13;19;4
The Clovehitch Killer;2018;Fresh;76;68;25;8;33;7
The Cobbler;2015;Rotten;10;36;7;63;70;26
The Cold Lands;2014;Fresh;64;56;7;4;11;6
The Cold Light of Day;2012;Rotten;4;29;2;44;46;11
The Coldest Game;2020;Rotten;0;50;0;5;5;1
The Collection;2012;Rotten;36;49;18;32;50;15
The Collector;1965;Fresh;100;84;14;0;14;2
The Collector;1900;Fresh;60;;3;2;5;4
The Collectors;2000;Fresh;80;22;4;1;5;0
The Collini Case;2020;Fresh;82;64;9;2;11;1
The Colony;2013;Rotten;21;22;7;27;34;12
The Color of Pomegranates (Sayat Nova );1980;Fresh;94;84;16;1;17;2
The Color of Time;2014;Rotten;5;20;1;20;21;10
The Color Wheel;2012;Fresh;78;56;21;6;27;12
The Colossus of Rhodes;1961;Fresh;63;31;5;3;8;2
The Comedian;2017;Rotten;24;28;27;86;113;36
The Comedy;2012;Rotten;47;55;16;18;34;16
The Command (Kursk);2019;Fresh;69;55;35;16;51;13
The Commune (Kollektivet);2017;Fresh;71;60;67;27;94;26
The Commuter;2018;Rotten;56;40;118;93;211;45
The Company You Keep;2013;Rotten;54;45;66;56;122;38
The Competition;2018;Rotten;17;53;1;5;6;1
The Con Is On;2018;Rotten;0;42;0;5;5;2
The Concert (Le concert);2010;Fresh;61;78;40;26;66;22
The Condemned;2013;Rotten;0;64;0;9;9;6
The Confirmation;2016;Fresh;91;57;29;3;32;11
The Conformist;1970;Certified-Fresh;98;90;55;1;56;17
The Congress;2014;Certified-Fresh;73;53;78;29;107;31
The Conjuring;2013;Certified-Fresh;86;83;191;32;223;51
The Conjuring 2;2016;Certified-Fresh;80;81;201;50;251;38
The Connection;2015;Certified-Fresh;77;71;57;17;74;25
The Conquest;2011;Fresh;77;50;24;7;31;20
The Conspiracy;2013;Fresh;88;62;7;1;8;2
The Conspirator;2011;Rotten;55;61;94;76;170;48
The Corrupted;2020;Rotten;30;33;3;7;10;2
The Cotton Club Encore;2019;;;;8;3;;7
The Counselor;2013;Rotten;33;23;72;144;216;49
The Counterfeiters;2007;Certified-Fresh;93;88;118;9;127;43
The Courier;2019;Rotten;5;26;1;18;19;7
The Courtship of Eddie's Father;1963;Fresh;60;68;3;2;5;0
The Crash (Jekyll Island);2017;Rotten;17;71;2;10;12;6
The Crash Reel;2013;Certified-Fresh;96;94;44;2;46;20
The Creeping Garden;2015;Fresh;95;60;19;1;20;9
The Crocodile Hunter: Collision Course;2002;Rotten;53;44;44;39;83;23
The Crow: Wicked Prayer;2005;Rotten;0;35;0;6;6;0
The Crowd Roars;1932;Fresh;80;56;4;1;5;1
The Crucifixion;1900;Rotten;6;24;1;15;16;1
The Cup;2012;Rotten;28;46;7;18;25;7
The Cup;1999;Fresh;85;86;28;5;33;8
The Cured;2018;Fresh;69;47;45;20;65;17
The Current War: Director's Cut;2019;Fresh;61;79;63;41;104;20
The Curse of Buckout Road;2019;Fresh;63;77;5;3;8;1
The Curse of La Llorona;2019;Rotten;28;37;52;131;183;25
The Curse of Sleeping Beauty;2016;Rotten;15;33;2;11;13;2
The Curse Of The Gothic Symphony;1900;Fresh;100;67;5;0;5;0
The Dalai Lama: Scientist;1900;Fresh;88;100;23;3;26;1
The Damned;2014;Rotten;8;18;1;11;12;4
The Damned: Don't You Wish That We Were Dead;1900;Fresh;100;64;12;0;12;3
The Danish Girl;2015;Fresh;67;72;161;80;241;47
The Dare;1900;Rotten;25;54;2;6;8;0
The Dark;2018;Fresh;88;55;21;3;24;4
The Dark Horse;2016;Certified-Fresh;97;77;62;2;64;21
The Dark Knight;2008;Certified-Fresh;94;94;320;20;340;63
The Dark Knight Rises;2012;Certified-Fresh;87;90;320;47;367;63
The Dark Red;2020;Fresh;78;65;7;2;9;1
The Dark Tapes;1900;Fresh;90;57;9;1;10;0
The Dark Tower;2017;Rotten;16;45;43;230;273;42
The Darkest Hour;2011;Rotten;12;25;7;52;59;11
The Darkest Minds;2018;Rotten;16;73;22;118;140;26
The Darkness;2016;Rotten;3;19;1;32;33;5
The Day He Arrives;2012;Fresh;90;68;19;2;21;10
The Day Shall Come;2019;Fresh;64;52;58;33;91;20
The Day the Earth Caught Fire;1962;Fresh;85;85;10;2;13;1
The Dead;1987;Fresh;93;78;27;2;29;10
The Dead;2011;Fresh;74;46;17;6;23;8
The Dead Center;2019;Fresh;94;47;17;1;18;5
The Dead Don't Die;2019;Rotten;54;38;164;137;301;46
The Dead Lands;2015;Fresh;69;57;35;16;51;15
The Deal;2005;Rotten;21;17;7;27;34;13
The Death and Life of John F. Donovan;2019;Rotten;20;56;6;24;30;8
The Death and Life of Marsha P. Johnson;2017;Fresh;96;72;27;1;28;13
The Death of Dick Long;2019;Certified-Fresh;75;86;57;19;76;13
The Death of Mr. Lazarescu;2006;Certified-Fresh;93;82;70;5;75;26
The Death of Stalin;2018;Certified-Fresh;95;78;232;12;244;44
The Death of Superman;1900;Fresh;92;85;12;1;13;0
The Death of Superman / Reign of the Supermen Double Feature;2019;Fresh;93;;14;1;15;1
The Debt (Oliver's Deal);2016;Rotten;44;47;4;5;9;5
The Debt Collector;1900;Fresh;83;39;5;1;6;1
The Decent One;2014;Fresh;70;44;21;10;30;16
The Decline (Jusqu'au declin);1900;Fresh;89;64;8;1;9;1
The Decline of Western Civilization;1981;Fresh;100;85;22;0;22;6
The Decoy Bride;2012;Rotten;23;51;5;17;22;9
The Deep;1900;Fresh;94;63;29;2;31;10
The Deep Blue Sea;2012;Certified-Fresh;80;52;113;28;141;46
The Deer Hunter;1978;Certified-Fresh;93;92;71;5;76;17
The Delinquent Season;2018;Fresh;67;71;8;4;12;1
The Demolisher;2015;Fresh;80;9;4;1;5;1
The Den;2014;Fresh;77;52;17;5;22;5
The Departure;2020;Rotten;50;;3;3;6;1
The Descendants;2011;Certified-Fresh;88;79;233;32;265;56
The Descent 2;2009;Rotten;55;34;21;17;38;9
The Details;2012;Rotten;46;34;16;19;35;16
The Devil and Daniel Webster;1941;Fresh;100;83;18;0;18;1
The Devil Bat;1940;Rotten;58;31;7;5;12;0
The Devil Inside;2012;Rotten;6;22;5;85;90;19
The Devil We Know;1900;Fresh;100;90;7;0;7;2
The Devil Wears Prada;2006;Certified-Fresh;75;76;147;49;196;48
The Devil's Candy;2017;Certified-Fresh;92;64;47;4;51;11
The Devil's Dolls;2016;Fresh;60;10;3;2;5;1
The Devil's Doorway;2018;Fresh;76;45;19;6;25;3
The Devil's Double;2011;Rotten;54;64;55;46;101;35
The Devil's Miner;2006;Fresh;93;85;25;2;27;11
The Devil's Playground;1900;Fresh;100;71;7;0;7;1
The Devil's Rock;2012;Rotten;56;36;5;4;9;3
The Devil's Violinist;2015;Rotten;31;44;4;9;13;6
The Diabolical;2015;Rotten;40;19;4;6;10;4
The Diary Of A Teenage Girl;2015;Certified-Fresh;95;73;155;9;164;43
The Dictator;2012;Rotten;57;44;126;94;220;52
The Dilemma;2011;Rotten;25;29;40;123;163;42
The Dinner;2017;Rotten;46;16;66;76;142;35
The Dinner Party;2020;Rotten;38;81;5;8;13;0
The Dinosaur Project;2012;Rotten;29;20;4;10;14;4
The Dirt;1900;Rotten;38;94;27;45;72;17
The Disappearance of Eleanor Rigby: Them;2014;Fresh;66;52;60;32;91;34
The Disappointments Room;2016;Rotten;0;17;0;25;25;6
The Disaster Artist;2017;Certified-Fresh;91;85;313;32;345;51
The Discovery;1900;Rotten;45;43;28;34;62;17
The Dish & The Spoon;2012;Rotten;58;51;7;5;12;4
The Divergent Series: Allegiant;2016;Rotten;11;41;21;173;193;42
The Divide;2012;Rotten;25;38;14;43;57;20
The Divine Fury;2019;Rotten;44;90;8;10;18;4
The Divine Order (Die gottliche Ordnung);2017;Certified-Fresh;83;63;45;9;54;15
The Diving Bell and the Butterfly;2007;Certified-Fresh;94;92;164;10;174;49
The Do-Deca-Pentathlon;2012;Fresh;75;54;30;10;40;18
The Dog;2014;Certified-Fresh;91;69;53;5;58;20
The Dog Lover;2016;Rotten;20;52;2;8;10;4
The Dogs of War;1980;Fresh;67;52;12;6;18;3
The Domestics;2018;Fresh;100;49;5;0;5;1
The Doorman;2008;Rotten;22;50;4;14;18;8
The Double;2011;Rotten;21;33;11;41;52;20
The Double;2014;Certified-Fresh;83;59;110;22;132;36
The Dresser;2015;Fresh;100;61;14;0;14;10
The Dressmaker;2016;Rotten;57;66;79;59;138;33
The Driller Killer;1979;Fresh;64;32;9;5;14;1
The Drop;2014;Certified-Fresh;89;76;178;22;200;49
The Drowning;2017;Rotten;50;15;7;7;14;6
The Duel;2016;Rotten;26;30;5;14;19;10
The Duelist (Duelyant);2016;Rotten;43;65;6;8;14;10
The DUFF;2015;Fresh;73;66;87;33;120;34
The Duke Is Tops;1938;Fresh;60;75;3;2;5;0
The Duke Of Burgundy;2015;Certified-Fresh;94;65;97;6;103;29
The Dyatlov Pass Incident (Devil's Pass);2013;Rotten;48;29;11;12;23;5
The Eagle Huntress;2016;Certified-Fresh;94;86;119;8;127;34
The Earrings of Madame De... (Madame de...);1954;Fresh;97;91;33;1;34;8
The East;2013;Certified-Fresh;76;64;111;36;147;45
The Easy Life (Il sorpasso);1962;Fresh;100;94;7;0;7;2
The Edge of Democracy;1900;Certified-Fresh;97;68;34;1;35;10
The Edge of Seventeen;2016;Certified-Fresh;94;83;199;13;212;44
The Editor;1900;Rotten;55;59;6;5;11;1
The Edukators;2005;Fresh;70;89;53;23;76;27
The Efficiency Expert;1992;Fresh;67;48;4;2;6;1
The Eiger Sanction;1975;Fresh;69;54;11;5;16;2
The Elephant In The Living Room;2011;Fresh;83;84;19;4;23;9
The Elephant Queen;2019;Fresh;91;93;20;2;22;7
The Emoji Movie;2017;Rotten;7;37;9;124;133;26
The Emperor and the Assassin (Jing Ke ci Qin Wang);1998;Fresh;81;79;29;7;36;7
The Emperor Jones;1933;Fresh;71;55;5;2;7;2
The Empty Hours;2014;Fresh;86;52;6;1;7;5
The End;1978;Fresh;60;50;9;6;15;3
The End of Love;2013;Rotten;59;47;10;7;17;12
The End Of The Tour;2015;Certified-Fresh;92;81;145;13;158;37
The End Of Time;2013;Fresh;78;41;7;2;9;4
The Endless;2018;Certified-Fresh;92;67;118;10;128;21
The English Surgeon;2009;Fresh;89;98;17;2;19;12
The English Teacher;2013;Rotten;41;30;15;22;37;17
The Equalizer;2014;Rotten;59;76;119;82;201;45
The Escape;2018;Certified-Fresh;76;51;35;11;46;14
The Escape Artist;1982;Fresh;80;66;4;1;5;2
The Escape of Prisoner 614;2018;Rotten;20;57;2;8;10;4
The Europeans;1979;Fresh;84;34;16;3;19;4
Evil Dead;2013;Fresh;62;63;126;76;202;40
The Evil Within;1900;Fresh;100;49;5;0;5;0
The Exception (The Kaiser's Last Kiss);2017;Certified-Fresh;73;67;43;16;59;15
The Expedition to the End of the World;2014;Fresh;84;52;16;3;19;11
The Expendables;2010;Rotten;42;64;86;120;206;45
The Expendables 2;2012;Fresh;68;67;88;42;130;29
The Expendables 3;2014;Rotten;32;49;55;116;171;43
The Exterminating Angel (El Angel Exterminador);1967;Fresh;93;93;25;2;27;2
The Eye of the Storm;2012;Fresh;60;46;33;22;55;22
The Eyes of My Mother;2016;Certified-Fresh;78;57;77;22;99;25
The Face Of An Angel;2015;Rotten;37;10;18;31;49;23
The Face of Love;2014;Rotten;42;31;31;42;73;29
The Fall of the House of Usher;1960;Fresh;90;74;27;3;30;4
The Falling;2015;Fresh;73;35;27;10;37;9
The Family;2013;Rotten;28;41;39;98;137;32
The Family Fang;2016;Certified-Fresh;83;47;67;14;81;26
The Family Tree;2011;Rotten;10;24;2;19;21;5
The Fanatic;2019;Rotten;16;29;11;56;67;18
The Fare;1900;Fresh;100;;7;0;7;0
The Farewell;2019;Certified-Fresh;98;87;325;7;332;43
The Farewell Party;2015;Fresh;94;73;32;2;34;15
The Farm: Life Inside Angola Prison;1998;Fresh;100;87;6;0;6;1
The Fate of the Furious;2017;Fresh;67;72;205;102;307;54
The Fault In Our Stars;2014;Certified-Fresh;81;85;179;43;222;62
The Favourite;2018;Certified-Fresh;93;69;378;27;405;52
The Fearless Vampire Killers;1967;Fresh;69;76;22;10;32;5
The Female Brain;2018;Rotten;35;49;7;13;20;8
The Field Guide to Evil;2019;Fresh;67;32;6;3;9;0
The Fields;2011;Fresh;60;27;3;2;5;1
The Fifth Estate;2013;Rotten;36;36;64;116;179;52
The 5th Wave;2016;Rotten;15;38;21;118;139;34
The Fight;2020;Certified-Fresh;98;67;64;1;65;17
The Fighter;2010;Certified-Fresh;90;89;226;24;250;49
The Final Girls;2015;Fresh;72;70;50;19;69;15
The Final Master;2016;Fresh;65;61;13;7;20;10
The Final Member;2014;Fresh;92;64;24;2;26;8
The Final Wish;2019;Fresh;73;25;8;3;11;2
The Final Year;2018;Certified-Fresh;84;49;88;17;105;28
The Finest Hours;2016;Fresh;63;66;125;72;197;38
The First Beautiful Thing (La prima cosa bella);2011;Fresh;82;70;14;3;17;9
The First Grader;2011;Fresh;62;76;48;30;78;24
The First Monday in May;2016;Certified-Fresh;76;69;45;14;59;21
The First Purge;2018;Rotten;56;27;95;76;171;31
The First Time;2012;Rotten;47;66;9;10;19;9
The Fits;2016;Certified-Fresh;97;54;104;3;107;27
The Fitzgerald Family Christmas;2012;Fresh;64;49;16;9;25;16
The Five-Year Engagement;2012;Fresh;63;51;112;65;177;46
The Flat;2012;Fresh;85;70;28;5;33;17
The Flaw;2011;Fresh;83;69;10;2;12;3
The Flight of the Intruder;1991;Rotten;25;50;3;9;12;3
The Flintstones;1994;Rotten;22;24;10;36;46;10
The Flood;1900;Fresh;68;;25;12;37;11
The Florida Project;2017;Certified-Fresh;96;80;296;12;308;46
The Flower of My Secret (La Flor de mi Secreto);1995;Fresh;83;76;20;4;24;10
The Flowers of War;2011;Rotten;41;73;24;34;58;22
The Fluffer;2003;Rotten;47;26;21;24;45;14
The Fluffy Movie;2014;Rotten;53;77;8;7;15;10
The Flying Deuces;1939;Fresh;83;65;5;1;6;0
The Flying Swords of Dragon Gate;2012;Fresh;68;48;19;9;28;12
The Fog;1980;Certified-Fresh;74;64;49;17;66;10
The Fog of War: Eleven Lessons from the Life of Robert S. McNamara;2003;Certified-Fresh;96;93;137;5;142;39
The Forbidden Dance;;Rotten;23;77;3;10;13;3
The Forbidden Room;2015;Certified-Fresh;96;50;66;3;68;19
The Foreigner;2017;Fresh;65;72;81;43;124;23
The Forest;2016;Rotten;10;22;14;123;137;34
The Forest for the Trees (Der Wald vor lauter Baumen);2005;Fresh;77;72;10;3;13;5
The Forest of Love;2019;Fresh;100;62;11;0;11;2
The Forest of the Lost Souls (A Floresta das Almas Perdidas);2018;Fresh;75;71;12;4;16;3
The Forger;2015;Rotten;9;32;4;40;44;16
The Forgiven;2018;Rotten;52;42;12;11;23;8
The Forgiveness of Blood;2012;Certified-Fresh;84;72;59;11;70;30
The Forgotten Kingdom;1900;Fresh;86;75;6;1;7;5
The Forgotten Space;2012;Fresh;71;40;5;2;7;3
The Founder;2017;Certified-Fresh;80;82;193;47;240;48
The Fountain;2006;Rotten;52;74;107;98;205;53
The Four Times (Le Quattro Volte);2011;Certified-Fresh;93;75;50;4;54;21
The Fox & the Child;2007;Rotten;50;63;15;15;30;9
The FP;2012;Rotten;50;54;12;12;24;8
The Free World;2016;Rotten;47;54;9;10;19;7
The Freebie;2010;Rotten;57;31;16;12;28;10
The French Minister;2014;Fresh;62;54;13;8;21;10
The Freshman (College Days);1925;Fresh;94;79;15;1;16;5
The Frighteners;1996;Fresh;64;71;25;14;39;13
The Frisco Kid;1979;Rotten;50;66;13;13;26;6
The Front Line;2012;Fresh;67;78;10;5;15;10
The Front Runner;2018;Fresh;60;39;133;89;222;47
The Frontier;2016;Rotten;50;50;3;3;6;1
The Frontier;2014;Fresh;67;;4;2;6;3
The Frozen Ground;2013;Fresh;61;50;35;22;57;14
The Fruit Hunters;2013;Fresh;100;68;7;0;7;4
The Fundamentals of Caring;1900;Fresh;77;83;27;8;35;8
The Funhouse;1981;Fresh;67;38;12;6;18;1
The Funhouse Massacre;2015;Fresh;73;37;11;4;15;4
The Furies;1950;Fresh;83;81;5;1;6;1
The Furies;1900;Fresh;64;57;18;10;28;2
The Future;2011;Certified-Fresh;72;54;79;31;110;42
The Future of Food;2005;Fresh;81;84;21;5;26;12
The Galapagos Affair: Satan Came To Eden;2014;Certified-Fresh;83;63;44;9;53;22
The Gallows;2015;Rotten;14;22;17;101;118;26
The Gallows Act II;2019;Rotten;0;36;0;13;13;4
The Gambler;2014;Rotten;43;31;61;80;141;40
The Game Plan;2007;Rotten;28;69;29;73;102;30
The Gang's All Here;1943;Fresh;100;69;8;0;8;3
The Gangster, the Cop, the Devil;2019;Fresh;97;94;32;1;33;7
The Garden;2019;Fresh;100;75;6;0;6;2
The Garden Left Behind;2020;Fresh;92;89;59;5;64;3
Hemingway's Garden of Eden;2010;Rotten;4;19;1;22;23;7
The Garden of the Finzi-Continis (Il Giardino dei Finzi-Contini);1971;Fresh;100;79;13;0;13;3
The Gardener;2018;Fresh;75;77;6;2;8;4
The Gatekeeper;2001;Rotten;52;20;11;10;21;10
The Gatekeepers;2013;Certified-Fresh;94;79;104;7;111;35
The Gentlemen;2020;Certified-Fresh;75;84;194;65;259;43
The German Doctor;2014;Certified-Fresh;75;63;47;16;63;23
The Ghost and Mr. Chicken;1966;Fresh;67;75;4;2;6;0
The Ghost of Peter Sellers;2020;Certified-Fresh;95;64;40;2;42;9
The Giant Behemoth;1959;Rotten;20;30;1;4;5;0
The Giant Mechanical Man;2012;Fresh;70;65;16;7;23;9
The Gift;2015;Certified-Fresh;91;75;177;17;194;37
The Girl;2013;Rotten;53;43;10;9;19;9
The Girl from the Naked Eye;2012;Rotten;40;20;6;9;15;7
The Girl in the Book;2015;Fresh;92;55;12;1;13;10
The Girl In The Photographs;2016;Rotten;18;21;4;18;22;8
The Girl in the Spider's Web;2018;Rotten;39;36;91;145;236;44
The Girl Is In Trouble;2015;Rotten;57;40;8;6;14;6
The Girl King;2015;Rotten;42;45;8;11;19;6
The Girl on the Train;2016;Rotten;44;49;134;170;304;57
The Girl;2012;Fresh;70;41;31;13;44;26
The Girl Who Kicked the Hornet's Nest;2010;Rotten;54;67;73;61;134;37
The Girl Who Leapt Through Time;2007;Fresh;83;90;15;3;18;8
The Girl With All the Gifts;2017;Certified-Fresh;86;67;108;18;126;18
The Girl with the Dragon Tattoo;2011;Certified-Fresh;86;86;215;34;249;50
The Girl with the Dragon Tattoo;2009;Certified-Fresh;85;87;162;28;190;48
The Girls in the Band;2013;Fresh;100;57;10;0;10;6
The Giver;2014;Rotten;35;55;58;109;167;42
The Glass Bottom Boat;1966;Rotten;57;74;4;3;7;0
The Glass Castle;2017;Rotten;52;71;85;79;164;43
The Glass Shield;1994;Fresh;65;39;15;8;23;8
The Gleaners and I;2001;Certified-Fresh;93;87;40;3;43;13
The Go-Getter;2008;Rotten;42;61;10;14;24;12
The Go-Getters;1900;Fresh;71;88;5;2;7;1
The Goebbels Experiment;2005;Fresh;95;81;18;1;19;6
The Gold Rush;1925;Certified-Fresh;100;93;50;0;50;10
The Golden Dream (La Jaula De Oro);2015;Fresh;89;86;32;4;36;15
The Golem;2019;Fresh;86;42;24;4;28;2
The Good Catholic;2017;Rotten;46;81;6;7;13;4
The Good Dinosaur;2015;Certified-Fresh;76;65;163;52;215;40
The Good Doctor;2012;Fresh;66;31;19;10;29;11
The Good Lie;2014;Certified-Fresh;88;82;77;11;88;30
The Good Neighbor;2016;Rotten;29;46;4;10;14;3
The Good Postman;1900;Fresh;100;67;6;0;6;1
The Good, the Bad and the Ugly;1966;Certified-Fresh;97;97;72;2;74;15
The Good, the Bad, the Weird (Joheun-nom, Nabbeun-nom, Isanghan-nom);2010;Certified-Fresh;82;83;54;12;66;20
The Gospel of John;2003;Rotten;37;88;18;31;49;17
The Grace Card;2011;Rotten;36;82;10;18;28;14
The Grace of Jake;2017;Fresh;80;69;4;1;5;3
The Gracefield Incident;2017;Rotten;10;16;1;9;10;3
The Grand Budapest Hotel;2014;Certified-Fresh;91;86;280;26;305;64
The Grand Seduction;2014;Rotten;59;66;41;28;69;24
The Grandmaster;2013;Certified-Fresh;78;58;108;30;138;42
The Great Alaskan Race;2019;Rotten;20;;2;8;10;4
The Great Beauty;2013;Certified-Fresh;91;80;120;12;132;34
The Great Buddha+;2018;Fresh;89;83;16;2;18;5
The Great Buster: A Celebration;2018;Certified-Fresh;94;90;44;3;47;13
The Great Escape;1963;Certified-Fresh;94;95;45;3;48;7
The Great Flood;2014;Fresh;93;56;14;1;15;6
The Great Gatsby;2013;Rotten;48;67;143;155;297;57
The Great Gilly Hopkins;2016;Fresh;65;69;11;6;17;8
The Great Hack;2019;Certified-Fresh;87;64;45;7;52;21
The Great Hip Hop Hoax;1900;Fresh;88;70;15;2;17;4
The Great Museum;2015;Fresh;67;42;10;5;15;5
The Great Silence (Il grande silenzio);1968;Fresh;100;90;12;0;12;3
The Great Train Robbery;1979;Fresh;73;68;19;7;26;4
The Great Wall;2017;Rotten;36;42;83;149;232;46
The Great War;2019;Rotten;17;39;1;5;6;4
The Greatest Showman;2017;Rotten;56;86;148;114;262;48
The Green Butchers;2004;Fresh;63;83;17;10;27;13
The Green Inferno;2015;Rotten;38;29;37;61;98;23
The Green Prince;2014;Certified-Fresh;77;83;40;12;52;23
The Greening Of Whitney Brown;2011;Rotten;13;37;2;13;15;10
The Grey;2012;Certified-Fresh;79;61;164;44;208;45
The Grey Zone;2002;Fresh;69;74;59;26;85;27
The Grief of Others;2018;Fresh;92;58;11;1;12;6
Dark Tourist;2013;Rotten;33;30;3;6;9;5
The Grinch;2018;Fresh;60;50;114;76;190;29
The Ground Truth;2006;Certified-Fresh;88;78;42;6;48;16
The Grudge;2004;Rotten;40;46;64;98;162;35
The Grudge;2020;Rotten;20;23;25;98;123;20
The Guard;2011;Certified-Fresh;94;81;129;8;137;39
The Guardian;2006;Rotten;37;80;55;95;150;40
The Guardians (Les Gardiennes);2018;Certified-Fresh;93;55;56;4;60;19
The Guernsey Literary and Potato Peel Pie Society;2018;Certified-Fresh;80;81;57;14;71;13
The Guest;2014;Certified-Fresh;91;69;105;10;115;34
The Guillotines;2013;Rotten;14;16;2;12;14;7
The Guilt Trip;2012;Rotten;37;39;47;81;128;37
The Guilty (Den skyldige);2018;Certified-Fresh;97;88;114;3;117;24
The Gunman;2015;Rotten;16;31;29;149;177;47
The Half of It;1900;Certified-Fresh;97;80;87;3;90;19
The Hallow (The Woods);2015;Fresh;70;43;42;18;60;15
The Hand that Rocks the Cradle;1992;Fresh;63;61;30;18;48;14
The Handmaiden (Ah-ga-ssi);2016;Certified-Fresh;95;91;202;10;212;40
The Hanging Garden;1998;Fresh;94;73;15;1;16;4
The Hangover Part II;2011;Rotten;33;52;82;165;247;56
The Hangover Part III;2013;Rotten;20;44;41;164;205;43
The Happy House;2013;Fresh;60;30;3;2;5;2
The Happy Poet;2013;Fresh;73;51;8;3;11;4
The Happy Prince;2018;Fresh;72;51;98;39;137;30
The Happy Sad;2013;Fresh;71;32;10;4;14;8
The Happytime Murders;2018;Rotten;23;40;57;187;243;44
The Harmonists;1999;Fresh;81;87;30;7;37;11
The Harvest;2015;Fresh;72;42;18;7;25;4
The Hate U Give;2018;Certified-Fresh;97;83;213;7;220;40
The Hateful Eight;2015;Certified-Fresh;75;76;248;85;332;55
The Hatton Garden Job;1900;Rotten;18;19;3;14;17;3
The Haunting in Connecticut 2: Ghosts of Georgia;2013;Rotten;19;44;3;13;16;6
The Unspoken;2016;Rotten;9;34;1;10;11;4
The Haunting of Sharon Tate;2019;Rotten;19;30;6;26;32;6
The Hawks and the Sparrows (Uccellacci e uccellini);1965;Fresh;77;85;10;3;13;4
The Head Hunter;2019;Fresh;100;56;14;0;14;1
The Healer;2018;Rotten;17;56;1;5;6;1
The Heart Machine;2014;Fresh;95;48;20;1;21;7
The Heartbreak Kid;2007;Rotten;28;37;45;113;158;47
The Heat;2013;Fresh;66;71;120;63;183;44
The Hedgehog;2011;Certified-Fresh;87;83;62;9;71;25
The Heir Apparent: Largo Winch;2011;Rotten;53;49;10;9;19;11
The Help;2011;Certified-Fresh;76;89;173;54;227;53
The Hero;2017;Certified-Fresh;78;59;88;25;113;27
The High Cost of Living;2011;Rotten;53;57;8;7;15;6
The High Note;2020;Fresh;70;73;123;53;176;32
The Highwaymen;2019;Rotten;57;73;79;59;138;35
The Hippopotamus;2017;Rotten;57;50;8;6;14;4
The Hitman's Bodyguard;2017;Rotten;43;67;97;126;223;37
The Hobbit: An Unexpected Journey;2012;Fresh;64;83;195;109;304;56
The Hobbit: The Battle of the Five Armies;2014;Rotten;59;74;155;107;261;53
The Hobbit: The Desolation of Smaug;2013;Certified-Fresh;74;85;182;66;247;49
The Hole (Le Trou);1964;Fresh;94;97;16;1;17;6
The Hole in the Ground;2019;Certified-Fresh;83;48;73;15;88;14
The Holiday;2006;Rotten;49;80;77;79;156;42
The Holiday Calendar;1900;Rotten;33;35;2;4;6;0
The Hollars;2016;Rotten;47;59;43;49;92;24
The Hollow;2016;Rotten;40;68;2;3;5;1
The Hollow Point;2016;Rotten;40;31;6;9;15;6
The Homesman;2014;Certified-Fresh;81;52;124;30;153;45
The Honeymoon Phase;2020;Fresh;89;73;8;1;9;0
The Horde (La Horde);2009;Rotten;45;41;9;11;20;7
The Hornet's Nest;2014;Fresh;72;80;13;5;18;6
The Horror of Frankenstein;1971;Rotten;55;42;6;5;11;1
The Horror of H.P. Lovecraft (LovecraCked! The Movie);2006;Rotten;40;31;2;3;5;0
The Horror Show;1989;Rotten;0;27;0;8;8;1
The Horseman;2008;Fresh;60;58;18;12;30;10
The Host;2007;Certified-Fresh;93;72;146;11;157;42
The Host;2013;Rotten;9;49;12;119;131;33
The Host;2020;Rotten;25;82;4;12;16;4
The Hot Flashes;2013;Rotten;36;34;9;16;25;11
The Hours and Times;2019;Fresh;80;59;12;3;15;4
The House;2017;Rotten;20;35;16;65;81;17
The House I Live In;2012;Certified-Fresh;94;85;62;4;66;27
The House of the Devil;2009;Certified-Fresh;85;63;86;15;101;26
The House of the Seven Gables;1900;Fresh;80;80;4;1;5;1
The House of the Spirits;1994;Rotten;30;72;11;26;37;16
The House That Jack Built;2018;Rotten;59;65;78;54;132;30
The House with a Clock in Its Walls;2018;Fresh;66;45;141;74;215;31
The Housemaid;2011;Fresh;69;54;49;22;71;24
The Housemaid (Co Hau Gai);2018;Fresh;71;35;10;4;14;4
The Houses October Built;2014;Fresh;60;30;9;6;15;4
The Houses October Built 2;2017;Rotten;13;48;1;7;8;1
The Human Centipede II (Full Sequence);2011;Rotten;29;23;24;58;82;26
The Human Centipede III (Final Sequence);2015;Rotten;17;11;8;38;46;13
The Human Comedy;1943;Fresh;80;68;4;1;5;0
The Human Experiment;2015;Rotten;50;61;5;5;10;4
The Human Race;2014;Rotten;42;58;5;7;12;3
The Human Resources Manager;2011;Fresh;75;62;24;8;32;8
The Human Scale;2013;Fresh;64;84;7;4;11;6
Human Tornado;1984;Fresh;80;70;4;1;5;0
The Humanity Bureau;2018;Rotten;25;23;2;6;8;2
The Humbling;2015;Rotten;52;28;32;29;61;22
The Hummingbird Project;2019;Rotten;58;48;68;50;118;30
The Hunchback of Notre Dame II;2001;Rotten;30;26;3;7;10;0
The Hundred-Foot Journey;2014;Fresh;67;81;99;48;147;43
The Hunger;1983;Rotten;53;66;17;15;32;5
The Hunger Games;2012;Certified-Fresh;84;81;261;49;310;57
The Hunger Games: Catching Fire;2013;Certified-Fresh;90;89;260;30;290;62
The Hunger Games: Mockingjay - Part 1;2014;Fresh;69;71;205;94;298;57
The Hunger Games: Mockingjay - Part 2;2015;Fresh;69;66;200;88;288;53
The Hungry Ghosts;2010;Rotten;14;62;1;6;7;5
The Hunt;2012;Fresh;83;;5;1;6;1
The Hunt (Jagten);2013;Certified-Fresh;93;93;124;10;134;34
The Hunt;2020;Rotten;57;66;139;107;246;38
The Hunter;2012;Fresh;72;62;68;27;95;23
The Hunter's Prayer;2017;Rotten;33;23;7;14;21;5
The Hunting Ground;2015;Certified-Fresh;93;85;67;5;72;31
The Hunting of the President;2004;Fresh;74;53;42;15;57;23
The Hunting Party;1971;Rotten;20;54;2;8;10;4
The Huntsman: Winter's War;2016;Rotten;19;45;41;174;215;42
The Hurricane Heist;2018;Rotten;47;23;28;31;59;10
The Hurt Locker;2009;Certified-Fresh;97;84;277;8;285;59
The Hustle;2019;Rotten;13;43;22;143;165;28
The Ice Cream Truck;2017;Fresh;72;36;13;5;18;3
The Iceman;2013;Fresh;66;62;84;43;127;37
The Identical;2014;Rotten;6;62;4;65;69;23
The Ides of March;2011;Certified-Fresh;84;73;204;39;243;55
The Illusionist (L'illusionniste);2010;Certified-Fresh;90;79;119;13;132;33
The Imaginarium of Doctor Parnassus;2009;Fresh;64;60;126;71;197;50
The Imitation Game;2014;Certified-Fresh;89;91;251;30;281;60
The Immigrant;2014;Certified-Fresh;85;60;95;17;112;41
The Immortalists;2014;Fresh;67;69;8;4;12;6
The Impossible;2012;Certified-Fresh;81;84;163;38;201;52
The Imposter;2012;Certified-Fresh;95;78;110;6;116;37
The In-Laws;1979;Fresh;88;83;21;3;24;0
The Inbetweeners;2012;Rotten;53;70;27;24;51;17
The Incomparable Rose Hartman;2017;Fresh;75;;6;2;8;5
The Incredible Burt Wonderstone;2013;Rotten;38;33;74;121;194;47
The Incredible Hulk;2008;Fresh;67;70;156;77;233;47
The Incredible Jessica James;1900;Certified-Fresh;88;66;52;7;59;18
The Incredible Mr. Limpet;1964;Rotten;40;60;4;6;10;0
The Incredibly True Adventure of Two Girls in Love;1995;Fresh;64;69;7;4;11;4
The Indian Runner;1991;Fresh;74;81;14;5;19;5
The Inevitable Defeat of Mister & Pete;2013;Fresh;86;88;32;5;37;11
The Infidel;2010;Fresh;60;45;15;10;25;4
The Infiltrator;2016;Fresh;72;71;128;51;179;41
The Infiltrators;2020;Fresh;87;67;27;4;31;11
The Influence (La influencia);1900;Rotten;0;26;0;5;5;0
The Inhabitants;1900;Fresh;71;12;5;2;7;0
The Innkeepers;2012;Certified-Fresh;79;42;96;25;121;38
The Innocent (L'innocente);1979;Fresh;79;81;15;4;19;7
The Institute;2017;Rotten;0;14;0;5;5;2
The Insult (L'insulte);2018;Certified-Fresh;87;89;99;15;114;25
The Intended;2004;Rotten;33;36;9;18;27;12
The Intern;2015;Fresh;60;73;117;78;194;44
The Internet's Own Boy: The Story of Aaron Swartz;2014;Certified-Fresh;93;91;56;4;60;23
The Internship;2013;Rotten;35;51;59;111;170;48
The Interrupters;2011;Certified-Fresh;99;82;92;1;93;32
The Intervention;2016;Certified-Fresh;78;49;40;11;51;13
The Interview;2014;Rotten;52;48;79;72;151;39
The Intouchables;2012;Certified-Fresh;75;93;94;32;126;40
The Intruder;2019;Rotten;33;69;33;66;99;18
The Intruders;1900;Rotten;17;21;1;5;6;0
The Inventor: Out for Blood in Silicon Valley;1900;Certified-Fresh;78;73;47;13;60;20
The Invisible Man;2020;Certified-Fresh;91;88;356;34;390;48
The Invisible War;2012;Certified-Fresh;99;84;71;1;72;25
The Invisible Woman;2013;Certified-Fresh;75;44;118;40;158;51
The Invitation;2016;Certified-Fresh;88;69;93;12;104;23
The Iran Job;2013;Fresh;90;76;19;2;21;9
The Irishman;2019;Certified-Fresh;96;86;421;19;439;53
The Iron Ladies;2001;Rotten;56;72;19;15;34;15
The Iron Lady;2012;Rotten;52;51;122;112;234;55
The Iron Ministry;2015;Fresh;89;50;16;2;18;8
The Island (Ostrov);2007;Fresh;63;81;12;7;19;12
The Island at the Top of the World;1974;Rotten;43;47;3;4;7;3
The Island President;2012;Certified-Fresh;98;77;48;1;49;19
The Isle;2019;Fresh;67;84;6;3;9;2
The Ivory Game;1900;Fresh;81;74;17;4;21;10
The Jack in the Box;1900;Rotten;20;40;1;4;5;0
The Jaundiced Eye;2000;Fresh;100;89;11;0;11;4
The Jeffrey Dahmer Files;2013;Fresh;65;41;17;9;26;11
The Jetsons;;Rotten;27;44;4;11;15;4
The Jewish Cardinal;1900;Fresh;88;71;7;1;8;2
The Jimmy Show;2001;Rotten;40;36;4;6;10;3
The Journey;2017;Fresh;68;64;61;29;90;21
The Judge;2014;Rotten;48;72;95;103;198;49
The Jungle Book;2016;Certified-Fresh;94;86;305;19;323;53
The Jurassic Games;1900;Fresh;71;41;5;2;7;0
The Karate Kid, Part III;1989;Rotten;15;35;5;28;33;9
The Keeper of Lost Causes (Kvinden i buret);2016;Fresh;70;67;19;8;27;8
The Keeping Hours;1900;Fresh;80;71;4;1;5;1
The Kid;2000;Rotten;49;49;49;50;99;26
The Kid;2019;Rotten;45;45;20;24;44;13
The Kid Brother;1927;Fresh;100;86;9;0;9;0
The Kid Who Would Be King;2019;Certified-Fresh;89;56;167;20;187;31
The Kid with a Bike;2012;Certified-Fresh;96;76;126;5;131;41
The Kidnapping of Michel Houellebecq;2015;Fresh;91;66;21;2;23;11
The Kids Are Alright;1979;Fresh;100;88;11;0;11;0
The Kids Grow Up;2010;Rotten;59;77;10;7;17;8
The Kill Hole;2012;Rotten;25;26;2;6;8;5
The Kill Team;2014;Certified-Fresh;90;73;38;4;42;18
The Kill Team;2019;Fresh;70;42;35;15;50;16
The Killer Inside Me;2010;Rotten;55;40;70;58;128;35
The Killing of a Sacred Deer;2017;Certified-Fresh;80;63;220;55;275;45
The Kindergarten Teacher (Haganenet);2015;Fresh;77;45;27;8;35;13
The Kindergarten Teacher;2018;Certified-Fresh;91;68;89;9;98;22
The Kindness of Strangers;2020;Rotten;18;63;5;23;28;11
The King;2006;Rotten;57;66;45;34;79;29
The King;2019;Fresh;71;83;100;41;141;32
The King Is Alive;2001;Fresh;60;57;41;27;68;20
The King of Masks;1999;Fresh;89;91;17;2;19;5
The King of Staten Island;2020;Fresh;74;85;198;70;268;45
The Kingdom;2007;Rotten;51;76;96;92;188;54
The Kingdom of Dreams and Madness;2014;Fresh;92;88;23;2;24;10
The King's Choice;2017;Fresh;84;84;21;4;25;7
The Kings of Summer;2013;Certified-Fresh;76;77;93;29;122;38
The King's Speech;2010;Certified-Fresh;94;92;279;17;296;60
The Kissing Booth;2018;Rotten;17;57;2;10;12;1
The Kitchen;2019;Rotten;24;69;53;172;225;46
The Knight Before Christmas;1900;Fresh;70;42;14;6;20;0
The Knot;2012;Rotten;0;30;0;18;18;4
The L.A. Riot Spectacular;2005;Rotten;38;40;3;5;8;2
The Ladies' Man;1961;Fresh;100;69;10;0;10;1
The Lady;2012;Rotten;36;62;26;46;72;24
The Lady From Shanghai;1948;Certified-Fresh;82;85;37;8;45;13
The Lady In The Van;2015;Certified-Fresh;89;64;132;17;149;45
The Land;2016;Fresh;70;61;14;6;20;7
The Land Before Time III: The Time of Great Giving;1995;Fresh;60;38;3;2;5;0
The Land of Steady Habits;2018;Certified-Fresh;83;47;34;7;41;13
The Last 5 Years;2015;Fresh;60;57;62;41;103;34
The Last American Hero;1973;Fresh;80;49;4;1;5;0
The Last Big Thing;1996;Fresh;67;54;4;2;6;0
The Last Black Man in San Francisco;2019;Certified-Fresh;92;84;189;16;205;41
The Last Days;2014;Fresh;91;49;10;1;11;1
The Last Days On Mars;2013;Rotten;18;25;11;50;61;27
The Last Dragon;1985;Rotten;58;86;11;8;19;7
The Last Exorcism Part II;2013;Rotten;15;26;11;61;72;18
The Last Face;2017;Rotten;8;33;4;44;48;16
The Last Full Measure;2020;Rotten;59;96;42;29;71;24
The Last Gladiators;2013;Fresh;90;80;9;1;10;4
The Last Heist;2016;Rotten;20;12;2;8;10;3
The Last Impresario;1900;Fresh;94;44;15;1;16;5
The Last King;2016;Fresh;89;44;8;1;9;1
The Last Laugh (Der Letzte Mann);1925;Fresh;100;88;28;0;28;3
The Last Laugh;1900;Rotten;53;36;8;7;15;2
The Last Lions;2011;Fresh;87;88;33;5;38;19
The Last Man On The Moon;2016;Certified-Fresh;94;78;44;3;47;19
The Last Metro (Le Dernier Metro);1981;Fresh;86;80;19;3;22;5
The Last Mountain;2011;Certified-Fresh;81;83;34;8;42;19
The Last Movie Star;2018;Rotten;59;72;16;11;27;9
The Last Of Robin Hood;2014;Rotten;27;23;18;48;66;26
The Last of the Unjust;2014;Certified-Fresh;96;78;46;2;48;25
The Last Photograph;1900;Fresh;71;57;5;2;7;2
The Last Race;2018;Fresh;93;61;14;1;15;7
The Last Ride;2012;Rotten;47;52;9;10;19;12
The Last Rites of Joe May;2011;Fresh;74;65;14;5;19;11
The Last Seduction;1994;Certified-Fresh;94;76;48;3;51;13
The Last Sentence;2014;Fresh;74;41;23;8;31;15
The Last September;2000;Rotten;42;33;10;14;24;6
The Last Sharknado: It's About Time;1900;Rotten;27;38;3;8;11;4
The Last Shot;2004;Fresh;62;32;42;26;68;21
The Last Starfighter;1984;Fresh;74;69;23;8;31;2
The Last Suit (El ultimo traje);2018;Fresh;78;90;18;5;23;6
The Last Summer;1900;Rotten;17;24;1;5;6;0
The Last Survivors (The Well);2014;Fresh;75;;9;3;12;2
The Last Thing He Wanted;2020;Rotten;5;13;3;53;56;14
The Last Waltz;1978;Certified-Fresh;98;94;49;1;50;16
The Last Witch Hunter;2015;Rotten;18;43;24;112;136;33
The Last Witness;2018;Rotten;33;64;2;4;6;0
The Last Word;2017;Rotten;40;64;38;57;95;26
The Late Bloomer;2016;Rotten;20;22;2;8;10;5
The Laundromat;2019;Rotten;41;40;68;99;167;31
The Law In These Parts;2012;Fresh;88;79;14;2;16;9
The Laws of Thermodynamics (Las Leyes de la Termodinamica);1900;Rotten;46;40;6;7;13;3
The Layover;2017;Rotten;0;22;0;18;18;6
The Lazarus Effect;2015;Rotten;16;23;17;90;107;28
The League of Gentlemen;1959;Fresh;86;84;6;1;7;0
The Ledge;2011;Rotten;14;48;4;25;29;12
The Legacy of a Whitetail Deer Hunter;1900;Rotten;30;42;7;16;23;7
The Legend Of 420;2017;Fresh;83;94;5;1;6;2
The Legend of Ben Hall;2016;Rotten;50;76;6;6;12;3
The Legend of Cocaine Island;1900;Fresh;78;65;14;4;18;5
The Legend of Hercules;2014;Rotten;4;33;3;79;82;17
The Legend of Tarzan;2016;Rotten;36;58;90;163;253;51
The Legion;2020;;;;0;5;;1
The Lego Batman Movie;2017;Certified-Fresh;90;80;279;32;310;60
The LEGO Movie;2014;Certified-Fresh;96;87;240;11;250;51
The LEGO Movie 2: The Second Part;2019;Certified-Fresh;85;68;248;45;293;46
The Lego Ninjago Movie;2017;Rotten;56;46;75;59;134;30
The Leisure Seeker;2018;Rotten;38;56;41;67;108;30
The Leopard;1963;Certified-Fresh;98;89;46;1;47;20
The Lesser Blessed;1900;Rotten;50;58;3;3;6;3
The Letters;2015;Rotten;29;66;11;27;38;9
The Levelling;2017;Fresh;94;57;32;2;34;9
The Liability;1900;Fresh;61;35;11;7;18;5
The Liberator;2014;Rotten;38;65;10;16;26;11
The Lie;2011;Fresh;74;48;14;5;19;10
The Life and Times of Hank Greenberg;2000;Certified-Fresh;97;80;63;2;65;22
The Lifeguard;2013;Rotten;16;26;5;27;32;13
The Light Between Oceans;2016;Fresh;61;61;142;90;231;44
The Lighthouse;2019;Certified-Fresh;90;72;335;38;373;45
The Limehouse Golem;2017;Certified-Fresh;74;55;57;20;77;18
The Lion King;1994;Certified-Fresh;93;93;120;9;129;29
The Lion King;2019;Rotten;52;88;219;205;424;52
The Lion King II: Simba's Pride;1998;Fresh;62;60;8;5;13;4
The Lion of Judah;2011;Rotten;0;62;0;6;6;2
The Little Death;2015;Fresh;61;64;35;22;57;18
The Little Hours;2017;Certified-Fresh;78;49;99;28;127;28
The Little Mermaid;1989;Certified-Fresh;93;88;66;5;71;14
The Little Mermaid 2: Return to the Sea;2000;Rotten;17;45;1;5;6;0
The Little Rascals;1994;Rotten;23;70;3;10;13;1
The Little Stranger;2018;Fresh;65;36;91;49;140;31
The Little Vampire 3D;1900;Rotten;14;53;2;12;14;3
The Lives of Others;2006;Certified-Fresh;93;96;149;12;161;54
The Living;2015;Rotten;50;35;4;4;8;3
The Living End;1992;Rotten;57;61;4;3;7;1
The Lobster;2016;Certified-Fresh;87;65;226;34;260;45
The Lodgers;2018;Rotten;56;39;25;20;45;8
The Loft;2015;Rotten;14;37;6;36;42;12
The Lone Ranger;2013;Rotten;30;51;75;171;246;50
The Loneliest Planet;2012;Fresh;74;31;48;17;65;22
The Lonely Island Presents: The Unauthorized Bash Brothers Experience;1900;Fresh;100;;12;0;12;4
The Long Dumb Road;2018;Fresh;75;51;21;7;28;9
The Long Good Friday;1982;Fresh;96;89;27;1;28;9
The Longest Ride;2015;Rotten;31;71;38;86;124;37
The Longest Week;2014;Rotten;10;21;2;18;20;7
The Look of Love;2013;Rotten;54;34;40;34;74;22
The Look of Silence;2015;Certified-Fresh;96;89;131;5;136;36
The Lookalike;2014;Rotten;20;48;1;4;5;2
Dr Seuss' The Lorax;2012;Rotten;54;63;84;73;157;37
The Lord of the Rings: The Fellowship of the Ring;2001;Certified-Fresh;91;95;213;20;233;48
The Lord of the Rings: The Return of the King;2003;Certified-Fresh;93;86;257;18;275;53
The Lord of the Rings: The Two Towers;2002;Certified-Fresh;95;95;243;12;255;52
The Lords of Salem;2013;Rotten;46;30;30;35;65;20
The Lost Bladesman (Guan yun chang);1900;Rotten;57;36;4;3;7;1
The Lost City of Z;2017;Certified-Fresh;87;57;212;33;245;51
The Lost Husband;1900;Rotten;55;65;12;10;22;5
The Love Letter;1999;Rotten;33;38;17;34;51;18
The Love Punch;2014;Rotten;29;31;16;40;56;22
The Love We Make;1900;Fresh;82;58;9;2;11;5
The Love Witch;2016;Certified-Fresh;95;61;105;5;110;28
The Loved Ones;2012;Certified-Fresh;98;73;56;1;57;7
The Lovers;2015;Rotten;8;20;1;12;13;6
The Lovers And The Despot;2016;Certified-Fresh;79;53;59;16;75;21
The Loving Story;2012;Fresh;100;84;19;0;19;7
The Low Life;1996;Rotten;56;36;5;4;9;2
The Lucky One;2012;Rotten;20;67;30;118;148;38
The Lullaby;2018;Fresh;67;74;8;4;12;3
The Lunchbox;2014;Certified-Fresh;97;87;113;4;117;30
The Machine;2014;Fresh;79;46;26;7;33;9
The Machine Which Makes Everything Disappear;2013;Fresh;64;82;9;5;14;8
The MacKintosh Man;1973;Rotten;58;44;7;5;12;5
The Maestro;2019;Fresh;80;;4;1;5;3
The Magic Christian;1970;Rotten;59;68;10;7;17;4
The Magic of Belle Isle;2012;Rotten;29;62;10;24;34;16
The Magician (Ansiktet);1958;Fresh;100;85;11;0;11;2
The Magnificent Seven;2016;Fresh;64;72;199;112;311;54
The Main Event;1900;Rotten;26;23;5;14;19;6
The Man From Earth: Holocene;2017;Rotten;50;57;3;3;6;2
The Man From London (A Londoni Ferfi);2007;Fresh;69;61;22;10;32;13
The Man from Planet X;1951;Fresh;100;38;7;0;7;0
The Man From U.N.C.L.E.;2015;Fresh;67;73;195;94;288;48
The Man Nobody Knew: In Search of My Father, CIA Spymaster William Colby;2011;Fresh;84;62;21;4;25;13
The Man on the Train (L'homme du train);2003;Certified-Fresh;92;79;106;9;115;36
The Man Standing Next;1900;Fresh;75;100;6;2;8;2
The Man Who Invented Christmas;2017;Certified-Fresh;79;77;135;36;171;29
The Man Who Killed Don Quixote;2019;Fresh;64;63;78;44;122;26
The Man Who Killed Hitler and Then The Bigfoot;2019;Certified-Fresh;75;50;70;23;93;15
The Man Who Knew Infinity;2016;Fresh;63;71;81;48;129;34
The Man Who Knew Too Much;1935;Fresh;88;68;30;4;34;5
The Man Who Knew Too Much;1956;Fresh;87;84;33;5;38;6
The Man Who Shook The Hand of Vincente Fernandez;2012;Rotten;40;68;2;3;5;3
The Man with Rain in His Shoes (Twice Upon a Yesterday);1998;Rotten;29;53;6;15;21;3
The Man With the Golden Arm;1955;Fresh;86;84;19;3;22;5
The Man With the Iron Fists;2012;Rotten;51;40;44;42;86;18
The Mandela Effect;2019;Rotten;20;77;1;4;5;2
The Marriage Circle;1924;Fresh;100;88;6;0;6;2
The Marriage of Maria Braun (Die Ehe der Maria Braun);1979;Fresh;92;90;23;2;25;5
The Martian;2015;Certified-Fresh;91;91;340;34;374;60
The Mask You Live In;1900;Fresh;60;74;3;2;5;1
The Masked Saint;2016;Rotten;14;62;1;6;7;4
The Master;2012;Certified-Fresh;85;61;214;39;253;56
The Maze Runner;2014;Fresh;65;68;111;60;171;42
The Meddler;2016;Certified-Fresh;85;56;121;22;143;38
The Meg;2018;Rotten;46;42;137;164;300;44
The Memory Thief;2007;Fresh;80;41;12;3;15;8
The Mercy;2018;Fresh;74;33;61;21;82;15
The Messenger;2015;Fresh;83;60;10;2;12;6
The Messengers;2007;Rotten;12;44;10;74;84;23
The Meyerowitz Stories (New and Selected);2017;Certified-Fresh;92;72;169;14;183;41
The Midnight Man;2018;Rotten;30;32;3;7;10;2
The Midwife (Sage femme);2017;Certified-Fresh;88;78;78;11;89;27
The Mighty Macs;2011;Rotten;47;64;24;27;51;17
The Mill and the Cross;2011;Certified-Fresh;79;64;33;9;42;18
The Mind's Eye;2016;Fresh;62;35;16;10;26;8
The Miners' Hymns;2012;Fresh;100;100;10;0;10;5
The Miracle Season;2018;Rotten;51;83;23;22;45;16
The Mirror;1975;Fresh;100;92;17;0;17;6
The Miseducation of Cameron Post;2018;Certified-Fresh;86;76;160;26;186;40
The Missing Picture;2014;Certified-Fresh;99;76;87;1;88;30
The Mole Agent;1900;Fresh;95;;38;2;40;5
The Moment;2014;Rotten;11;5;1;8;9;5
The Monitor (Babycall);2012;Fresh;75;36;18;6;24;5
The Monkey King 2 (San Da Bai Gu Jing);2014;Fresh;100;51;5;0;5;1
The Monkey King 3;2018;Rotten;33;48;2;4;6;3
The Monster;2016;Certified-Fresh;81;40;39;9;48;10
The Monster Project;2017;Rotten;50;45;3;3;6;2
The Monuments Men;2014;Rotten;30;44;76;177;253;58
The Mortal Instruments: City of Bones;2013;Rotten;13;58;17;109;126;36
The Most Assassinated Woman in the World (La femme la plus assassinee du monde);2018;Fresh;86;33;6;1;7;0
The Most Dangerous Year;2019;Fresh;91;100;10;1;11;3
The Most Hated Woman In America;2017;Rotten;36;39;8;14;22;8
The Motel Life;2013;Fresh;70;43;30;13;43;20
The Moth Diaries;2012;Rotten;13;23;6;40;46;12
The Motive (El autor);2018;Fresh;60;51;12;8;20;3
The Motorcycle Diaries;2004;Certified-Fresh;83;92;130;27;157;41
The Mountain Between Us;2017;Rotten;38;47;65;106;171;46
The Mule;2018;Fresh;70;66;133;56;189;36
The Mummy;2017;Rotten;16;35;49;261;310;50
The Muppets;2011;Certified-Fresh;95;80;216;12;228;51
The Murder of Nicole Brown Simpson;2020;Rotten;0;4;0;9;9;3
The Music Never Stopped;2011;Fresh;67;81;33;16;49;15
The Music of Silence;2018;Rotten;0;81;0;17;17;4
The Music of Strangers: Yo-Yo Ma and the Silk Road Ensemble;2016;Certified-Fresh;84;84;48;9;57;19
The Mustang;2019;Certified-Fresh;95;74;124;7;131;32
The Naked Gun 33 1/3: The Final Insult;1994;Rotten;54;53;19;16;35;7
The Naked Gun: From the Files of Police Squad!;1988;Certified-Fresh;88;84;50;7;57;11
The Naked Island (Hadaka no shima);1960;Fresh;100;85;7;0;7;2
The Naked Kiss;1964;Fresh;93;81;13;1;14;0
The Name of the Rose (Der Name der Rose);1986;Fresh;74;84;17;6;23;2
The Nameless (Los sin nombre);2005;Rotten;20;41;1;4;5;0
The Natural History of the Chicken;2001;Fresh;60;76;3;2;5;0
The Neighbor;1900;Fresh;67;35;4;2;6;3
The Neon Demon;2016;Rotten;59;51;149;106;254;48
The Neverending Story;1984;Certified-Fresh;80;81;33;8;41;5
The Neverending Story II: The Next Chapter;1991;Rotten;14;40;1;6;7;0
The New Girlfriend;2015;Certified-Fresh;81;61;67;16;83;23
The New Radical;2017;Rotten;58;67;7;5;12;7
The New Romantic;2018;Fresh;62;37;18;11;29;7
The Newspaperman: The Life and Times of Ben Bradlee;1900;Fresh;94;80;16;1;17;6
The Nice Guys;2016;Certified-Fresh;92;79;288;26;313;55
The Night Before;2015;Fresh;68;61;107;50;156;38
The Night Clerk;2020;Rotten;36;31;16;29;45;8
The Night Comes For Us;2018;Fresh;91;83;29;3;32;3
The Night Eats the World (La nuit a devore le monde);2018;Certified-Fresh;86;56;37;6;43;8
The Night Listener;2006;Rotten;40;35;54;82;136;36
The Night of the Virgin (La noche del virgen);1900;Rotten;50;33;6;6;12;0
The Night Sitter;1900;Fresh;78;58;7;2;9;0
The Night Visitor;1971;Rotten;13;50;1;7;8;2
The Night Watchmen;1900;Fresh;86;74;6;1;7;0
The Night We Never Met;1993;Rotten;56;37;5;4;9;1
The Nightingale (Ye Ying - Le promeneur d'oiseau);1900;Fresh;90;57;9;1;10;3
The Nightmare;2015;Fresh;67;43;41;20;61;20
The Nine Muses;2011;Fresh;75;;12;4;16;7
The Nines;2007;Fresh;65;61;39;21;60;20
The Normal Heart;1900;Certified-Fresh;94;88;47;3;50;24
The November Man;2014;Rotten;35;46;45;85;130;30
The Number 23;2007;Rotten;8;56;15;175;190;49
The Numbers Station;2013;Rotten;30;31;8;19;27;7
The Nun;2018;Rotten;25;35;50;152;202;24
The Nun's Story;1959;Fresh;94;82;15;1;16;3
The Nut Job;2014;Rotten;13;43;12;84;96;30
The Nut Job 2: Nutty by Nature;2017;Rotten;14;43;9;54;63;17
The Nutcracker and the Four Realms;2018;Rotten;32;34;65;137;202;34
The Oath;2018;Fresh;63;40;57;34;91;23
The Occupant (Hogar);1900;Fresh;61;47;14;9;23;1
The Odd Life of Timothy Green;2012;Rotten;36;67;47;84;131;34
The Odd Way Home;2014;Rotten;20;67;1;4;5;4
The Odyssey (L'odyssee);1900;Fresh;63;52;12;7;19;4
The Old Man & the Gun;2018;Certified-Fresh;93;62;248;19;267;48
The One;2001;Rotten;14;51;12;74;86;25
The One I Love;2014;Certified-Fresh;82;76;76;17;93;32
The Ones Below;2016;Certified-Fresh;76;47;37;12;49;14
The Only Real Game;2014;Fresh;100;65;7;0;7;5
The Oogieloves in The Big Balloon Adventure;2012;Rotten;30;63;7;16;23;9
The Open House;2018;Rotten;15;8;2;11;13;1
The Optimists;1973;Fresh;86;71;6;1;7;4
The Oranges;2012;Rotten;31;32;24;54;78;30
The Order;2003;Rotten;8;38;5;55;60;13
The Order of Myths;2008;Fresh;100;70;32;0;32;11
The Orphanage;2007;Certified-Fresh;87;86;154;23;177;43
The Osiris Child: Science Fiction Volume One;2017;Fresh;62;47;13;8;21;5
The Other Dream Team;2012;Fresh;88;88;28;4;32;18
The Other F Word;2011;Fresh;78;82;28;8;36;13
The Other Lamb;2020;Certified-Fresh;75;34;75;25;100;14
The Other Man: F.W. de Klerk and the End of Apartheid;2015;Rotten;50;33;3;3;6;4
The Other Side of Everything (Druga strana svega);1900;Fresh;91;83;10;1;11;5
The Other Side of Heaven;2001;Rotten;30;74;13;30;43;14
The Other Side of the Door;2016;Rotten;35;29;13;24;37;9
The Other Side of the Wind;2018;Certified-Fresh;84;58;82;16;98;24
The Other Son;2012;Certified-Fresh;79;78;41;11;52;22
The Other Woman;2011;Rotten;39;45;18;28;46;18
The Other Woman;2014;Rotten;25;57;42;124;166;40
The Ottoman Lieutenant;2017;Rotten;19;51;7;29;36;12
The Out-of-Towners;1999;Rotten;27;31;10;27;37;6
The Outcasts;2017;Rotten;56;47;5;4;9;3
The Outlaw;1943;Fresh;73;31;8;3;11;1
The Outpost;2020;Certified-Fresh;92;83;83;7;90;17
The Outrageous Sophie Tucker;2015;Fresh;74;61;14;5;19;11
The Outsider;2014;Rotten;5;12;1;19;20;9
The Outsider;1900;Rotten;17;68;4;19;23;7
The Outsider;2019;Rotten;47;37;8;9;17;1
The Overnight;2015;Certified-Fresh;83;54;109;23;132;36
The Overnighters;2014;Certified-Fresh;97;85;71;2;73;26
The Overture;2005;Fresh;60;86;3;2;5;2
The Owl and the Pussycat;1970;Fresh;80;66;8;2;10;0
The Owners;2020;Fresh;64;31;25;14;39;3
The Pack;2016;Rotten;55;18;6;5;11;3
The Package;1900;Rotten;42;50;8;11;19;2
The Pact;2012;Fresh;66;41;27;14;41;13
The Pact II;2014;Rotten;23;13;3;10;13;4
The Painted Bird;2020;Certified-Fresh;81;58;80;19;99;23
The Painter and the Thief;2020;Certified-Fresh;97;78;94;3;97;24
The Pajama Game;1957;Fresh;91;64;10;1;11;0
The Pale Door;2020;Rotten;51;64;18;17;35;3
The Paperboy;2012;Rotten;45;33;65;81;146;44
The Parking Lot Movie;2010;Fresh;78;79;7;2;9;3
The Parting Glass;1900;Fresh;100;53;7;0;7;3
The Parts You Lose;2019;Fresh;67;57;12;6;18;4
The Party;2018;Certified-Fresh;82;61;129;29;158;33
The Party's Over;2001;Rotten;56;68;9;7;16;5
The Passion of Anna (En Passion);1970;Fresh;100;85;14;0;14;5
The Patience Stone;2013;Certified-Fresh;85;75;52;9;61;27
The Patrol;1900;Fresh;64;32;7;4;11;4
The Patsy;1964;Fresh;82;63;9;2;11;0
The Pawnbroker;1965;Fresh;82;87;14;3;17;1
The Peanut Butter Falcon;2019;Certified-Fresh;96;96;201;9;210;25
The Peanuts Movie;2015;Certified-Fresh;87;76;172;25;197;45
The People I've Slept With;2010;Rotten;27;37;3;8;11;6
The People vs. George Lucas;2011;Fresh;72;69;18;7;25;8
The Perfect Age of Rock 'n' Roll;2011;Rotten;0;50;0;14;14;8
The Perfect Date;1900;Fresh;65;36;11;6;17;2
The Perfect Family;2012;Rotten;50;36;17;17;34;17
The Perfect Guy;2015;Rotten;18;51;8;37;45;15
The Perfect Match;2016;Rotten;22;44;4;14;18;7
The Perfect Weapon;1991;Rotten;45;65;5;6;11;2
The Perfection;1900;Certified-Fresh;72;57;66;26;92;14
The Perks of Being a Wallflower;2012;Certified-Fresh;86;89;143;23;166;46
The Pervert's Guide To Ideology;2013;Fresh;93;78;27;2;29;13
The Petrified Forest;1936;Fresh;100;79;13;0;13;0
The Phantom Carriage;1920;Fresh;100;90;15;0;15;1
The Phenom;2016;Certified-Fresh;79;38;37;10;47;16
The Photograph;2020;Fresh;74;81;79;28;107;30
The Piano Tuner of Earthquakes;2006;Rotten;45;58;18;22;40;16
The Pill;2011;Fresh;70;56;7;3;10;5
The Pillow Book;1997;Fresh;67;81;36;18;54;19
The Pinochet Case;2002;Fresh;94;89;16;1;17;9
The Pirate Fairy;2014;Fresh;81;70;17;4;21;6
The Pirates;2014;Rotten;57;51;4;3;7;4
The Pirates! Band of Misfits;2012;Certified-Fresh;86;60;132;21;153;35
The Place Beyond The Pines;2013;Certified-Fresh;78;75;174;49;223;51
The Plague Dogs;1983;Rotten;57;89;4;3;7;2
The Plagues of Breslau (Plagi Breslau);1900;Fresh;83;50;5;1;6;3
The Platform (El Hoyo);1900;Certified-Fresh;79;72;72;19;91;10
The Playroom;2013;Rotten;54;55;13;11;24;12
The Pleasures Of Being Out Of Step;2014;Fresh;100;57;16;0;16;8
The Poison Rose;2019;Rotten;0;24;0;6;6;4
The Polka King;1900;Fresh;66;49;23;12;35;6
The Pollinators;1900;Fresh;75;;6;2;8;2
The Pool;2008;Certified-Fresh;96;73;45;2;47;25
The Possession;2012;Rotten;39;48;39;60;99;24
The Possession Experiment;1900;Rotten;20;9;1;4;5;0
The Possession of Hannah Grace;2018;Rotten;18;28;10;45;55;7
The Possession of Michael King;2014;Rotten;32;39;6;13;19;7
The Post;2018;Certified-Fresh;88;73;350;48;398;54
The Postcard Killings;2020;Rotten;24;37;5;16;21;4
The Power Of Few;2013;Rotten;50;39;4;4;8;2
The Predator;2018;Rotten;32;33;93;195;288;39
The Preppie Connection;2016;Rotten;11;50;1;8;9;7
The President;2016;Fresh;84;69;21;4;25;14
The Pretty One;2014;Rotten;50;45;17;17;34;11
The Prey;2020;Fresh;73;;16;6;22;2
The Price;2017;Fresh;78;42;14;4;18;6
The Price of Desire;1900;Rotten;25;;3;9;12;3
The Prince;2014;Rotten;0;23;0;10;10;4
The Prince (El Principe);1900;Fresh;92;86;12;1;13;2
The Prince & Me;2004;Rotten;28;59;35;88;123;36
The Princess and the Cobbler (The Thief and the Cobbler);1993;Rotten;50;74;4;4;8;2
The Princess Switch;1900;Fresh;75;48;9;3;12;1
The Principal;1987;Rotten;50;51;5;5;10;0
The Prodigy;2019;Rotten;41;36;33;47;80;17
The Professor;2019;Rotten;10;76;2;18;20;8
The Professor and the Madman;2019;Rotten;43;78;13;17;30;5
The Program;2016;Fresh;62;43;67;41;108;22
The Promise;2017;Rotten;51;92;81;79;160;36
The Prophecy II;1998;Rotten;33;44;2;4;6;0
Kahlil Gibran's The Prophet;2015;Fresh;65;75;47;25;72;17
The Pruitt-igoe Myth: An Urban History;2012;Fresh;86;82;19;3;22;9
The Public;2019;Fresh;65;79;62;33;95;19
The Puffy Chair;2005;Certified-Fresh;77;62;40;12;52;21
The Punk Singer;2013;Certified-Fresh;91;83;60;6;66;22
The Purge;2013;Rotten;40;36;61;93;154;38
The Purge: Anarchy;2014;Rotten;57;56;80;60;140;29
The Purge: Election Year;2016;Rotten;56;48;90;70;160;34
The Pyramid;2014;Rotten;14;21;6;38;44;14
The Quake (Skjelvet);2018;Fresh;85;54;33;6;39;6
The Quarry;2020;;;;19;27;;10
The Queen;1968;Fresh;96;62;22;1;23;6
The Queen of Spain (La reina de Espana);2017;Rotten;31;35;8;18;26;9
The Queen of Versailles;2012;Certified-Fresh;95;73;111;6;117;37
The Quest of Alain Ducasse (La Quete d'Alain Ducasse);2018;Fresh;69;;9;4;13;4
The Quiet;2006;Rotten;22;51;21;74;95;27
The Quiet Family (Choyonghan kajok);1998;Fresh;80;79;4;1;5;0
The Quiet One;2019;Fresh;65;91;22;12;34;15
The Quiet Ones;2014;Rotten;37;25;31;53;84;20
The Quiet Room;1997;Fresh;80;72;4;1;5;1
The Rabbi's Cat;2012;Fresh;94;75;15;1;16;8
The Rachel Divide;2018;Fresh;72;60;18;7;25;14
The Rage in Placid Lake;2004;Rotten;56;80;9;7;16;5
The Raid 2;2014;Certified-Fresh;81;87;142;34;176;40
The Raid: Redemption;2012;Certified-Fresh;86;87;144;23;167;38
The Railway Man;2014;Fresh;66;68;83;42;125;39
The Rainbow Bridge Motel;1900;Rotten;33;;2;4;6;0
The Rainbow Experiment;1900;Rotten;56;80;5;4;9;1
The Rambler;2013;Rotten;33;35;4;8;12;5
The Rape Of Recy Taylor;2017;Fresh;94;64;33;2;35;14
The Raven;2012;Rotten;22;46;31;110;141;31
The Real Blonde;1998;Rotten;34;38;10;19;29;8
The Real Dirt on Farmer John;2007;Certified-Fresh;88;78;37;5;42;16
The Reckoning: Hollywood's Worst Kept Secret;1900;Fresh;80;;4;1;5;2
The Red Pill;2016;Rotten;29;92;2;5;7;3
The Red Sea Diving Resort;1900;Rotten;29;78;12;29;41;8
The Red Turtle (La tortue rouge);2017;Certified-Fresh;93;80;154;11;165;38
The Red Violin (Le violon rouge);1999;Fresh;74;91;31;11;42;7
The Reef;2010;Fresh;80;41;16;4;20;1
The Reflecting Skin;;Fresh;88;78;14;2;16;0
The Reluctant Fundamentalist;2013;Rotten;57;61;56;43;99;34
The Remaining;2014;Fresh;60;38;6;4;10;3
The Remarkable Life of John Weld;1900;Rotten;38;;3;5;8;0
The Rental;2020;Certified-Fresh;75;45;132;43;175;21
The Rescuers;1977;Fresh;81;68;25;6;31;4
The Rest of Us;2020;Fresh;90;80;9;1;10;2
The Resurrection of Gavin Stone;2017;Rotten;50;83;6;6;12;4
The Retrieval;2014;Fresh;93;73;26;2;28;10
The Return;2004;Certified-Fresh;96;93;85;4;89;34
The Return of Jafar;1994;Rotten;33;40;4;8;12;1
The Return of Martin Guerre (Le Retour de Martin Guerre);1982;Fresh;100;80;16;0;16;1
The Return of the Vampire;1944;Fresh;75;34;6;2;8;0
The Returned;2014;Rotten;58;37;11;8;19;6
The Revenant;2012;Rotten;58;50;15;11;26;10
The Revenant;2015;Certified-Fresh;78;84;311;86;397;53
The Revisionaries;2012;Fresh;92;75;12;1;13;8
The Revival;2018;Fresh;78;42;7;2;9;2
The Rewrite;2015;Fresh;66;42;41;21;62;23
The Rhythm Section;2020;Rotten;28;44;48;122;170;33
The Rider;2018;Certified-Fresh;97;83;177;5;182;36
The Right Kind of Wrong;2014;Rotten;17;37;3;15;18;6
The Riot Act;2018;Fresh;63;83;12;7;19;0
The Riot Club (Posh);2015;Fresh;67;43;46;23;69;22
The Rise (Wasteland);2013;Fresh;60;63;15;10;25;9
The Rise and Rise of Bitcoin;2014;Fresh;67;79;6;3;9;4
The Rite;2011;Rotten;21;40;37;136;173;38
The Ritual;1900;Fresh;73;60;66;24;90;12
The River;1959;Fresh;92;79;22;2;24;5
The Road;2012;Fresh;65;59;11;6;17;9
The Road to Fame;1900;Fresh;100;;5;0;5;2
The Road to Wellville;1994;Rotten;41;44;7;10;17;4
The Road Within;2015;Rotten;45;69;9;11;20;7
The Robber;2011;Fresh;79;66;26;7;33;13
The Rocket;2014;Certified-Fresh;95;83;61;3;64;17
The Rocky Horror Picture Show: Let's Do the Time Warp Again;2016;Rotten;28;25;11;29;40;18
The Roommate;2011;Rotten;3;27;3;83;86;20
The Rover;2014;Fresh;66;51;111;57;168;48
The Royal Tenenbaums;2002;Certified-Fresh;80;89;169;41;210;49
The Ruins;2008;Rotten;48;30;46;50;96;17
The Rules of the Game (La regle du jeu);1950;Certified-Fresh;96;90;48;2;50;14
The Runaways;2010;Fresh;69;55;131;58;189;51
The Rundown;2003;Fresh;69;66;106;47;153;37
The Runner;2015;Rotten;24;22;9;29;38;17
The Russian Woodpecker;2015;Fresh;96;67;24;1;25;10
The Sacrament;2014;Fresh;63;47;45;26;71;18
The Sacrifice;1986;Certified-Fresh;86;90;36;6;42;14
The Salesman (Forushande);2017;Certified-Fresh;96;84;189;7;196;48
The Salt of the Earth;2015;Certified-Fresh;95;90;89;5;94;33
The Salvation;2015;Fresh;72;62;58;22;79;24
The Samaritan;2012;Rotten;26;40;9;26;35;18
The Santa Clause 2;2002;Rotten;56;42;68;54;122;34
The Sapphires;2013;Certified-Fresh;91;76;125;12;137;41
The Sasquatch Gang;2007;Rotten;46;57;6;7;13;5
The Savage Innocents;1961;Fresh;69;74;9;4;13;4
The Scarlet Pimpernel;1935;Fresh;89;74;8;1;9;0
The Scheme;1900;Fresh;88;83;7;1;8;5
The School of Flesh;1998;Fresh;68;58;13;6;19;4
The Science of Sleep;2006;Fresh;70;81;115;49;164;45
The Scorpio File;1973;Fresh;67;41;6;3;9;1
The Scribbler;2014;Rotten;50;38;7;7;14;3
The Sea;1900;Rotten;52;39;11;10;21;9
The Sea of Trees;2016;Rotten;17;42;9;43;52;17
The Seagull;2018;Fresh;67;46;84;41;125;37
The Seasoning House;1900;Rotten;21;41;3;11;14;4
The Seasons in Quincy: Four Portraits of John Berger;2016;Fresh;71;48;17;7;24;11
The Second Best Exotic Marigold Hotel;2015;Fresh;65;59;122;65;187;49
The Second Mother (Que Horas Ela Volta?);2015;Certified-Fresh;97;89;87;3;90;27
The Secret: Dare to Dream;2020;Rotten;29;82;14;35;49;12
The Secret Garden;1900;Fresh;65;46;53;29;82;17
The Secret Life of Pets;2016;Certified-Fresh;73;62;169;63;232;48
The Secret Life of Pets 2;2019;Fresh;60;90;96;63;159;22
The Secret Life Of Walter Mitty;2013;Rotten;52;71;100;95;194;47
The Secret Life of Words;2006;Fresh;69;86;27;12;39;15
The Secret Lives Of Dorks;2013;Rotten;11;40;1;8;9;4
The Secret of the Sword;1985;Fresh;60;79;3;2;5;3
The Secret Scripture;2017;Rotten;36;69;14;25;39;9
The Secret World of Arrietty;2012;Certified-Fresh;95;85;143;8;151;39
The Selfish Giant;2013;Certified-Fresh;98;81;83;2;85;30
The Sensation of Sight;2008;Rotten;50;58;3;3;6;3
The Sense Of An Ending;2017;Certified-Fresh;75;51;90;30;120;32
The Sentence;2018;Fresh;90;89;18;2;20;5
The Sentinel;1977;Rotten;45;44;9;11;20;3
The Sergeant;1969;Rotten;20;;1;4;5;1
The Sessions;2012;Certified-Fresh;91;80;185;18;203;54
The Seven Five;2015;Fresh;83;85;24;5;29;13
The Seventh Dwarf;2015;Rotten;22;29;2;7;9;5
The Seventh Fire;2016;Fresh;92;53;24;2;26;13
The Shack;2017;Rotten;21;77;15;57;72;20
Calm with Horses (The Shadow of Violence);2020;Certified-Fresh;94;68;61;4;65;13
The Shallows;2016;Certified-Fresh;78;59;171;48;219;37
The Shanghai Gesture;1942;Fresh;100;71;5;0;5;0
The Shape of Water;2017;Certified-Fresh;92;72;414;34;448;59
The Sharks (Los tiburones);1900;Fresh;86;;18;3;21;3
The Shed;2019;Fresh;65;38;13;7;20;3
The Shop On Main Street (Obchod na Korze);1966;Fresh;100;94;14;0;14;0
The Short Game;2013;Fresh;84;85;16;3;19;8
The Short History of the Long Road;2020;Fresh;91;88;30;3;33;7
The Siege of Jadotville;1900;Fresh;64;74;7;4;11;2
The Signal;2014;Fresh;61;38;55;36;90;31
The Silence;2013;Certified-Fresh;88;71;35;5;40;21
The Silence;2019;Rotten;30;25;10;23;33;4
The Silencing;2020;Rotten;18;90;4;18;22;2
The (Silent) War (Sordo);1900;Rotten;56;9;5;4;9;1
The Similars (Los Parecidos);2016;Fresh;95;49;19;1;20;3
The Singing Forest;2003;Rotten;0;7;0;9;9;6
The Singing Revolution;2007;Fresh;83;82;30;6;36;16
The Single Moms Club;2014;Rotten;18;58;5;23;28;14
The Sisterhood Of Night;2015;Fresh;80;65;16;4;20;8
The Sisters Brothers;2018;Certified-Fresh;87;68;177;27;204;40
The Sitter;2011;Rotten;22;39;25;87;112;35
The Skeleton Twins;2014;Certified-Fresh;87;69;144;22;166;47
The Skin I Live In;2011;Certified-Fresh;81;84;142;34;176;50
The Sleepwalker;2014;Rotten;43;26;6;8;14;7
The Smurfs;2011;Rotten;21;44;25;94;119;31
The Smurfs 2;2013;Rotten;14;56;13;82;95;32
The Snow Queen;2013;Rotten;0;65;0;7;7;2
The Snowman;1982;Fresh;80;91;4;1;5;2
The Snowman;2017;Rotten;7;18;13;183;196;40
The Snowtown Murders;2012;Certified-Fresh;83;66;60;12;72;17
The Son (El hijo);1900;;;;9;2;;3
The Son of No One;2011;Rotten;15;22;6;33;39;16
The Sonata;2020;Rotten;48;65;12;13;25;4
The Song;2014;Rotten;31;82;4;9;13;5
The Song of Names;2019;Rotten;40;90;22;33;55;12
The Song of Sway Lake;2018;Rotten;42;80;14;19;33;7
The Sons Of Tennessee Williams;2011;Fresh;69;90;9;4;13;6
The Soul Collector;1900;Fresh;73;88;8;3;11;2
The Sound Of Music Live!;1900;Rotten;44;;7;9;16;10
The Sound of Silence;2019;Fresh;65;29;28;15;43;14
The Source Family;2013;Fresh;77;71;17;5;22;8
The Source: The Story of the Beats and the Beat Generation;1999;Fresh;88;68;14;2;16;5
The Souvenir;2019;Certified-Fresh;89;36;153;19;172;41
The Space Between Us;2017;Rotten;16;54;22;114;135;33
The Special Relationship;2010;Certified-Fresh;83;63;25;5;30;12
The Spectacular Now;2013;Certified-Fresh;91;76;154;15;169;42
The Spirit;2008;Rotten;14;25;16;97;113;33
The Spirit of the Marathon;2008;Fresh;88;90;7;1;8;4
The SpongeBob Movie: Sponge Out of Water;2015;Certified-Fresh;81;54;84;20;104;34
The Spy Who Came In from the Cold;1965;Fresh;87;82;13;2;15;4
The Spy Who Dumped Me;2018;Rotten;49;57;101;105;206;40
The Square;2010;Certified-Fresh;86;70;73;12;85;29
The Square (Al Midan);2013;Certified-Fresh;100;90;69;0;68;23
The Square;2017;Certified-Fresh;85;70;182;32;214;38
The Squeeze;2015;Rotten;15;43;2;11;13;2
The Standoff at Sparrow Creek;2019;Certified-Fresh;78;64;38;11;49;9
The Stanford Prison Experiment;2015;Certified-Fresh;84;75;84;16;99;32
The Star;2017;Rotten;42;71;22;30;52;13
The Starving Games;2013;Rotten;0;21;0;9;9;2
The Steps;1900;Rotten;33;44;2;4;6;1
The Stolen;1900;Rotten;0;31;0;5;5;0
The Stone Roses: Made of Stone;2013;Fresh;76;76;22;7;29;6
The Story Of Luke;2013;Fresh;83;78;5;1;6;3
The Story of Qiu Ju (Qiu Ju da guan si);1992;Fresh;86;85;19;3;22;7
The Story of the Last Chrysanthemums;1979;Fresh;94;91;15;1;16;2
The Strange Case Of Angelica;2010;Fresh;85;44;23;4;27;9
The Strange Color of Your Body's Tears;2014;Rotten;51;42;24;23;47;17
The Strange Ones;2018;Rotten;55;43;16;13;29;8
The Strangers;2008;Rotten;48;48;78;86;164;42
The Strangers: Prey At Night;2018;Rotten;39;35;48;74;122;22
The Stray;2017;Rotten;40;69;4;6;10;1
The Strongest Man;2015;Rotten;22;50;2;7;9;4
The Substitute 4: Failure Is Not an Option;2001;Rotten;17;35;1;5;6;0
The Sugarland Express;1974;Fresh;85;66;33;6;39;6
The Suicide Theory;2015;Fresh;79;69;15;4;19;7
The Summit;2013;Fresh;65;63;24;13;37;19
The Sun Is Also a Star;2019;Rotten;51;61;52;49;101;23
The Sunday Sessions;1900;Fresh;100;;6;0;6;0
The Sunlit Night;1900;Rotten;33;55;17;34;51;12
The Sunset Limited;1900;Fresh;68;79;19;9;28;17
The Sunshine Makers;2017;Fresh;100;73;9;0;9;5
The Super;2018;Rotten;40;64;4;6;10;2
The Surrogate;2020;Fresh;92;60;23;2;25;7
The Survivalist;2017;Certified-Fresh;96;66;43;2;45;11
The Suspect (Yong-eui-ja);2014;Fresh;78;70;7;2;9;5
The Swan Princess II: Escape from Castle Mountain;1997;Rotten;40;46;2;3;5;2
The Sweeney;2013;Rotten;45;44;29;35;64;20
The Swerve;1900;Fresh;100;73;44;0;44;4
The Swindle;1997;Fresh;69;46;18;8;26;7
The Switch;2010;Rotten;52;44;80;74;154;41
The Sword of Doom;1966;Fresh;78;91;7;2;9;0
The Taking Of Deborah Logan;2014;Fresh;89;48;8;1;9;0
The Taking of Pelham One Two Three;1974;Fresh;100;88;39;0;39;10
The Taking of Tiger Mountain;2015;Fresh;71;66;12;5;17;7
The Tale of Zatoichi Continues (Zoku Zatoichi monogatari);1962;Fresh;100;88;5;0;5;0
The Tall Man;2012;Rotten;41;38;12;17;29;8
The Taste of Money;2013;Rotten;32;23;6;13;19;9
The Tax Collector;2020;Rotten;19;72;13;55;68;8
The Tenants;2006;Rotten;32;30;6;13;19;8
The Tender Trap;1955;Fresh;67;56;4;2;6;0
The Texas Chainsaw Massacre: The Beginning;2006;Rotten;13;53;11;75;86;20
The Theatre Bizarre;2012;Rotten;38;36;3;5;8;1
The Theory of Everything;2014;Certified-Fresh;80;84;215;55;270;60
The Thief of Bagdad;1924;Fresh;96;82;26;1;27;4
The Thieves;2012;Fresh;67;71;8;4;12;4
The Thin Man Goes Home;1945;Fresh;60;78;3;2;5;0
The Thing;2011;Rotten;34;42;59;113;172;39
The Thing with Two Heads;1972;Rotten;0;25;0;8;8;1
The Things We've Seen;1900;Rotten;50;;3;3;6;0
The Third Man;1949;Certified-Fresh;99;93;81;1;82;24
The Third Murder (Sandome no satsujin);2018;Certified-Fresh;87;66;71;11;82;19
The Thorn in the Heart;2010;Rotten;52;48;16;15;31;13
The Three Caballeros;1944;Fresh;82;66;14;3;17;4
The Three Musketeers;2011;Rotten;26;39;25;71;96;23
The Ticket;2017;Rotten;51;30;18;17;35;11
The Tiger Hunter;2017;Fresh;78;79;14;4;18;7
The Tillman Story;2010;Certified-Fresh;93;91;82;6;88;29
The Time Being;2013;Rotten;28;34;5;13;18;9
The Times of Harvey Milk;1984;Fresh;96;94;25;1;26;7
The Tin Drum (Die Blechtrommel);1980;Fresh;83;84;19;4;23;4
The Titan;1900;Rotten;18;15;5;23;28;8
The To Do List;2013;Rotten;55;46;66;54;119;37
The Toe Tactic;2009;Rotten;44;38;4;5;9;4
The Tomorrow Man;2019;Rotten;41;44;23;33;56;15
The Tortured;2012;Rotten;6;35;1;17;18;7
The Tower;2012;Rotten;17;58;1;5;6;3
The Town;2010;Certified-Fresh;93;85;214;17;231;50
The Town That Dreaded Sundown;2014;Fresh;66;40;19;10;29;7
The Toxic Avenger: Part II;1900;Rotten;0;33;0;8;8;0
The Traitor;2020;Certified-Fresh;84;70;84;16;100;22
The Transporter Refueled;2015;Rotten;16;30;16;85;101;27
The Traveler;2010;Rotten;20;16;1;4;5;0
The Treasure;2016;Fresh;95;42;35;2;37;13
The Tree;2011;Certified-Fresh;72;53;48;19;67;27
The Tree of Life;2011;Certified-Fresh;85;60;242;44;286;58
The Tree of Wooden Clogs (L'albero degli Zoccoli);1979;Fresh;94;86;16;1;17;4
The Trial of Billy Jack (El Juicio de Billy Jack);1900;Rotten;50;50;4;4;8;0
The Trials of Darryl Hunt;2007;Fresh;100;88;11;0;11;3
The Trials Of Muhammad Ali;2013;Fresh;89;85;34;4;38;19
The Tribe;2015;Certified-Fresh;88;69;116;16;132;34
The Tribe (La tribu);1900;Fresh;71;43;5;2;7;0
The Tribes of Palos Verdes;2017;Fresh;64;58;14;8;22;8
The Trip;2003;Rotten;39;71;12;19;31;15
The Trip;2011;Certified-Fresh;89;70;95;12;107;37
The Trip to Greece;2020;Certified-Fresh;87;52;99;15;114;21
The Trip To Italy;2014;Certified-Fresh;87;57;115;17;132;39
The Trip to Spain;2017;Certified-Fresh;83;64;89;18;107;25
The Triplets of Belleville;2003;Certified-Fresh;94;90;141;9;150;40
The Triumph of Love;2002;Rotten;48;51;35;38;73;28
The Trouble With Angels;1966;Fresh;75;86;6;2;8;1
The Trouble with Bliss;2012;Rotten;33;28;6;12;18;9
The Trouble with Harry;1955;Fresh;90;73;26;3;29;4
The Trouble with Terkel;2017;Rotten;40;80;2;3;5;1
The Trouble with the Truth;2012;Fresh;94;73;16;1;17;8
The True Memoirs of an International Assassin;2016;Rotten;0;43;0;9;9;4
The Trust;2016;Fresh;63;29;29;17;46;14
The Truth About Emanuel;2014;Rotten;37;35;11;19;30;13
The Tunnel;1900;Fresh;100;50;7;0;7;0
The Turin Horse;2012;Certified-Fresh;89;76;55;7;62;19
The Turning;1900;Fresh;86;54;24;4;28;5
The Twilight Saga: Breaking Dawn Part 1;2011;Rotten;25;60;52;157;209;50
The Twilight Saga: Breaking Dawn Part 2;2012;Rotten;49;70;96;99;195;46
The Two Faces of January;2014;Certified-Fresh;80;48;98;25;123;33
The Two Jakes;;Fresh;65;38;13;7;20;3
The Two of Us (Le vieil homme et l'enfant);1967;Fresh;100;93;15;0;15;7
The Two Popes;2019;Certified-Fresh;89;88;195;24;219;43
The Ultimate Life;2013;Rotten;18;56;2;9;11;3
The Ultimate Warrior;1975;Rotten;33;34;2;4;6;0
The Uncondemned;2016;Fresh;100;100;13;0;13;6
The Undefeated;2011;Rotten;0;38;0;15;15;10
The Unforeseen;2008;Certified-Fresh;90;69;38;4;42;17
The Unicorn;2019;Fresh;91;65;10;1;11;5
The Unknown Girl (La fille inconnue);2017;Fresh;71;47;65;26;91;22
The Unknown Known;2014;Certified-Fresh;82;70;86;19;105;39
The Unseen;2017;Fresh;100;54;9;0;9;1
The Unspeakable Act;2013;Fresh;89;63;8;1;9;3
The Upside;2019;Rotten;42;82;78;106;184;43
The Valet;2007;Fresh;70;68;57;25;82;31
The Valley;2018;Rotten;42;62;5;7;12;6
The Valley of Gwangi;1969;Fresh;78;60;7;2;9;0
The Vanished;2020;Rotten;15;49;2;11;13;2
The Vanishing;2019;Fresh;85;48;33;6;39;9
The Vanishing of Sidney Hall;2018;Rotten;11;78;3;24;27;7
The Vatican Tapes;2015;Rotten;20;59;9;36;45;10
The Vault;2017;Rotten;25;26;7;21;28;5
The VelociPastor;1900;Rotten;54;71;7;6;13;0
The Very Thought of You;1999;Rotten;33;60;3;6;9;2
The Veteran;2012;Fresh;60;38;12;8;20;7
The Victim;2012;Rotten;32;25;6;13;19;4
The Villainess (Ak-Nyeo);2017;Certified-Fresh;85;65;72;13;85;21
The Violent Kind;1900;Rotten;17;21;2;10;12;4
The V.I.P.s;1963;Rotten;0;45;0;5;5;1
The Viral Factor;2012;Rotten;56;54;9;7;16;6
The Virginity Hit;2010;Rotten;29;31;14;35;49;17
The Visit;2015;Fresh;68;51;154;74;228;40
The Visitor;1979;Fresh;78;44;14;4;18;4
The Voices;2015;Certified-Fresh;74;57;70;24;94;24
The Void;2017;Certified-Fresh;78;47;58;16;74;13
The Vow;2012;Rotten;31;63;42;93;135;34
The Wailing (Goksung);2016;Certified-Fresh;99;81;81;1;82;19
The Wait;2014;Rotten;31;23;4;9;13;7
The Waiting Room;2007;Fresh;60;56;3;2;5;1
The Waiting Room;2012;Fresh;100;75;34;0;34;19
The Walk;2015;Certified-Fresh;83;77;226;47;272;53
The Walking Deceased;2015;Rotten;0;26;0;11;11;2
The Wall;2017;Fresh;65;42;81;44;125;33
The Wanderers;1979;Fresh;89;87;16;2;18;0
The Wannabe;2015;Rotten;38;36;3;5;8;3
The War of the Worlds;1953;Fresh;89;71;31;4;35;5
The War Within;2005;Fresh;72;64;41;16;57;24
The Ward;2011;Rotten;33;27;24;48;72;19
The Warring States (Zhan Guo);2011;Rotten;40;44;2;3;5;3
The Watch;2012;Rotten;17;39;27;136;163;40
The Water Diviner;2015;Fresh;61;60;92;58;150;42
The Watermelon Woman;1997;Fresh;100;54;16;0;16;2
The Wave (Bolgen);2016;Certified-Fresh;83;65;90;19;109;31
The Wave;2020;Fresh;67;62;24;12;36;7
The Way Back;2011;Certified-Fresh;74;72;103;36;139;40
The Way Back;2020;Certified-Fresh;84;84;158;31;189;32
The Way He Looks;2014;Certified-Fresh;93;89;39;3;42;21
The Way Way Back;2013;Certified-Fresh;84;84;152;30;182;49
The We and the I;2013;Fresh;70;48;30;13;43;15
The Weather Underground;2002;Certified-Fresh;91;87;53;5;58;20
The Wedding Guest;2019;Rotten;44;37;32;41;73;20
The Wedding Party;1900;Rotten;43;24;3;4;7;0
The Wedding Plan;2017;Certified-Fresh;86;65;64;10;74;24
The Wedding Ringer;2015;Rotten;29;63;32;79;111;29
The Wedding Video;2014;Fresh;67;36;12;6;18;5
The Wedding Year;2019;Rotten;44;53;4;5;9;1
The Week Of;1900;Rotten;27;33;7;19;26;10
The Weekend;2019;Fresh;86;46;19;3;22;5
The Well-Digger's Daughter;2012;Certified-Fresh;88;74;35;5;40;22
The Whale;2011;Fresh;83;84;19;4;23;10
The Whisperer In Darkness;2011;Fresh;86;65;6;1;7;2
The Whistleblower;2011;Certified-Fresh;75;71;89;30;119;37
The White Crow;2019;Fresh;66;80;87;44;131;30
The White Haired Witch of Lunar Kingdom;1900;Rotten;13;22;1;7;8;1
The White Helmets;1900;Fresh;100;84;6;0;6;2
The Whole Town's Talking;1935;Fresh;100;78;12;0;12;1
The Whole Truth;2016;Rotten;30;33;9;21;30;12
The Wicker Man;1973;Certified-Fresh;89;82;48;6;54;11
The Wicker Man;2006;Rotten;15;17;16;91;107;18
The Wife;2018;Certified-Fresh;86;77;191;32;223;33
The Wild;2006;Rotten;19;36;21;91;112;35
The Wild Life;2016;Rotten;17;28;10;48;58;18
The Wilde Wedding;2017;Rotten;27;14;4;11;15;5
All The Wilderness;2015;Fresh;60;42;15;10;25;7
The Wildest Dream: Conquest of Everest;2010;Fresh;77;70;27;8;35;15
The Willoughbys;1900;Certified-Fresh;90;64;57;6;63;11
The Wind;2019;Certified-Fresh;82;50;56;12;68;10
The Wind Rises;2014;Certified-Fresh;88;85;157;22;179;49
The Wind Will Carry Us;2014;Fresh;97;84;29;1;30;7
The Winding Stream;2015;Fresh;100;65;9;0;9;3
The Windmill (The Windmill Massacre);2016;Rotten;58;23;7;5;12;1
The Winner;1997;Rotten;17;9;1;5;6;0
The Winter Guest;1997;Fresh;65;75;17;9;26;7
The Wipers Times;1900;Fresh;88;81;7;1;8;5
The Wise Kids;2012;Fresh;100;66;12;0;12;5
The Witch;2016;Certified-Fresh;90;59;293;32;325;57
The Witch: Subversion (Manyeo);1900;Fresh;88;87;15;2;17;1
The Witch Who Came from the Sea;1976;Fresh;80;35;8;2;10;0
The Witches;;Certified-Fresh;93;70;40;3;43;13
The Wizard of Lies;2017;Certified-Fresh;75;63;38;13;51;23
The Wizard of Oz;1939;Certified-Fresh;98;89;118;2;120;31
The Wolf of Wall Street;2013;Certified-Fresh;80;83;226;58;284;55
The Wolfpack;2015;Certified-Fresh;86;68;126;20;146;36
The Wolf's Call (Le chant du loup);1900;Fresh;92;71;11;1;12;3
The Wolverine;2013;Fresh;71;69;182;74;256;52
The Woman;2011;Certified-Fresh;73;56;37;14;51;15
The Woman in Black;2012;Fresh;67;54;129;64;193;47
The Woman in Black 2 Angel of Death;2015;Rotten;23;24;19;62;81;21
The Woman in the Fifth;2012;Rotten;59;22;34;24;58;24
The Women's Balcony (Ismach Hatani);2017;Certified-Fresh;96;77;45;2;47;12
The Words;2012;Rotten;24;49;31;97;128;35
The World Before Her;2013;Fresh;100;79;7;0;7;4
The World Before Your Feet;2018;Fresh;100;74;31;0;31;10
The World Is Yours (Le monde ou rien);1900;Fresh;95;60;19;1;20;6
The World Made Straight;2015;Fresh;62;46;13;8;21;10
The World of Apu;1960;Fresh;96;95;26;1;27;8
The World's End;2013;Certified-Fresh;89;71;215;26;241;53
The Wrestler;2008;Certified-Fresh;98;88;227;4;231;52
The Wretched;2020;Certified-Fresh;74;46;81;28;109;9
The Wrong Missy;1900;Rotten;33;51;19;38;57;11
The Year Dolly Parton Was My Mom;1900;Rotten;40;32;2;3;5;2
The Year of the Yao;2005;Fresh;67;70;22;11;33;12
The Yellow Birds;2018;Rotten;44;41;18;23;41;12
The Yellow Sea (Hwanghae);2011;Fresh;88;78;22;3;25;8
The Yes Men Are Revolting;2015;Fresh;81;55;26;6;32;12
The Young Girl and the Monsoon;2001;Rotten;53;43;10;9;19;9
The Young Girls of Rochefort (Les Demoiselles de Rochefort);1968;Certified-Fresh;98;84;43;1;44;15
The Young Karl Marx (Le jeune Karl Marx);2018;Fresh;61;69;30;19;49;15
The Young Messiah;2016;Rotten;49;66;19;20;39;8
The Young Philadelphians;1959;Fresh;71;80;5;2;7;1
The Young Unknown;2000;Rotten;14;;4;25;29;13
The Zen Of Bennett;2012;Fresh;67;70;6;3;9;7
The Zero Theorem;2014;Rotten;49;43;63;66;129;33
The Zookeeper's Wife;2017;Fresh;63;76;113;65;178;41
Theater of Blood (Theatre of Blood) (Much Ado About Murder);1973;Fresh;93;81;26;2;28;4
Theeb;2015;Certified-Fresh;97;76;70;2;72;22
Their Finest;2017;Certified-Fresh;90;71;150;17;167;34
Thelma;2017;Certified-Fresh;93;77;137;11;148;28
Thelma & Louise;1991;Certified-Fresh;84;82;59;11;70;18
Them;2007;Fresh;62;60;32;20;52;20
Them That Follow;2019;Rotten;59;45;55;38;93;22
Then Came You;2019;Rotten;59;76;13;9;22;3
Then She Found Me;2007;Rotten;50;44;60;59;119;40
The Theory of Flight;1998;Rotten;50;57;11;11;22;7
Theory of Obscurity: A Film About the Residents;1900;Fresh;75;52;6;2;8;4
There Be Dragons;2011;Rotten;12;54;5;36;41;17
There Was a Crooked Man;1970;Fresh;80;74;8;2;10;0
There Will Be Blood;2007;Certified-Fresh;92;86;217;20;236;50
There's No Business Like Show Business;1954;Fresh;67;57;8;4;12;0
There's Something About Mary;1998;Certified-Fresh;83;61;70;14;84;24
There's Something in the Water;1900;Fresh;79;;11;3;14;6
Therese;2013;Rotten;52;37;31;29;60;19
These Amazing Shadows;2011;Fresh;75;85;9;3;12;3
These Birds Walk;2013;Fresh;96;73;26;1;27;11
These Final Hours;2015;Certified-Fresh;84;64;49;9;58;13
These Girls;2006;Fresh;73;45;8;3;11;5
Thesis;1996;Fresh;83;89;10;2;12;3
They Call It Myanmar: Lifting The Curtain;2012;Fresh;100;72;13;0;13;7
They Call Me Mister Tibbs;1970;Fresh;60;36;0;0;5;0
They Came to Cordura;1959;Fresh;80;50;4;1;5;0
They Came Together;2014;Fresh;68;39;63;29;92;30
They Died With Their Boots On;1900;Fresh;82;75;9;2;11;0
They Got Me Covered;1943;Rotten;20;82;1;4;5;2
They Live;1988;Certified-Fresh;86;79;56;9;65;10
They Might Be Giants;1971;Fresh;75;75;9;3;12;1
They Remain;1900;Rotten;57;31;16;12;28;7
They Wait;2008;Rotten;40;38;2;3;5;3
They Were Expendable;1945;Fresh;91;73;10;1;11;0
They Will Have to Kill Us First;2016;Fresh;100;61;19;0;19;7
They'll Love Me When I'm Dead;2018;Fresh;92;80;34;3;37;10
They're Inside;1900;;;;1;5;;0
They're Watching;2016;Rotten;47;35;8;9;17;7
Thief Of Hearts;1984;Rotten;0;51;0;6;6;0
Thieves' Highway;1949;Fresh;100;78;7;0;7;1
Thin;2006;Fresh;100;84;7;0;7;1
The Thin Blue Line;1988;Fresh;100;90;17;0;17;2
The Convincer (Thin Ice);2012;Fresh;68;51;41;19;60;21
A Thin Line Between Love and Hate;1996;Rotten;12;77;3;22;25;9
The Thin Man;1934;Fresh;97;93;38;1;39;6
The Thing About My Folks;2005;Rotten;45;52;29;36;65;21
The Thing Called Love;1993;Rotten;57;70;12;9;21;5
Things to Do;1900;Fresh;100;68;6;0;6;1
Things Behind the Sun;2001;Fresh;100;79;12;0;12;2
Things Change;1988;Fresh;83;79;10;2;12;1
Things Never Said;2013;Fresh;67;82;6;3;9;6
Things to Come;1936;Fresh;93;54;28;2;30;4
Things to Come (L'avenir);2016;Certified-Fresh;99;70;142;1;143;34
Things to Do in Denver When You're Dead;1995;Rotten;33;72;9;18;27;5
Things We Lost in the Fire;2007;Fresh;65;73;83;45;128;35
Things You Can Tell Just by Looking at Her;2000;Fresh;74;64;14;5;19;5
Think Like a Dog;1900;Fresh;70;52;7;3;10;0
Think Like a Man;2012;Rotten;54;79;55;47;102;34
Think Like a Man Too;2014;Rotten;22;59;19;66;85;31
Stephen King's 'Thinner';1996;Rotten;15;30;3;17;20;4
Third Person;2014;Rotten;25;34;27;80;106;42
The Third Wheel;2002;Rotten;33;31;2;4;6;0
Third World Cop;1999;Rotten;21;87;3;11;14;5
Thirteen;2003;Certified-Fresh;81;77;125;29;154;41
Thirteen Women;1932;Rotten;56;34;5;4;9;3
Thirteen Conversations About One Thing;2001;Certified-Fresh;83;71;96;19;115;29
Thirteen Days;2000;Certified-Fresh;83;80;102;21;123;29
Thirteen Ghosts (13 Ghosts);2001;Rotten;16;49;15;79;94;24
Thirty Two Short Films About Glenn Gould;1993;Fresh;92;88;23;2;25;9
Thirty Seconds Over Tokyo;1944;Fresh;100;75;5;0;5;0
36 quai des orfevres;2005;Fresh;100;81;6;0;6;0
This Beautiful City;2007;Rotten;14;35;1;6;7;4
This Ain't No Mouse Music!;2014;Fresh;71;75;5;2;7;5
This Beautiful Fantastic;2017;Fresh;61;75;14;9;23;8
This Boy's Life;1993;Fresh;76;79;28;9;37;13
This Changes Everything;2015;Rotten;56;47;10;8;18;9
This Christmas;2007;Rotten;55;81;46;38;84;32
This Divided State;2005;Fresh;83;84;20;4;24;8
This Girl's Life;2004;Rotten;50;44;4;4;8;2
This Is 40;2012;Rotten;51;50;113;107;220;49
This Is Elvis;1900;Fresh;86;85;6;1;7;2
This Is England;2007;Certified-Fresh;92;90;86;7;93;34
This Is Martin Bonner;2013;Fresh;93;70;28;2;30;11
This Is My Life;1992;Rotten;38;49;5;8;13;2
This Is Not a Film;2012;Certified-Fresh;97;69;98;3;101;39
This is not Berlin;2019;Certified-Fresh;82;67;41;9;50;11
This Is Spinal Tap;1984;Certified-Fresh;95;92;62;3;65;10
This Is the End;2013;Certified-Fresh;83;71;188;38;226;48
One Direction: This Is Us;2013;Fresh;63;79;59;34;93;26
This Is Where I Leave You;2014;Rotten;44;59;73;95;167;53
This Land Is Mine;1943;Fresh;71;81;5;2;7;3
This Means War;2012;Rotten;26;56;47;136;183;43
This Must Be The Place;2012;Fresh;67;58;58;29;87;30
This Old Cub;2004;Fresh;74;85;14;5;19;8
This Property Is Condemned;1966;Fresh;64;77;9;5;14;4
This Revolution;2006;Rotten;18;70;2;9;11;6
This So-Called Disaster;2004;Fresh;90;62;26;3;29;14
This Sporting Life;1963;Fresh;95;87;20;1;21;9
This Teacher;1900;Fresh;100;;7;0;7;1
This Thing of Ours;2003;Rotten;40;27;6;9;15;6
Thoda Pyaar Thoda Magic;2008;Fresh;88;52;7;1;8;3
Thomas and the Magic Railroad;2000;Rotten;21;42;14;54;68;23
The Thomas Crown Affair;1968;Fresh;76;74;26;8;34;7
The Thomas Crown Affair;1999;Fresh;70;77;71;31;102;29
Thor;2011;Certified-Fresh;77;76;220;66;286;55
Thor: Ragnarok;2017;Certified-Fresh;93;87;396;31;426;52
Thor: The Dark World;2013;Fresh;66;76;184;96;279;55
Thoroughbreds;2018;Certified-Fresh;86;67;140;22;162;37
Those Magnificent Men in Their Flying Machines;1965;Fresh;78;75;7;2;9;0
Those People;2016;Fresh;80;56;8;2;10;6
Three and Out;2008;Rotten;17;40;1;5;6;3
Three Billboards Outside Ebbing, Missouri;2017;Certified-Fresh;90;87;366;39;405;59
The Three Burials of Melquiades Estrada;2006;Certified-Fresh;85;81;126;23;149;41
Three Came Home;1950;Fresh;100;72;8;0;8;3
Three Christs;2020;Rotten;43;69;20;26;46;10
Three Coins in the Fountain;1954;Fresh;60;43;6;4;10;3
Three Colors: Blue (Trois Couleurs: Bleu);1993;Certified-Fresh;98;93;45;1;46;7
Three Colors: White (Trois Couleurs: Blanc);1994;Certified-Fresh;87;87;41;6;47;13
Three Days of the Condor;1975;Certified-Fresh;87;83;39;6;45;6
The Three Faces of Eve;1957;Fresh;93;77;14;1;15;0
Three Fugitives;1989;Rotten;14;50;2;12;14;0
Three Godfathers;1948;Fresh;83;78;10;2;12;2
Three Identical Strangers;2018;Certified-Fresh;97;88;173;6;179;42
Three Kings;1999;Certified-Fresh;94;77;121;8;129;30
Three Men and a Baby (3 Men and a Baby);1987;Fresh;75;47;27;9;36;10
Three Men and a Little Lady;;Rotten;38;43;6;10;16;3
Three Night Stand;2015;Fresh;60;30;6;4;10;3
Three O'Clock High;1987;Fresh;67;73;8;4;12;1
Three of Hearts;1993;Rotten;53;35;9;8;17;8
Three Sisters;2013;Fresh;100;88;6;0;6;1
Three Smart Girls;1936;Fresh;86;50;6;1;7;2
Torst (Thirst) (Three Strange Loves);1949;Fresh;100;52;6;0;6;2
Three Times (Zui hao de shi guang);2005;Certified-Fresh;86;71;44;7;51;24
Three to Tango;1999;Rotten;28;48;18;47;65;21
Three Wishes;1995;Rotten;13;52;2;13;15;4
Three Worlds;2013;Rotten;38;46;3;5;8;5
The 3 Worlds of Gulliver;1960;Fresh;83;54;5;1;6;0
Three...Extremes (Saam gaang yi);2005;Certified-Fresh;84;77;51;10;61;24
Threesome;1994;Rotten;28;56;7;18;25;8
Thriller;1900;Rotten;40;15;10;15;25;6
Throne of Blood;1957;Certified-Fresh;95;94;41;2;43;9
Through a Lens Darkly: Black Photographers and the Emergence of a People;2014;Fresh;61;73;11;7;18;11
Throw Momma from the Train;1987;Fresh;63;54;22;13;35;6
A Throw of Dice;1930;Fresh;100;47;8;0;8;4
Thumbsucker;2005;Fresh;71;71;85;34;119;32
Thunder and the House of Magic;2014;Fresh;73;54;22;8;30;11
Thunder Road;2018;Certified-Fresh;96;93;79;3;82;14
Thunder Soul;2011;Fresh;100;86;29;0;29;14
Thunderball;1965;Certified-Fresh;86;73;44;7;51;7
Thunderbirds;2004;Rotten;19;36;20;86;106;33
Thunderbirds Are Go;1966;Rotten;57;57;4;3;7;1
Thunderbolt and Lightfoot;1974;Fresh;90;73;26;3;29;5
Thunderheart;1992;Fresh;89;75;17;2;19;3
Thunderstruck;2012;Rotten;27;70;3;8;11;1
Thursday;1998;Rotten;43;81;3;4;7;0
THX 1138;1971;Certified-Fresh;86;74;54;9;63;12
Ticked-off Trannies With Knives;2010;Fresh;71;46;5;2;7;1
Tideland;2006;Rotten;31;64;24;54;78;26
Atame! (Tie Me Up! Tie Me Down!);;Fresh;67;79;20;10;30;4
Tig Notaro: Happy to Be Here;1900;Fresh;100;71;8;0;8;4
La tigre e la neve (The Tiger and the Snow);2006;Rotten;20;84;5;20;25;8
Tiger Bay;1959;Fresh;75;84;6;2;8;0
Tiger Eyes;2013;Fresh;66;53;19;10;29;14
Tiger Orange;1900;Fresh;100;45;5;0;5;2
Tigerland;2000;Certified-Fresh;77;71;36;11;47;11
Tigertail;1900;Certified-Fresh;81;67;62;15;77;18
Tightrope;1984;Fresh;85;50;11;2;13;1
Tijuana Jackson: Purpose Over Prison;2020;Fresh;67;100;4;2;6;1
Tikkun;2016;Fresh;95;46;19;1;20;7
Till Human Voices Wake Us;2003;Rotten;25;66;18;54;72;24
Till the Clouds Roll By;1947;Fresh;100;49;6;0;6;0
Tim and Eric's Billion Dollar Movie;2012;Rotten;36;47;27;47;74;25
Timber Falls;2007;Rotten;38;28;3;5;8;0
Timbuktu;2015;Certified-Fresh;98;77;120;2;122;38
Time After Time;1979;Fresh;87;72;26;4;30;6
Time Bandits;1981;Certified-Fresh;90;77;44;5;49;7
Time Changer;2002;Rotten;22;86;2;7;9;1
Los Cronocrimenes (Timecrimes);2007;Certified-Fresh;89;79;63;8;71;20
Zamani baraye masti asbha (A Time for Drunken Horses)(Intoxication for Horses);2000;;;;29;5;;9
Time For Ilhan;1900;Fresh;94;42;17;1;18;1
Time Lapse;2015;Fresh;78;64;14;4;18;4
Time of the Wolf;2004;Fresh;64;65;36;20;56;18
Time Out Of Mind;2015;Certified-Fresh;80;42;70;18;88;32
Time Regained;1999;Fresh;70;72;19;8;27;4
Time Share (Tiempo Compartido);1900;Fresh;86;50;19;3;22;3
The Time That Remains;2011;Certified-Fresh;85;68;39;7;46;21
Time Trap;2018;Rotten;58;65;7;5;12;2
The Time Traveler's Wife;2009;Rotten;38;59;61;98;159;47
Timecode;2000;Fresh;68;49;55;26;81;24
Timecop;1994;Rotten;45;36;20;24;44;13
Timeline;2003;Rotten;11;45;16;126;142;37
Tim's Vermeer;2014;Certified-Fresh;89;86;108;13;121;38
Tin Cup;1996;Fresh;71;65;37;15;52;16
Tin Men;1987;Fresh;77;63;17;5;22;1
The Tin Star;1957;Fresh;83;72;5;1;6;0
The Tingler;1959;Fresh;76;66;13;4;17;0
Tinker Bell;2008;Fresh;90;73;9;1;10;2
Tinker Bell and the Great Fairy Rescue;2010;Fresh;78;76;7;2;9;2
Tinker Bell and the Lost Treasure;2009;Fresh;100;73;5;0;5;0
Tinker Tailor Soldier Spy;2011;Certified-Fresh;83;65;190;38;228;53
TinkerBell and the Legend of the NeverBeast;1900;Fresh;75;76;15;5;20;8
Tiny Furniture;2010;Certified-Fresh;80;54;78;20;98;34
Tio Papi;2013;Rotten;29;39;2;5;7;4
Tip Top;2014;Rotten;53;22;8;7;15;8
Tiptoes;2004;Rotten;20;22;2;8;10;1
Titan A.E.;2000;Rotten;51;60;52;49;101;29
Titanic;1997;Certified-Fresh;89;69;171;21;192;62
Titanica;1995;Fresh;60;45;3;2;5;1
TMNT;2007;Rotten;35;60;42;78;120;29
To All the Boys I've Loved Before;2018;Certified-Fresh;96;86;65;3;68;13
To All the Boys: P.S. I Still Love You;1900;Certified-Fresh;75;40;53;18;71;15
To Be Takei;2014;Certified-Fresh;90;75;44;5;49;18
To Catch a Thief;1955;Certified-Fresh;96;84;48;2;50;9
To End All Wars;2002;Fresh;62;85;8;5;13;2
To Gillian on Her 37th Birthday;1996;Rotten;14;42;4;24;28;8
To Have and Have Not;1944;Fresh;97;90;35;1;36;7
To Kid or Not to Kid;2019;Fresh;100;;15;0;15;4
To Kill A Mockingbird;1962;Certified-Fresh;92;92;57;5;62;12
To Kill a Priest;1988;Fresh;80;60;4;1;5;1
To Rome with Love;2012;Rotten;46;40;83;98;181;51
To Save a Life;2010;Rotten;39;82;9;14;23;8
To Sir, With Love;1967;Fresh;89;88;25;3;28;5
To Sleep With Anger;;Fresh;88;78;28;4;32;12
To the Arctic;2012;Fresh;64;66;18;10;28;13
To the Bone;2017;Fresh;72;64;46;18;64;17
To The Devil A Daughter;1976;Rotten;40;38;4;6;10;1
To the Stars;1900;Certified-Fresh;81;77;48;11;59;12
To The Wonder;2013;Rotten;46;37;82;94;175;51
To Wong Foo, Thanks for Everything! Julie Newmar;1995;Rotten;39;71;15;23;38;10
To Your Last Death;1900;Fresh;67;94;10;5;15;0
Toad Road;2013;Fresh;75;49;6;2;8;2
Toast;2011;Fresh;62;52;21;13;34;15
Today's Special;2010;Fresh;81;72;25;6;31;15
Todd Glass: Act Happy;1900;Fresh;100;;7;0;7;3
Together;2001;Certified-Fresh;90;89;73;8;81;29
Rage;2014;Rotten;12;28;5;37;42;14
Tokyo Decadence;1991;Fresh;67;55;4;2;6;2
Tokyo Drifter;1966;Fresh;92;80;12;1;13;2
Tokyo Godfathers;2003;Certified-Fresh;90;91;65;7;72;24
Tokyo Zankoku Keisatsu (Tokyo Gore Police);2008;Fresh;82;61;9;2;11;4
Tokyo Sonata (Tokyo Sonata);2009;Certified-Fresh;94;80;83;5;88;33
Tokyo Story (Tokyo monogatari);1953;Certified-Fresh;100;93;48;0;48;11
Tokyo Tribe;2015;Rotten;55;46;18;15;33;12
Tolkien;2019;Rotten;51;71;99;97;196;37
Tom and Huck;1900;Rotten;25;42;2;6;8;2
Tom and Jerry: The Movie;1992;Rotten;14;40;2;12;14;5
Tom Dowd and the Language of Music;2004;Fresh;90;92;27;3;30;11
Tom Horn;1980;Fresh;83;69;5;1;6;0
Tom Jones;1963;Fresh;82;58;32;7;39;9
Tom of Finland;2017;Certified-Fresh;84;70;58;11;69;17
Tom Segura: Disgraceful;1900;Fresh;100;78;5;0;5;2
Tom Thumb;1958;Fresh;100;62;6;0;6;0
Tomb Raider;2018;Rotten;51;55;161;154;315;51
Tomboy;2011;Certified-Fresh;96;82;64;3;67;28
Tombs Of The Blind Dead (Noche del terror ciego);1972;Fresh;67;58;6;3;9;0
Tomcats;2001;Rotten;14;42;11;65;76;24
Tommaso;2020;Certified-Fresh;78;22;53;15;68;11
Tommy Boy;1995;Rotten;42;90;18;25;43;8
Tommy's Honour;2017;Fresh;67;68;56;27;83;24
Tomorrow Ever After;2017;Fresh;86;64;6;1;7;4
Tomorrow Never Dies;1997;Rotten;57;53;51;38;89;26
Tomorrow You're Gone;2013;Rotten;7;4;1;13;14;6
Tomorrowland;2015;Rotten;50;49;148;148;296;51
Tone-Deaf;2019;Rotten;45;26;14;17;31;4
Toni Erdmann;2016;Certified-Fresh;93;73;219;16;234;39
Tonight You're Mine;2012;Rotten;39;60;18;28;46;16
Tony 'n' Tina's Wedding;2007;Rotten;25;55;2;6;8;3
Tony Rome;1967;Fresh;63;59;5;3;8;1
Too Big to Fail;1900;Fresh;77;76;23;7;30;17
Too Late Blues;1961;Fresh;78;72;6;2;9;3
Too Much Sun;1991;Rotten;17;31;1;5;6;2
Toolbox Murders;2004;Rotten;53;33;8;7;15;1
Tooth and Nail;2007;Rotten;33;22;2;4;6;0
The Tooth Fairy;2006;Rotten;25;34;2;6;8;1
Tootsie;1982;Certified-Fresh;90;81;46;5;51;9
Top Cat Begins (Don Gato, el inicio de la pandilla);2017;Rotten;14;28;1;6;7;2
Top End Wedding;1900;Fresh;89;74;33;4;37;5
Top Five;2014;Certified-Fresh;85;64;158;27;185;51
Top Gun;1986;Rotten;54;83;31;26;57;13
Top Hat;1935;Certified-Fresh;100;91;42;0;42;9
Topaz;1969;Fresh;71;36;22;9;31;5
Topkapi;1900;Fresh;90;67;19;2;21;5
The Topp Twins: Untouchable Girls;2011;Fresh;89;91;25;3;28;13
Topper Returns;1941;Fresh;89;80;8;1;9;0
Tora! Tora! Tora!;1970;Rotten;55;81;16;13;29;6
Torn Curtain;1966;Fresh;67;53;20;10;30;6
Tortilla Soup;2001;Certified-Fresh;74;71;53;19;72;28
Tortoise In Love;1900;Rotten;45;37;5;6;11;3
Toss It;1900;Fresh;71;;5;2;7;0
Total Eclipse;1995;Rotten;25;61;4;12;16;4
Total Recall;;Certified-Fresh;82;78;58;13;71;21
Total Recall;2012;Rotten;31;47;72;162;234;49
Touch The Sound;2004;Certified-Fresh;88;73;45;6;51;21
A Touch of Class;1973;Fresh;83;64;10;2;12;1
A Touch of Zen;1969;Fresh;96;82;23;1;24;4
Touchback;2012;Rotten;38;63;5;8;13;5
Touched With Fire;2016;Fresh;67;89;34;17;51;19
Touching Wild Horses;2002;Rotten;0;71;0;6;6;0
Touching the Void;2004;Certified-Fresh;94;92;131;9;140;42
Touchy Feely;2013;Rotten;40;22;25;38;63;19
The Tourist;2010;Rotten;20;42;34;137;171;41
All the Mornings of the World (Tous Les Matins du Monde);1991;Fresh;89;89;8;1;9;2
Towards Darkness;2007;Rotten;11;50;1;8;9;5
Towelhead;2007;Rotten;49;58;56;58;114;39
Tower;2016;Certified-Fresh;99;89;98;1;99;31
Tower Block;2012;Rotten;47;37;8;9;17;2
Tower Heist;2011;Fresh;67;48;134;65;199;49
The Towering Inferno;1974;Fresh;69;72;22;10;32;7
Town & Country;2000;Rotten;13;14;12;82;94;27
The Town That Dreaded Sundown;1976;Rotten;42;41;5;7;12;1
The Toxic Avenger;1984;Fresh;70;63;14;6;20;4
Citizen Toxie: The Toxic Avenger IV;2000;Fresh;70;65;7;3;10;2
Toxic Beauty;1900;Fresh;100;;7;0;7;0
The Toy;1982;Rotten;9;53;1;10;11;1
Toy Story;1995;Certified-Fresh;100;92;90;0;90;28
Toy Story 2;1999;Certified-Fresh;100;86;169;0;169;43
Toy Story 3;2010;Certified-Fresh;98;89;302;5;307;57
Toy Story 4;2019;Certified-Fresh;97;94;430;14;443;51
Toy Story of Terror!;2013;Fresh;94;84;15;1;16;3
Toy Story That Time Forgot;2014;Fresh;100;82;10;0;10;3
Toys;1992;Rotten;30;39;8;19;27;5
Toys In The Attic (Na Pude);2012;Fresh;73;80;11;4;15;6
Tracers;2015;Rotten;24;37;7;22;29;12
Tracey Ullman: Live and Exposed;2005;;;;2;3;;2
Track 29;1988;Fresh;63;45;5;3;8;2
Tracker;2011;Fresh;85;53;11;2;13;5
Tracks;1900;Rotten;50;;4;4;8;3
Tracy Morgan: Staying Alive;1900;Fresh;83;;5;1;6;2
Trade of Innocents;2012;Rotten;0;54;0;7;7;4
Traded;2016;Rotten;40;31;2;3;5;3
Trading Mom;1994;Rotten;38;56;3;5;8;2
Trading Paint;2019;Rotten;0;35;0;12;12;3
Trading Places;1983;Certified-Fresh;87;84;40;6;46;9
Traffic Stop;1900;Fresh;100;27;8;0;8;3
Trafficked;2017;Rotten;29;60;2;5;7;3
Traffik;2018;Rotten;27;46;9;24;33;6
Trafic (Traffic);1972;Fresh;95;77;19;1;20;5
Trail of the Pink Panther;1982;Rotten;23;33;3;10;13;0
Trailer Park Boys: The Movie;2006;Rotten;57;78;13;10;23;9
The Train Robbers;1973;Rotten;33;58;2;4;6;1
Train to Busan (Busanhaeng);2016;Certified-Fresh;94;88;109;7;116;17
Training Day;2001;Fresh;73;89;116;44;160;39
Trainspotting;1996;Certified-Fresh;91;93;77;8;85;24
Trainwreck;2015;Certified-Fresh;85;66;240;44;284;53
Traitor;2008;Fresh;65;64;110;59;169;47
Tramps;1900;Fresh;95;68;21;1;22;7
Trance;2013;Fresh;68;62;128;59;187;42
Trancers;1985;Fresh;83;53;5;1;6;0
Transamerica;2006;Certified-Fresh;77;83;112;33;145;41
Transcendence;2014;Rotten;19;37;44;184;228;55
Transformer;2018;Fresh;100;92;11;0;11;1
Transformers: Age of Extinction;2014;Rotten;18;50;37;172;209;54
Transformers: Dark of the Moon;2011;Rotten;35;55;92;170;262;55
Transformers: Revenge of the Fallen;2009;Rotten;20;57;50;201;251;57
Transformers: The Last Knight;2017;Rotten;15;43;37;213;250;42
Transformers;2007;Rotten;58;85;131;96;227;49
The Transformers - The Movie;1986;Rotten;58;88;14;10;24;3
Transit;2012;Rotten;50;30;4;4;8;3
Transit;2019;Certified-Fresh;94;63;167;10;177;33
Transpecos;2016;Fresh;91;56;21;2;23;10
The Transporter;2002;Rotten;54;73;68;59;127;33
Transporter 2;2005;Rotten;52;58;64;58;122;31
Transporter 3;2008;Rotten;39;49;45;69;114;32
Transsiberian;2008;Certified-Fresh;91;65;92;9;101;25
Transylmania;2009;Rotten;0;21;0;22;22;9
Transylvania 6-5000;1985;Rotten;18;41;2;9;11;0
Trap For Cinderella;2013;Rotten;25;24;4;12;16;4
Trapeze;1956;Fresh;67;64;4;2;6;0
Trapped in Paradise;1994;Rotten;10;41;2;18;20;8
Trash Humpers;2010;Rotten;59;44;23;16;39;15
Trash;2015;Fresh;66;70;29;15;44;17
Trashed;2012;Fresh;87;77;13;2;15;7
Trauma;2004;Rotten;29;25;5;12;17;3
Travelers and Magicians;2005;Certified-Fresh;93;83;57;4;61;18
Travels With My Aunt;1972;Rotten;57;49;4;3;7;1
Tread;2020;Fresh;90;89;9;1;10;3
Treasure Island;2000;Rotten;31;64;4;9;13;4
The Treasure of the Sierra Madre;1948;Certified-Fresh;100;93;49;0;49;5
Treasure Planet;2002;Fresh;69;72;104;46;150;37
The Treatment;2006;Fresh;68;33;28;13;41;19
Treeless Mountain;2009;Certified-Fresh;86;72;54;9;63;24
Trees Lounge;1996;Fresh;81;79;21;5;26;6
Trekkies;1999;Certified-Fresh;86;71;36;6;42;7
Trembling Before G-d;2001;Certified-Fresh;89;74;55;7;62;21
Tremors;;Certified-Fresh;86;75;38;6;44;8
Tremors 2: Aftershocks;1996;Rotten;56;46;5;4;9;0
Tremors 3 - Back to Perfection;2001;Fresh;67;34;4;2;6;0
Tremors: A Cold Day in Hell;1900;Rotten;40;29;2;3;5;0
Trespass;1992;Fresh;69;47;18;8;26;7
Trespass;2011;Rotten;9;22;7;67;74;26
Trespass Against Us;2017;Rotten;57;25;40;30;70;18
Trespassers;2019;Fresh;60;27;18;12;30;4
Trevor Noah: Afraid Of The Dark;1900;Fresh;100;;5;0;5;1
Trial by Fire;2019;Fresh;62;77;42;26;68;17
Trial by Jury;1994;Rotten;8;27;1;11;12;3
The Trials of Henry Kissinger;2002;Certified-Fresh;95;78;55;3;58;17
Trickfilme;1999;Fresh;78;83;18;5;23;6
Trick;2019;Rotten;33;33;9;18;27;4
Trick 'r Treat;2007;Fresh;81;71;21;5;26;2
Tricked (Steekspel);2016;Rotten;38;29;6;10;16;7
Trigger;2011;Fresh;88;64;7;1;8;3
The Trigger Effect;1996;Fresh;75;43;18;6;24;4
Trigger Man;2007;Fresh;90;44;9;1;10;3
Triple 9;2016;Rotten;54;41;98;84;181;43
Triple Frontier;2019;Fresh;70;55;93;39;132;26
Triple Threat;2019;Fresh;69;36;22;10;32;2
Trishna;2012;Fresh;63;52;58;34;92;31
Tristana;1970;Fresh;97;83;31;1;32;10
Tristram Shandy: A Cock & Bull Story;2005;Certified-Fresh;89;66;115;14;129;41
Triumph of the Spirit;1989;Rotten;50;52;3;3;6;1
Triumph des Willens (Triumph Of The Will);1935;Fresh;87;75;20;3;23;3
Trog;1970;Rotten;14;24;1;6;7;1
Troll 2;;Rotten;5;44;1;20;21;2
Trollhunter;2011;Certified-Fresh;81;72;88;20;108;30
Trolls;2016;Certified-Fresh;76;67;123;39;162;35
Trolls World Tour;2020;Fresh;70;59;107;45;152;30
Troma's War;1988;Rotten;20;61;1;4;5;0
TRON;1982;Certified-Fresh;72;69;47;18;65;7
Troop Beverly Hills;1989;Rotten;25;62;4;12;16;2
Tropic of Cancer;1970;Fresh;75;25;6;2;8;0
Tropic Thunder;2008;Certified-Fresh;82;70;204;45;249;54
Trouble Every Day (Gargoyle);2001;Rotten;50;55;27;27;54;16
Trouble Is My Business;2017;Fresh;100;95;6;0;6;0
Trouble the Water;2008;Certified-Fresh;96;86;73;3;76;31
The Trouble with Romance;2009;Rotten;17;17;2;10;12;6
Trouble with the Curve;2012;Rotten;51;66;104;100;204;50
Troublesome Creek: A Midwestern;1900;Fresh;82;83;9;2;11;3
Troy;2004;Rotten;54;73;122;106;228;50
Trucker;2009;Rotten;59;58;22;15;37;16
Trudell;2006;Rotten;33;75;10;20;30;11
True Adolescents;2011;Fresh;75;53;6;2;8;3
True Believer;1989;Fresh;95;63;21;1;22;5
True Confessions;1981;Fresh;71;53;10;4;14;6
True Grit;1969;Certified-Fresh;89;84;47;6;53;15
True Grit;2010;Certified-Fresh;96;85;260;12;272;56
True History of the Kelly Gang;2020;Certified-Fresh;79;41;122;32;154;28
True Identity;1991;Rotten;43;26;3;4;7;3
True Legend;2011;Fresh;64;55;25;14;39;15
True Romance;1993;Certified-Fresh;93;93;51;4;55;13
True Stories;1986;Fresh;78;83;18;5;23;1
True Story;2015;Rotten;45;38;76;93;169;47
The Truman Show;1998;Certified-Fresh;95;89;125;7;132;34
Trumbo;2015;Certified-Fresh;74;79;152;53;205;42
The Trumpet of the Swan;2001;Rotten;14;36;6;36;42;16
Trust;2011;Certified-Fresh;79;65;52;14;66;21
Trust Machine: The Story of Blockchain;2018;Fresh;90;83;9;1;10;3
Trust Me;2014;Rotten;52;38;17;16;33;12
Trust the Man;2006;Rotten;28;35;29;73;102;30
Truth;2015;Fresh;63;62;112;66;178;40
The Truth About Cats & Dogs;1996;Certified-Fresh;85;56;40;7;47;12
The Truth About Charlie;2002;Rotten;33;27;45;90;135;38
Truth About Love;2005;Rotten;0;41;0;11;11;5
Truth or Consequences, N.M.;1997;Rotten;38;46;6;10;16;3
Truth or Die;2012;Rotten;22;30;2;7;9;3
Tsotsi (Thug);2006;Certified-Fresh;82;86;108;23;131;36
Tu Dors Nicole;2015;Fresh;100;66;17;0;17;6
Tuck Everlasting;2002;Fresh;60;70;72;48;120;29
Tucked;1900;Fresh;95;50;18;1;19;4
Tucker and Dale vs. Evil;2011;Certified-Fresh;85;84;96;17;113;26
Tucker: The Man and His Dream;1988;Certified-Fresh;83;67;35;7;42;10
Tuesday, After Christmas;2011;Fresh;74;68;17;6;23;11
Tuff Turf;1985;Rotten;17;59;1;5;6;2
Tulip Fever;2017;Rotten;10;43;6;54;60;20
Tully;2002;Certified-Fresh;81;76;43;10;53;22
Tully;2018;Certified-Fresh;87;75;242;36;278;49
Tumbledown;2016;Fresh;70;61;26;11;37;14
Tunes of Glory;1960;Fresh;75;79;9;3;12;0
Turbo;2013;Fresh;66;65;75;38;113;28
Turbo: A Power Rangers Movie;1997;Rotten;15;41;3;17;20;8
Turistas (Paradise Lost);2006;Rotten;18;28;19;87;106;32
Turkey Bowl;2011;Fresh;70;41;7;3;10;5
Elimination Game (Turkey Shoot);1900;Rotten;20;6;1;4;5;1
Turn It Up;2000;Rotten;8;26;3;35;38;16
Turn the River;2008;Fresh;62;45;13;8;21;14
Turner and Hooch;1989;Rotten;52;51;15;14;29;5
Turning Green;2005;Rotten;42;42;5;7;12;3
Turtle: The Incredible Journey;2011;Fresh;71;77;12;5;17;7
Tuscaloosa;2020;Fresh;70;85;7;3;10;2
Tusk;2014;Rotten;45;36;59;72;131;35
The Tuskegee Airmen;1995;Fresh;88;79;7;1;8;2
The Tuxedo;2002;Rotten;21;30;30;110;140;31
Tuya's Marriage;2006;Certified-Fresh;95;83;38;2;40;16
The TV Set;2007;Fresh;65;58;50;27;77;31
Twelfth Night;1998;Fresh;76;80;26;8;34;11
12;2007;Certified-Fresh;77;84;46;14;60;24
Twelve;2010;Rotten;3;32;1;29;30;13
Twelve and Holding;2006;Certified-Fresh;73;79;57;21;78;31
Twelve Thirty;2011;Rotten;17;17;2;10;12;11
Twentieth Century;1934;Fresh;86;76;24;4;28;2
Twenty8k;1900;Rotten;17;16;1;5;6;1
Twenty Bucks;1993;Fresh;75;63;6;2;8;2
Twenty-Four Hour Woman;1999;Rotten;47;33;7;8;15;5
Twentyfourseven;1998;Rotten;35;81;7;13;20;6
Twentynine Palms;2004;Rotten;40;40;16;24;40;13
Twice Born;2013;Rotten;17;68;4;20;24;14
Twice in a Lifetime;1985;Fresh;83;61;5;1;6;1
Twice Told Tales;1963;Rotten;57;54;4;3;7;0
Twilight;2008;Rotten;49;73;108;113;221;50
The Twilight Saga: New Moon;2009;Rotten;28;61;64;164;228;57
Twilight Zone: The Movie;1983;Rotten;58;55;23;17;40;7
Twin Dragons (Shuang long hui) (Brother vs. Brother);1992;Rotten;44;48;17;22;39;8
Twin Peaks - Fire Walk with Me;1992;Fresh;64;78;48;27;75;12
Twin Murders: The Silence of the White City (El silencio de la ciudad blanca);1900;Rotten;40;15;2;3;5;1
Twin Warriors (Tai ji zhang san feng) (The Tai-Chi Master);1984;Fresh;86;84;6;1;7;0
Twist of Faith;2004;Fresh;100;81;20;0;20;7
Twisted;2004;Rotten;1;31;2;133;135;40
Twitches;2005;Fresh;60;65;3;2;5;0
Twixt;1900;Rotten;26;18;5;14;19;5
Two Bits;1995;Rotten;40;39;4;6;10;4
Two Brothers;2004;Certified-Fresh;78;75;89;25;114;34
Two Can Play That Game;2001;Rotten;41;83;26;37;63;26
Two Days, One Night;2014;Certified-Fresh;97;76;177;6;183;40
Two Drifters;2006;Rotten;47;45;7;8;15;8
Two Evil Eyes;;Rotten;56;35;10;8;18;2
Two Family House;2000;Fresh;89;81;31;4;35;11
Two for the Money;2005;Rotten;22;48;24;86;110;30
Two for the Road;1967;Fresh;81;84;17;4;21;3
Two for the Seesaw;1962;Rotten;43;57;3;4;7;0
Two Girls and a Guy;1998;Rotten;51;41;32;31;63;21
Two Hands;1999;Fresh;71;80;5;2;7;1
Two Heads Creek;1900;Fresh;90;69;18;2;20;1
Two if by Sea;1995;Rotten;11;23;3;25;28;5
Two Lives (Zwei Leben);2014;Fresh;92;73;12;1;13;5
Two Lovers;2008;Certified-Fresh;82;59;135;30;165;54
Two Men in Town;2015;Rotten;47;25;8;9;17;9
Two Men Went to War;2004;Rotten;59;71;17;12;29;9
Two Minute Warning;1900;Rotten;25;38;3;9;12;5
Two Mules for Sister Sara;1970;Fresh;69;73;9;4;13;1
Two Night Stand;2014;Rotten;38;45;18;29;47;16
Two Ninas;2000;Fresh;67;51;6;3;9;4
Two on a Guillotine;1900;Rotten;0;29;0;6;6;1
Two Thousand Maniacs!;1964;Rotten;41;50;9;13;22;1
Two Weeks;2006;Rotten;19;66;5;21;26;13
Two Weeks in Another Town;1962;Fresh;89;65;8;1;9;1
Two Weeks Notice;2002;Rotten;42;59;52;71;123;35
Two Women (La Ciociara);1961;Fresh;88;91;7;1;8;0
Oligarkh (Tycoon) (Tycoon: A New Russian);2003;Rotten;46;69;16;19;35;16
Tying the Knot;2004;Fresh;89;74;31;4;35;13
Tyler Perry's A Fall from Grace;1900;Rotten;17;51;4;20;24;9
Tyler Perry's A Madea Christmas;2013;Rotten;20;70;7;28;35;17
Tyler Perry's A Madea Family Funeral;2019;Rotten;12;30;4;30;34;8
Tyler Perry's Acrimony;2018;Rotten;17;51;6;30;36;12
Tyler Perry's Boo 2! A Madea Halloween;2017;Rotten;4;40;1;22;23;7
Tyler Perry's Boo! A Madea Halloween;2016;Rotten;19;52;8;35;43;9
Tyler Perry's Good Deeds;2012;Rotten;36;76;13;23;36;12
Tyrannosaur;2011;Certified-Fresh;83;85;71;15;86;29
Tyrel;2018;Fresh;60;32;30;20;50;17
U2: Rattle and Hum;1988;Fresh;62;86;8;5;13;0
U-571;2000;Fresh;68;62;78;37;115;30
U, Me Aur Hum;2008;Fresh;60;55;3;2;5;2
U-Turn;1997;Fresh;61;62;31;20;51;15
Ugetsu (Ugetsu monogatari);1954;Fresh;100;94;30;0;30;7
The Ugly Truth;2009;Rotten;14;60;24;150;174;48
UglyDolls;2019;Rotten;27;54;23;63;86;16
UHF;1989;Fresh;64;77;16;9;25;1
Ulee's Gold;1997;Certified-Fresh;94;75;49;3;52;16
The Ultimate Gift;2006;Rotten;33;84;20;40;60;18
Ultras;1900;Fresh;60;34;3;2;5;0
Ulzana's Raid;1972;Fresh;90;66;9;1;10;0
Umberto D;1955;Fresh;97;93;29;1;30;8
Un amour de jeunesse (Goodbye First Love);2012;Certified-Fresh;83;61;44;9;53;24
Un Oso rojo (Red Bear);2004;Fresh;60;78;3;2;5;1
Un Padre No Tan Padre;2017;Fresh;75;86;6;2;8;1
Una;2017;Certified-Fresh;76;49;83;26;109;24
Una noche (One Night);2013;Fresh;83;70;19;4;23;12
Unaccompanied Minors;2006;Rotten;29;53;26;64;90;30
The Unbearable Lightness of Being;1988;Fresh;85;84;23;4;27;5
The Unbelievable Truth;;Fresh;100;88;10;0;10;2
Unborn in the USA: Inside the War on Abortion;2007;Fresh;80;58;12;3;15;8
Unbranded;1900;Fresh;75;84;12;4;16;9
Unbreakable;2000;Fresh;70;77;121;51;172;38
Unbroken;2014;Rotten;50;70;116;114;230;50
Unbroken: Path to Redemption;2018;Rotten;38;76;10;16;26;6
Uncertain;2017;Fresh;100;82;22;0;22;8
Uncertain Terms;2015;Fresh;71;55;12;5;17;8
Uncertainty;2009;Rotten;50;33;13;13;26;8
Uncle Boonmee Who Can Recall His Past Lives;2011;Certified-Fresh;89;61;87;11;98;27
Uncle Buck;1989;Fresh;61;76;14;9;23;1
Uncle Drew;2018;Fresh;61;47;59;38;97;26
Uncle Kent;1900;Fresh;60;43;6;4;10;1
Uncle Kent 2;2016;Fresh;73;50;8;3;11;6
Uncle Nick;2015;Rotten;45;71;5;6;11;5
Uncle Peckerhead;2020;Fresh;100;73;11;0;11;0
Uncle Sam;1997;Rotten;56;25;5;4;9;0
Unconditional;2012;Fresh;75;87;9;3;12;5
Uncorked;1900;Certified-Fresh;91;65;42;4;46;15
Uncovered: The Whole Truth About the Iraq War;2004;Fresh;100;75;6;0;6;1
Uncut Gems;2019;Certified-Fresh;92;52;305;26;331;44
UNDEAD;2005;Rotten;32;44;25;53;78;21
Undefeated;2012;Certified-Fresh;96;89;98;4;102;37
Under Fire;1983;Fresh;90;69;19;2;21;4
Under Our Skin;2008;Fresh;81;88;26;6;32;10
Under Siege;1992;Fresh;79;62;23;6;29;6
Under Siege 2: Dark Territory;1995;Rotten;34;38;11;21;32;4
Under Suspicion;1991;Rotten;25;58;2;6;8;1
Under the Bed;2013;Rotten;40;14;4;6;10;1
Under The Boardwalk: The Monopoly Story;2011;Fresh;85;54;11;2;13;4
Sous les Bombes (Under the Bombs);2007;Fresh;80;74;4;1;5;2
Under the Cherry Moon;1986;Rotten;36;67;13;23;36;11
Under the Eiffel Tower;2019;Rotten;41;49;7;10;17;5
Under the Gun;2016;Fresh;100;41;10;0;10;5
Sous les Toits de Paris (Under the Roofs of Paris);1930;Fresh;90;73;19;2;21;3
Under the Same Moon;2008;Fresh;73;82;69;26;95;31
Sous le sable (Under the Sand);2001;Certified-Fresh;93;83;68;5;73;24
Under The Shadow;2016;Certified-Fresh;99;73;89;1;90;19
Under the Silver Lake;2019;Rotten;59;55;88;62;150;31
Under the Skin;2014;Certified-Fresh;85;55;212;37;249;56
Under The Sun;2016;Fresh;94;69;30;2;32;12
Under the Tuscan Sun;2003;Fresh;62;78;96;59;155;38
Under the Yum Yum Tree;1963;Rotten;17;58;1;5;6;2
Underclassman;2005;Rotten;6;35;5;78;83;28
Undercover Brother;2002;Certified-Fresh;77;64;100;30;130;28
Underdog;2007;Rotten;16;42;11;59;70;18
Undertaking Betty;2003;Rotten;50;66;3;3;6;1
Undertow;2004;Rotten;55;62;66;54;120;37
Undertow;2010;Fresh;88;;28;4;32;12
Underwater;2020;Rotten;48;60;99;109;208;31
Underworld;2003;Rotten;31;79;50;112;162;37
Underworld: Awakening;2012;Rotten;26;62;20;56;76;13
Underworld: Blood Wars;2017;Rotten;21;49;20;76;96;17
Underworld: Evolution;2006;Rotten;17;72;18;86;104;22
Underworld: The Rise of the Lycans;2009;Rotten;29;63;23;55;78;17
Undiscovered;2005;Rotten;8;48;6;68;74;26
Undisputed;2002;Rotten;48;47;51;55;106;33
Undrafted;2016;Rotten;25;75;2;6;8;3
Une Vieille Maitresse;2007;Certified-Fresh;77;59;75;23;98;32
Unexpected;2015;Fresh;66;44;38;20;58;25
Unfaithful;2002;Rotten;50;68;83;83;166;37
Unfinished Business;2015;Rotten;10;26;10;92;102;29
An Unfinished Life;2005;Rotten;52;67;74;68;142;37
Unfinished Song;2013;Fresh;65;68;65;35;100;36
#Unfit: The Psychology of Donald Trump;2020;Fresh;85;70;22;4;26;5
Unforgettable;1996;Rotten;21;28;6;22;28;5
Unforgettable;2017;Rotten;28;33;33;86;119;27
Unforgivable;2012;Fresh;77;35;27;8;35;21
Unfriended;2015;Fresh;62;36;114;71;185;41
Unfriended: Dark Web;2018;Rotten;59;38;70;48;118;22
Unhook the Stars;1996;Fresh;81;48;17;4;21;10
Unicorn Store;2019;Fresh;64;41;55;31;86;16
The Uninvited;2009;Rotten;32;49;41;88;129;35
Union;2019;Fresh;64;40;7;4;11;1
Union Square;2012;Fresh;66;35;19;10;29;15
United 93;2006;Certified-Fresh;90;83;191;21;212;47
United Passions;2015;Rotten;0;11;0;16;16;8
United Red Army;2011;Fresh;93;63;13;1;14;6
The United States of Leland;2004;Rotten;34;81;32;61;93;28
United We Fan;1900;Fresh;100;;14;0;14;1
Universal Soldier;1992;Rotten;33;46;11;22;33;9
Universal Soldier: Day of Reckoning;2012;Rotten;57;34;29;22;51;15
Universal Soldier: The Return;1999;Rotten;5;24;3;55;58;24
Unknown;2011;Rotten;54;55;111;93;204;49
Unlawful Entry;1992;Fresh;74;48;25;9;34;9
Unleashed;2017;Fresh;75;72;6;2;8;3
Unlocked;2017;Rotten;26;42;15;42;57;18
Unlovable;2018;Fresh;81;75;13;3;16;5
The Unloved;2009;Fresh;94;67;17;1;18;7
Unmistaken Child;2009;Fresh;81;88;29;7;36;16
Unplanned;2019;Rotten;42;92;11;15;26;7
An Unreasonable Man;2007;Certified-Fresh;92;87;58;5;63;26
Unsane;2018;Certified-Fresh;80;58;186;47;233;46
The Unsinkable Molly Brown;1964;Fresh;78;70;7;2;9;0
Unstoppable;2010;Certified-Fresh;87;72;167;26;193;45
Unstrung Heroes;1995;Fresh;74;61;17;6;23;5
Untamed Heart;1993;Rotten;54;77;14;12;26;4
Until the Birds Return (En attendant les Hirondelles);1900;Fresh;78;80;7;2;9;2
Until the Light Takes Us;2009;Rotten;46;57;11;13;24;8
(Untitled);1900;Fresh;66;57;27;14;41;16
Client 9: The Rise and Fall of Eliot Spitzer;2010;Certified-Fresh;90;83;63;7;70;28
Untouchable;1900;Certified-Fresh;86;71;44;7;51;19
The Untouchables;1987;Certified-Fresh;82;89;51;11;62;17
Unzipped;1995;Fresh;80;78;12;3;15;6
Up;2009;Certified-Fresh;98;90;289;7;296;59
Up and Down (Horem Padem) (Loop the Loop);2004;Certified-Fresh;83;74;55;11;66;25
Up Close & Personal;1996;Rotten;31;66;11;24;35;9
Up for Grabs;2005;Certified-Fresh;92;87;44;4;48;19
Up in Smoke;1978;Rotten;47;83;9;10;19;3
Up in the Air;2009;Certified-Fresh;91;79;258;27;285;60
Up on the Glass;1900;Rotten;50;100;4;4;8;0
Up the Academy;1980;Rotten;0;42;0;5;5;2
Up the Down Staircase;1967;Fresh;80;67;4;1;5;1
Up the Sandbox;1972;Fresh;60;48;3;2;5;1
Up the Yangtze;2007;Certified-Fresh;96;83;51;2;53;20
Upgrade;2018;Certified-Fresh;88;87;165;23;188;34
Upside Down;2013;Rotten;28;42;15;39;54;21
The Upside of Anger;2005;Certified-Fresh;75;63;138;47;185;44
Upstream Color;2013;Certified-Fresh;86;69;127;21;147;40
Uptown Girls;2003;Rotten;14;60;16;97;113;32
Uptown Saturday Night;1974;Fresh;67;81;6;3;9;0
Urban Cowboy;1980;Fresh;73;81;16;6;22;4
Urban Hymn;2017;Rotten;58;78;15;11;26;11
Urban Legend;1998;Rotten;21;37;12;45;57;12
Urban Legends: Bloody Mary;2005;Rotten;40;28;2;3;5;1
Urban Legends: Final Cut;2000;Rotten;9;20;7;75;82;25
Urbanized;2011;Fresh;100;85;14;0;14;9
Urge;2016;Rotten;0;24;0;6;6;2
Urok (The Lesson);2015;Fresh;83;68;19;4;23;9
Us;2019;Certified-Fresh;93;59;497;38;535;60
Us and Them;2018;Fresh;60;64;12;8;20;7
Us & Them;1900;Fresh;100;91;6;0;6;0
U.S. Marshals;1997;Rotten;25;53;9;27;36;9
The U.S. vs. John Lennon;2006;Certified-Fresh;77;81;75;22;97;34
Use Me;1900;Fresh;86;77;6;1;7;0
Used Cars;1980;Fresh;77;69;23;7;30;7
Used People;1992;Rotten;44;37;7;9;16;4
Useless Humans;2020;Rotten;40;96;4;6;10;0
Ushpizin;2005;Certified-Fresh;94;87;59;4;63;22
USS Indianapolis: Men of Courage;2016;Rotten;17;30;2;10;12;7
The Usual Suspects;1995;Certified-Fresh;89;96;68;8;76;22
V for Vendetta;2006;Certified-Fresh;73;90;183;68;251;51
In the Fog;2013;Fresh;87;60;27;4;31;17
Va Savoir;2001;Certified-Fresh;86;68;67;11;78;28
Vacancy;2007;Rotten;55;42;68;56;124;37
Vacation;2015;Rotten;27;45;47;125;171;38
Vacationland;2006;Rotten;0;23;0;6;6;4
Vai;1900;Fresh;100;;11;0;11;2
Valentine;2001;Rotten;12;33;9;67;76;23
Valentine Road;1900;Fresh;91;86;10;1;11;5
Valentine's Day;2010;Rotten;18;47;34;156;190;48
Valentino: The Last Emperor;2009;Certified-Fresh;77;78;58;17;75;28
Valerian and the City of a Thousand Planets;2017;Rotten;48;53;140;154;294;49
Valerie and Her Week of Wonders;1970;Fresh;81;80;17;4;21;8
Valhalla Rising;2010;Fresh;73;49;43;16;59;19
Valiant;2005;Rotten;32;29;36;78;114;30
Valiant;1900;Fresh;100;;5;0;5;0
Valkyrie;2008;Fresh;62;65;122;75;197;51
Valley Girl;2020;Rotten;55;87;27;22;49;12
Valley of the Dolls;1967;Rotten;35;58;13;24;37;6
Valmont;1989;Rotten;55;69;16;13;29;11
Vamp;1986;Rotten;25;48;2;6;8;1
Vampira And Me;2013;Fresh;86;80;6;1;7;1
Vampire Academy;2014;Rotten;16;55;9;49;58;11
The Vampire Bat (Blood Sucker) (Forced to Sin);1933;Fresh;60;26;3;2;5;0
Vampire in Brooklyn;1995;Rotten;12;31;4;30;34;12
Cirque du Freak: The Vampire's Assistant;2009;Rotten;38;42;53;87;140;37
Vampire's Kiss;1989;Fresh;61;53;14;9;23;6
Vampires: Los Muertos;1900;Rotten;20;39;1;4;5;0
Vampire's Seduction;1900;Rotten;40;;0;0;5;0
Vampires Suck;2010;Rotten;4;29;4;87;91;22
Vamps;2012;Rotten;56;33;10;8;18;8
Vampyr - Der Traum des Allan Grey;1932;Fresh;97;83;33;1;34;7
Vampyros Lesbos (Lesbian Vampires: The Heiress of Dracula);1970;Rotten;57;48;4;3;7;1
Van Gogh;1992;Fresh;70;67;7;3;10;4
Van Helsing;2004;Rotten;24;57;54;172;226;42
Van Wilder: The Rise of Taj (Van Wilder 2);2006;Rotten;7;38;3;42;45;19
Vanilla;1900;Fresh;87;83;13;2;15;2
Vanilla Sky;2001;Rotten;42;72;71;99;170;37
Vanishing On 7th Street;2011;Rotten;48;21;29;31;60;15
Vanishing Waves;2013;Rotten;56;52;5;4;9;4
Vanity Fair;2004;Rotten;49;50;83;85;168;43
Vantage Point;2008;Rotten;34;57;54;104;158;35
Vanya on 42nd Street;1995;Fresh;89;80;32;4;36;10
Varsity Blues;1999;Rotten;43;76;24;32;56;13
Vatel;2000;Rotten;31;61;10;22;32;11
Vaxxed: From Cover-Up to Catastrophe;2016;Rotten;38;84;5;8;13;5
Vazante;2018;Fresh;85;66;29;5;34;11
Veer-Zaara;2004;Fresh;92;88;11;1;12;6
Vegas Vacation;1997;Rotten;13;51;4;26;30;10
Vehicle 19;2013;Rotten;23;31;6;20;26;11
Velvet Buzzsaw;2019;Fresh;62;35;112;70;182;25
Velvet Goldmine;1998;Rotten;57;80;25;19;44;7
The Velveteen Rabbit;2009;Fresh;86;66;6;1;7;1
Vendetta;1900;Rotten;17;38;2;10;12;4
Vengeance Is Mine;1979;Fresh;100;89;12;0;12;2
Vengeance Valley;1951;Fresh;100;18;5;0;5;2
Venom;2018;Rotten;30;81;104;245;349;44
Venus;2006;Certified-Fresh;88;74;135;18;153;45
Venus;1900;Fresh;100;83;7;0;7;1
Venus And Serena;2013;Fresh;77;69;24;7;31;19
Venus in Fur;2014;Certified-Fresh;88;71;102;14;116;33
Vera Cruz;1954;Fresh;83;70;10;2;12;0
Vera Drake;2004;Certified-Fresh;92;84;147;13;160;43
The Verdict;1982;Fresh;88;88;29;4;33;6
Verdict on Auschwitz: The Frankfurt Trial 1963-1965;2007;Fresh;100;83;18;0;18;11
Vernon, Florida;1981;Fresh;100;79;13;0;13;0
Veronica Guerin;2003;Rotten;53;69;75;67;142;40
Veronica Mars;2014;Certified-Fresh;79;78;106;28;133;42
Verotika;2019;Rotten;24;21;4;13;17;0
Vertical Limit;2000;Rotten;48;41;53;57;110;34
Vertige (High Lane);2009;Fresh;60;33;3;2;5;0
Vertigo;1958;Certified-Fresh;94;93;76;5;81;22
Very Bad Things;1998;Rotten;41;58;24;34;58;13
A Very Brady Sequel;1996;Rotten;53;35;18;16;34;9
Very Good Girls;2014;Rotten;19;33;7;29;36;10
A Very Harold & Kumar Christmas;2011;Fresh;68;59;89;42;131;36
Very Young Girls;2007;Fresh;70;76;7;3;10;3
Veteran;2015;Fresh;90;77;9;1;10;2
VFW;2020;Fresh;81;61;44;10;54;3
V/H/S;2012;Rotten;57;41;59;44;103;27
V/H/S: Viral;2014;Rotten;34;13;11;21;32;6
VHYes;2020;Certified-Fresh;81;70;34;8;42;7
V.I. Warshawski;1991;Rotten;21;23;5;19;24;3
Vice;2015;Rotten;4;15;1;26;27;9
Vice;2018;Fresh;65;60;234;125;359;47
Vice Squad;1982;Fresh;60;64;3;2;5;0
Viceroy's House;2017;Fresh;72;66;57;22;79;23
The Vicious Kind;2009;Fresh;70;70;7;3;10;5
Vicky Cristina Barcelona;2008;Certified-Fresh;81;74;170;40;210;53
Victim;1961;Fresh;100;87;30;0;30;11
Victim;1900;Rotten;33;24;3;6;9;3
Victor Victoria;1982;Fresh;97;86;32;1;33;8
Victor Crowley;1900;Fresh;67;45;10;5;15;0
Victor Frankenstein;2015;Rotten;26;35;36;105;141;30
Victoria;2015;Certified-Fresh;82;83;110;24;134;33
Victoria & Abdul;2017;Fresh;65;68;129;68;197;41
Vida Sin Rumbo;1983;Fresh;80;62;8;2;10;2
Vidal Sassoon: The Movie;2011;Fresh;60;56;21;14;35;17
Video Games: The Movie;2014;Rotten;18;36;3;14;17;8
Videocracy;2009;Fresh;67;39;18;9;27;9
Videodrome;1983;Certified-Fresh;80;80;40;10;50;6
Viena and the Fantomes;1900;Rotten;20;25;1;4;5;2
View from the Top;2003;Rotten;14;34;17;106;123;33
A View to a Kill;1985;Rotten;38;40;23;37;60;11
Vigilante;1983;Rotten;20;69;1;4;5;0
Vigilante Diaries;2016;Rotten;14;69;1;6;7;1
Viking Destiny (Of Gods and Warriors);2018;Rotten;13;31;1;7;8;4
Vikingdom;2013;Rotten;43;25;3;4;7;4
The Vikings;1958;Fresh;76;73;16;5;21;4
Vikings: Journey to New Worlds;2004;Fresh;100;56;6;0;6;1
Viktor;1900;Rotten;0;13;0;7;7;5
The Village;2004;Rotten;43;57;94;124;218;44
The Village Barbershop;2008;Fresh;80;57;4;1;5;2
Villain ;1971;Fresh;64;45;7;4;11;5
Villain;1900;Fresh;71;53;17;7;24;7
Vincent & Theo;;Fresh;88;72;23;3;26;10
Vincent N Roxxy;2017;Rotten;41;65;7;10;17;9
Vincere;2010;Certified-Fresh;92;68;84;7;91;32
Vinyl;1900;Rotten;50;39;3;3;6;0
Viola;2013;Fresh;92;44;11;1;12;7
Violent Cop (Sono otoko, kyobo ni tsuki);1989;Fresh;83;80;5;1;6;2
Violet;2017;Fresh;84;56;16;3;19;8
Violet & Daisy;2013;Rotten;22;34;11;40;51;18
Violet Tendencies;2010;Fresh;63;50;5;3;8;3
Violeta Went to Heaven;2013;Fresh;73;83;8;3;11;7
Violette;2014;Certified-Fresh;86;69;43;7;50;23
Viral;2016;Rotten;50;29;7;7;14;0
The Virgin Suicides;2000;Certified-Fresh;77;81;77;23;100;22
Viridiana;1961;Fresh;96;90;25;1;26;5
Virtual JFK: Vietnam If Kennedy Had Lived;2008;Fresh;77;77;17;5;22;14
Virtuosity;1995;Rotten;32;32;10;21;31;9
Vision: From the Life of Hildegard von Bingen;2010;Fresh;82;71;31;7;38;15
Vision Quest;1985;Rotten;57;78;8;6;14;2
Visioneers;2008;Fresh;70;54;7;3;10;5
Visions of 8 - The Olympics of Motion Picture Achievement;1900;Rotten;50;56;3;3;6;4
Visitors;2014;Fresh;69;50;38;17;55;26
Visual Acoustics: The Modernism of Julius Shulman;2009;Fresh;94;80;17;1;18;9
Vita & Virginia;2019;Rotten;42;61;37;52;89;20
Vital;2005;Fresh;88;71;7;1;8;1
Vito;1900;Fresh;100;90;6;0;6;1
Viva Knievel!;1977;Rotten;17;14;1;5;6;2
Viva Las Vegas;1964;Fresh;86;67;24;4;28;5
Viva Riva!;2011;Certified-Fresh;86;52;51;8;59;20
Viva Zapata!;1952;Fresh;65;77;11;6;17;4
Vivan las Antipodas!;2013;Fresh;100;80;9;0;9;2
Vivarium;2020;Fresh;72;38;103;41;144;17
Vive l'Amour;1994;Fresh;83;84;5;1;6;0
Voice from the Stone;2017;Rotten;38;33;10;16;26;6
Volcanoes of the Deep Sea;2003;Fresh;78;65;7;2;9;2
Volunteers;1985;Rotten;58;33;7;5;12;3
Volver;2006;Certified-Fresh;91;89;157;15;172;51
Von Richthofen and Brown;1971;Rotten;50;35;4;4;8;3
Von Ryan's Express;1965;Fresh;89;82;17;2;19;4
VooDoo;2017;Rotten;30;96;3;7;10;3
"The Thief (Vor) (&#1042;&#1086;&#1088;)";1997;Fresh;88;88;21;3;24;8
Vox Lux;2018;Fresh;61;37;150;96;246;44
Voyage of the Damned;1976;Fresh;83;53;10;2;12;0
Voyage to the Bottom of the Sea;1961;Fresh;76;40;13;4;17;0
Voyeur;2017;Fresh;79;60;23;6;29;12
Vulgar;2002;Rotten;23;41;6;20;26;7
W.;2008;Rotten;58;42;129;93;222;56
W. Kamau Bell: Private School Negro;1900;Fresh;82;33;9;2;11;6
The Wackness;2008;Fresh;70;72;95;40;135;36
Waco: The Rules of Engagement;1997;Fresh;88;86;14;2;16;3
Wadjda;2013;Certified-Fresh;99;88;119;1;120;38
Wag the Dog;1997;Certified-Fresh;85;76;64;11;75;19
The Wages of Fear;1953;Certified-Fresh;100;95;45;0;45;9
Wagon Master;1950;Fresh;100;68;8;0;8;1
Wagons East!;1994;Rotten;0;30;0;29;29;12
Wah Do Dem;2010;Fresh;72;50;13;5;18;10
Wah-Wah;2006;Rotten;54;63;37;32;69;28
Waist Deep;2006;Rotten;28;76;21;55;76;28
Wait Until Dark;1967;Fresh;96;91;22;1;23;1
Waiting;2005;Rotten;30;75;28;64;92;29
Waiting For Dublin;2007;Rotten;7;22;1;13;14;9
Waiting for Forever;2011;Rotten;5;42;1;18;19;12
The Waiting City;2010;Fresh;75;52;12;4;16;2
Waiting for Anya;2020;Rotten;36;62;8;14;22;7
Waiting for Armageddon;2010;Fresh;80;41;16;4;20;8
Waiting for Guffman;1996;Certified-Fresh;91;91;50;5;55;12
Waiting For Lightning;2012;Rotten;43;72;9;12;21;10
Waiting for Superman;2010;Certified-Fresh;90;84;106;12;118;35
Waiting for the Barbarians;2020;Rotten;54;65;46;39;85;17
Waiting to Exhale;1995;Rotten;56;79;15;12;27;11
Waitress;2007;Certified-Fresh;89;74;155;19;174;49
Wake Wood;1900;Fresh;80;39;20;5;25;8
Wake in Fright;2012;Certified-Fresh;96;83;54;2;56;18
Wakefield;2017;Certified-Fresh;72;52;50;19;69;20
Waking Life;2001;Certified-Fresh;81;87;117;28;145;36
Waking Ned Devine;1998;Certified-Fresh;84;88;51;10;61;16
Waking Sleeping Beauty;2010;Certified-Fresh;71;80;36;15;51;16
Waking the Dead;2000;Rotten;51;78;28;27;55;13
Waking Up in Reno;2002;Rotten;13;31;5;35;40;10
Wal-Mart: The High Cost of Low Price;2005;Fresh;90;65;26;3;29;12
Waldo On Weed;1900;Fresh;100;100;7;0;7;2
Walk Away Renee;2012;Rotten;44;61;4;5;9;7
Walk, Don't Run;1966;Fresh;83;70;5;1;6;0
Walk Hard: The Dewey Cox Story;2007;Certified-Fresh;74;57;104;36;140;39
A Walk in the Clouds;1995;Rotten;44;75;12;15;27;4
Walk Of Shame;2014;Rotten;12;37;3;22;25;11
A Walk on the Moon;1999;Fresh;72;71;26;10;36;7
Walk on Water;2005;Fresh;72;87;55;21;76;25
Walk the Line;2005;Certified-Fresh;82;90;173;37;210;43
A Walk to Remember;2002;Rotten;27;78;28;75;103;30
Walk With Me;1900;Fresh;81;58;21;5;26;8
Walkabout;1971;Fresh;84;86;31;6;37;8
Walking and Talking;1996;Fresh;88;70;22;3;25;5
Walking on Sunshine;2015;Rotten;31;41;8;18;26;8
Walking Out;2017;Certified-Fresh;90;56;44;5;49;14
Walking Tall;2004;Rotten;26;60;35;101;136;35
Walking With Dinosaurs;2013;Rotten;23;41;18;59;77;22
Walking With The Enemy;2014;Rotten;45;59;17;21;38;18
WALL-E;2008;Certified-Fresh;95;90;247;12;259;53
Wall Street;1987;Certified-Fresh;79;81;44;12;56;9
Wall Street: Money Never Sleeps;2010;Rotten;55;44;130;106;236;55
Wallace & Gromit: The Curse of the Were-Rabbit;2005;Certified-Fresh;95;79;175;9;184;42
Walt & El Grupo;2008;Rotten;59;43;13;9;22;11
Walt Before Mickey;2015;Rotten;17;40;1;5;6;0
Walter;2015;Rotten;54;49;7;6;13;7
Waltz with Bashir;2008;Certified-Fresh;96;91;145;6;151;48
Wanda;1971;Fresh;92;72;33;3;36;9
Wanda Sykes: I'ma Be Me;2009;Fresh;86;;6;1;7;4
Wanda Sykes: Not Normal;1900;Fresh;100;;9;0;9;3
Wanderlust;2012;Rotten;59;39;86;59;145;44
Wanted: Dead or Alive;1987;Rotten;30;49;3;7;10;1
War (Rogue Assassin);2007;Rotten;14;51;8;51;59;15
War and Peace;1956;Rotten;43;63;3;4;7;1
The War Bride (War Bride);2001;Rotten;57;77;4;3;7;3
War Dogs;2016;Fresh;61;68;139;90;229;52
War for the Planet of the Apes;2017;Certified-Fresh;94;84;331;22;353;51
War Horse;2011;Certified-Fresh;75;74;177;60;237;50
War, Inc.;2008;Rotten;28;38;24;61;85;29
War Machine;2017;Rotten;48;34;44;48;92;33
War Made Easy;2007;Fresh;88;80;14;2;16;6
War of the Arrows (Arrow, The Ultimate Weapon);2011;Fresh;100;78;5;0;5;3
The War of the Roses;1989;Certified-Fresh;85;71;34;6;40;9
War of the Worlds;2005;Certified-Fresh;75;42;198;65;263;50
War of the Worlds: Goliath;2014;Rotten;17;45;1;5;6;4
War on Everyone;2017;Fresh;61;37;59;38;97;19
War on Whistleblowers: Free Press and the National Security State;2013;Fresh;60;69;3;2;5;4
War Requiem;;Fresh;100;62;6;0;6;0
The War Room;1993;Fresh;96;83;23;1;24;4
War Room;2015;Rotten;34;87;12;23;35;12
War Story;2014;Rotten;57;22;12;9;21;10
The War Tapes;2006;Certified-Fresh;98;83;64;1;65;27
The War Wagon;1967;Fresh;90;77;9;1;10;4
War Witch;2013;Certified-Fresh;94;78;59;4;63;21
Warcraft;2016;Rotten;28;76;65;166;231;47
WarGames (War Games);1983;Certified-Fresh;93;76;41;3;44;9
Warlock;1991;Rotten;53;47;9;8;17;2
Warlords (Tau ming chong);2010;Fresh;63;70;35;21;56;24
Warm Bodies;2013;Certified-Fresh;81;73;169;39;208;43
Warm Water Under a Red Bridge (Akai Hashi No Shita Noo Nurui Mizu);2002;Certified-Fresh;80;76;35;9;44;13
Warning Sign;1985;Rotten;11;41;1;8;9;1
Warrior King 2 (The Protector 2);2014;Rotten;18;32;4;18;22;6
Warriors of Heaven and Earth (Tian di ying xiong);2004;Fresh;68;56;21;10;31;11
Warriors of the Rainbow: Seediq Bale;2012;Fresh;71;83;10;4;14;7
Wasabi;2001;Rotten;43;69;18;24;42;14
Washington Square;1997;Fresh;81;69;25;6;31;8
Wassup Rockers;2006;Rotten;38;64;20;33;53;22
Waste Land;2010;Certified-Fresh;100;90;71;0;71;27
Wasted on the Young;2010;Fresh;60;48;12;8;20;1
Wasted! The Story of Food Waste;2017;Fresh;100;74;9;0;9;4
Watch List;2020;Fresh;100;;13;0;13;1
Watch on the Rhine;1943;Fresh;80;63;4;1;5;2
The Watcher;2000;Rotten;11;29;10;81;90;26
Watchers of the Sky;2015;Fresh;86;76;18;3;21;11
Watchmen;2009;Fresh;65;71;200;109;309;63
Water;2005;Certified-Fresh;90;90;85;9;94;33
Water for Elephants;2011;Fresh;60;70;119;78;197;48
The Water Horse: Legend of the Deep;2007;Fresh;74;62;67;23;90;34
The Waterboy;1998;Rotten;34;71;26;50;76;18
Waterland;1992;Rotten;53;61;8;7;15;7
Waterloo Bridge;1940;Fresh;80;89;4;1;5;1
Watermark;2014;Fresh;77;58;27;8;35;15
Watership Down;1978;Fresh;82;86;28;6;34;3
Waterworld;1995;Rotten;46;43;27;32;59;12
Wattstax;2000;Fresh;86;89;19;3;22;10
Waves;2019;Certified-Fresh;84;81;205;38;243;36
Waxwork II: Lost in Time;1900;Rotten;20;32;1;4;5;0
Way Down East;1920;Fresh;95;69;18;1;19;4
The Way Home (Jibeuro);2002;Certified-Fresh;75;92;42;14;56;18
The Way of the Gun;2000;Rotten;45;70;61;72;132;38
The Way We Were;1973;Fresh;63;81;17;10;27;7
Wayne;1900;Fresh;89;83;8;1;9;1
Wayne's World;1992;Certified-Fresh;84;84;43;8;51;9
Wayne's World 2;1993;Fresh;60;63;27;18;45;8
Ways To Live Forever;2013;Fresh;83;78;5;1;6;3
W.E.;2012;Rotten;12;48;14;99;113;39
We Are Boats;2019;Rotten;50;56;3;3;6;2
We Are Little Zombies;2020;Certified-Fresh;92;67;49;4;53;8
We Are Marshall;2006;Rotten;48;79;61;65;126;33
We Are Still Here;2015;Certified-Fresh;95;47;42;2;44;11
We Are the Best!;2014;Certified-Fresh;96;77;130;5;135;39
We Are the Heat;1900;;;;4;1;;0
We Are The Night;2011;Fresh;63;52;10;6;16;3
We Are Together: The Children of Agape Choir;2006;Fresh;92;84;12;1;13;3
We Are Twisted F***ing Sister!;2016;Fresh;80;61;8;2;10;7
We Are What We Are;2013;Certified-Fresh;86;50;78;13;91;29
We are Wizards;2008;Rotten;50;29;11;11;22;8
We Are X;2016;Fresh;82;86;23;5;28;11
We Are Your Friends;2015;Rotten;38;42;51;83;133;44
We Believe In Dinosaurs;2019;Fresh;91;92;10;1;11;2
We Bought a Zoo;2011;Fresh;65;71;109;59;168;49
We Come as Friends;2015;Fresh;97;62;31;1;32;13
We Don't Live Here Anymore;2004;Fresh;65;54;83;44;127;36
We Go On;1900;Fresh;100;53;10;0;10;1
We Have a Pope;2012;Fresh;65;55;53;28;81;32
We Need to Talk About Kevin;2012;Certified-Fresh;75;78;155;52;207;54
We Own the Night;2007;Rotten;57;61;86;66;152;48
We Steal Secrets: The Story Of Wikileaks;2013;Certified-Fresh;92;75;76;7;83;32
We Summon the Darkness;2020;Fresh;69;32;46;21;67;7
We the Animals;2018;Certified-Fresh;92;75;92;8;100;23
We the Parents;2013;Fresh;67;;4;2;6;3
We the Party;2012;Rotten;28;68;5;13;18;12
We The People: The Market Basket Effect;2016;Fresh;78;55;7;2;9;4
We Were Here;2011;Certified-Fresh;100;86;46;0;46;17
We Were Soldiers;2002;Fresh;63;84;93;54;147;39
The Weather Man;2005;Rotten;59;56;80;56;136;37
Web Junkie;2014;Fresh;71;50;17;7;24;11
The Wedding Banquet (Xi yan);1993;Fresh;96;100;27;1;28;8
Wedding Crashers;2005;Certified-Fresh;76;70;142;46;188;47
The Wedding Date;2005;Rotten;11;67;16;125;141;34
Wedding Palace;2013;Rotten;33;62;3;6;9;7
The Wedding Planner;2001;Rotten;17;59;18;87;105;31
The Wedding Singer;1998;Fresh;68;80;43;20;63;14
Weekend;2011;Certified-Fresh;95;86;81;4;85;34
Weekend at Bernie's;1989;Rotten;54;57;13;11;24;2
Weekend at Bernie's II;1993;Rotten;10;41;3;26;29;5
Weekend Of A Champion;2013;Fresh;73;75;11;4;15;9
The Weight of Water;2001;Rotten;35;39;23;42;65;24
Weiner;2016;Certified-Fresh;97;83;169;6;175;48
Weirdsville;2007;Rotten;58;60;19;14;33;12
Welcome to Dongmakgol;2005;Fresh;86;92;6;1;7;1
Welcome Home (The Getaway);2018;Rotten;11;30;1;8;9;3
Welcome Home Roscoe Jenkins;2008;Rotten;23;63;19;64;83;29
Welcome Home Roxy Carmichael;;Rotten;44;46;4;5;9;1
Welcome to Collinwood;2002;Rotten;55;56;37;30;67;26
Welcome To Curiosity;2018;Rotten;0;46;0;5;5;2
Welcome To Happiness;2016;Rotten;31;57;5;11;16;5
Welcome to Marwen;2018;Rotten;34;48;57;110;167;38
Welcome to Me;2015;Fresh;73;46;80;29;109;35
Welcome to Mercy;2018;Fresh;70;46;7;3;10;3
Welcome to Mooseport;2004;Rotten;13;19;19;127;146;39
Welcome To New York;2015;Certified-Fresh;76;42;42;13;55;21
Welcome to Sarajevo;1997;Fresh;80;74;28;7;35;10
Welcome to the Dollhouse;1995;Certified-Fresh;90;86;46;5;51;9
Welcome to the Jungle;2014;Rotten;22;20;2;7;9;5
Welcome to the Punch;2013;Rotten;48;36;27;29;56;14
Welcome to the Rileys;2010;Rotten;54;58;45;38;83;30
Welcome to the Sticks;2008;Fresh;67;78;6;3;9;2
Welcome to Woop Woop;1998;Rotten;32;68;6;13;19;3
We'll Never Have Paris;2015;Rotten;33;18;8;17;24;7
Wendigo;2002;Fresh;60;30;32;21;53;15
Wendy and Lucy;2008;Certified-Fresh;85;67;156;27;183;48
Went the Day Well?;1942;Fresh;93;92;13;1;14;5
Went to Coney Island on a Mission From God...Be Back by Five;1900;Rotten;43;33;3;4;7;1
We're Back! A Dinosaur's Story;1993;Rotten;38;49;6;10;16;7
We're The Millers;2013;Rotten;48;72;76;82;157;40
Were the World Mine;2008;Fresh;71;72;17;7;24;13
Werewolf of London;1935;Fresh;77;45;10;3;13;0
Werewolf: The Beast Among Us;1900;Rotten;40;37;2;3;5;0
Wes Craven Presents: Carnival of Souls;1998;Rotten;20;16;1;4;5;0
Wes Craven Presents Dracula III: Legacy;2004;Rotten;50;32;4;4;8;0
Wes Craven's New Nightmare;1994;Certified-Fresh;78;66;32;9;41;11
West of Memphis;2012;Certified-Fresh;95;87;111;6;117;31
West Side Story;1961;Certified-Fresh;92;84;72;6;78;17
Western;2018;Certified-Fresh;96;73;69;3;72;12
Westfront 1918;1930;Fresh;100;90;10;0;10;3
Westworld;1973;Fresh;87;70;33;5;38;4
Wet Hot American Summer;2001;Rotten;38;76;29;47;76;27
Wetlands;2017;Rotten;40;40;6;9;15;6
Wetlands Preserved: The Story of an Activist Rock Club;1900;Fresh;91;73;10;1;11;4
Whale Rider;2003;Certified-Fresh;91;88;141;14;155;39
Whaledreamers;2008;Rotten;50;59;3;3;6;1
The Whales of August;1987;Fresh;64;66;7;4;11;1
What a Girl Wants;2003;Rotten;35;62;38;70;108;31
What a Way to Go!;1964;Rotten;22;66;2;7;9;3
What About Bob?;1991;Certified-Fresh;84;79;36;7;43;9
What Alice Found;2003;Fresh;68;50;26;12;38;12
What Boys Like;2004;Rotten;0;32;0;6;6;2
What Did You Do in the War, Daddy?;1966;Rotten;50;72;6;6;12;4
What Doesn't Kill You;2008;Fresh;65;46;22;12;34;13
What Dreams May Come;1998;Rotten;54;84;37;32;69;16
What Ever Happened to Baby Jane?;1962;Certified-Fresh;92;92;47;4;51;10
What Happened, Miss Simone?;2015;Certified-Fresh;89;85;41;5;46;10
What Happened to Monday;2017;Rotten;58;67;21;15;36;9
What Happened Was...;1994;Fresh;90;75;19;2;21;5
What Have I Done to Deserve This? (Qu he hecho yo para merecer esto!!);1984;Fresh;78;82;7;2;9;1
What If...;2010;Rotten;33;68;2;4;6;0
What If;2014;Fresh;74;69;98;35;133;49
What Just Happened?;2008;Rotten;50;22;71;71;142;44
What Keeps You Alive;2018;Certified-Fresh;82;42;41;9;50;11
What Lies Beneath;2000;Rotten;46;58;58;67;125;31
What Lies Upstream;2018;Fresh;100;90;11;0;11;4
What Maisie Knew;2013;Certified-Fresh;87;80;97;15;112;39
What Men Want;2019;Rotten;42;34;61;85;146;34
What Our Fathers Did: A Nazi Legacy;2015;Fresh;90;73;26;3;29;15
What Richard Did;2013;Certified-Fresh;91;60;43;4;47;16
What She Said: The Art of Pauline Kael;2019;Certified-Fresh;88;52;58;8;66;14
What Still Remains;1900;Fresh;90;47;9;1;10;1
What the Bleep Do We Know!?;2004;Rotten;34;69;26;51;77;25
What They Had;2018;Certified-Fresh;86;83;99;16;115;25
What to Expect When You're Expecting;2012;Rotten;22;47;30;104;134;38
What We Did on Our Holiday;2015;Fresh;73;71;38;14;52;16
What We Do In The Shadows;2015;Certified-Fresh;96;86;177;7;184;38
What We Do Is Secret;2007;Rotten;45;53;21;26;47;22
What We Found;1900;;;;5;4;;0
What Women Want;2001;Rotten;54;54;66;56;122;34
What You Gonna Do When the World's on Fire?;2019;Certified-Fresh;87;57;41;6;47;11
Whatever Works;2009;Rotten;50;61;82;83;165;50
What's Cooking?;2000;Rotten;52;65;34;32;66;22
What's Eating Gilbert Grape;1993;Certified-Fresh;90;89;44;5;49;11
What's In A Name?;2013;Fresh;71;74;10;4;14;4
What's Love Got To Do With It?;1993;Certified-Fresh;96;88;51;2;53;16
What's New, Pussycat?;1965;Rotten;29;56;5;12;17;6
What's the Matter with Kansas?;2009;Fresh;60;58;9;6;15;6
What's the Worst That Could Happen?;2001;Rotten;10;35;10;88;98;33
What's Up, Doc?;1972;Certified-Fresh;90;89;38;4;42;8
What's Your Number?;2011;Rotten;24;44;27;87;114;37
Wheelman;2017;Fresh;88;66;21;3;24;5
When a Man Loves a Woman;1994;Fresh;71;77;15;6;21;4
When a Stranger Calls;2006;Rotten;9;44;8;85;93;18
When a Stranger Calls Back;1993;Rotten;57;55;4;3;7;1
When Comedy Went to School;2013;Rotten;55;46;18;15;33;16
When Did You Last See Your Father?;2008;Certified-Fresh;72;64;73;28;101;41
When Harry Met Sally;1989;Certified-Fresh;91;89;67;7;74;19
When Harry Tries to Marry;2011;Rotten;13;41;1;7;8;5
When I Saw You;1900;Fresh;82;72;9;2;11;5
When I Walk;2013;Fresh;88;73;15;2;17;7
When in Rome;2010;Rotten;17;41;19;94;113;32
When Jews Were Funny;1900;Fresh;67;36;4;2;6;2
When Marnie Was There;2015;Certified-Fresh;91;88;90;9;99;28
When Night Is Falling;1995;Rotten;50;81;8;8;16;4
When the Bough Breaks;2016;Rotten;12;45;3;22;25;7
When the Dragon Swallowed the Sun;2012;Fresh;60;80;6;4;10;5
When The Game Stands Tall;2014;Rotten;20;72;14;56;70;21
When the Levees Broke: A Requiem in Four Acts;2006;Fresh;97;96;33;1;34;17
When Time Ran Out;1980;Rotten;0;20;0;6;6;1
When We First Met;2018;Rotten;43;57;10;13;23;3
When Will I Be Loved;2004;Rotten;32;32;23;50;73;28
When Worlds Collide;1951;Fresh;78;63;18;5;23;5
When You're Strange;2010;Fresh;61;;43;27;70;25
Where Angels Fear to Tread;1994;Fresh;64;53;9;5;14;3
Where Do We Go Now?;2012;Rotten;53;73;40;36;76;28
Where Eagles Dare;1969;Fresh;91;89;21;2;23;6
Where God Left His Shoes;2007;Fresh;67;71;8;4;12;5
Where Hands Touch;2018;Rotten;43;71;21;28;49;10
Where Hope Grows;2015;Rotten;50;75;7;7;14;5
Where in the World Is Osama Bin Laden?;2008;Rotten;37;52;40;67;107;35
Where Is Kyra?;2018;Certified-Fresh;81;51;43;10;53;18
Where the Buffalo Roam;1980;Rotten;17;73;4;20;24;7
Where the Day Takes You;1992;Fresh;80;74;4;1;5;1
Where the Green Ants Dream (Wo die Grunen Ameisen Traumen);1985;Fresh;80;61;4;1;5;3
Where the Money Is;2000;Rotten;48;36;38;41;79;23
Where the Sidewalk Ends;1950;Fresh;100;87;15;0;15;4
Where the Truth Lies;2005;Rotten;41;46;41;60;101;32
Where the Wild Things Are;2009;Fresh;73;57;196;73;269;58
Where to Invade Next;2016;Certified-Fresh;79;77;154;41;194;42
Where'd You Go, Bernadette;2019;Rotten;49;74;91;93;184;38
Where's Daddy?;1900;Fresh;100;;6;0;6;0
Where's Marlowe?;1999;Rotten;17;53;2;10;12;4
Where's My Roy Cohn?;2019;Certified-Fresh;87;76;71;11;82;22
Which Way Home;2009;Fresh;100;92;8;0;8;4
Which Way Is the Front Line from Here? The Life and Times of Tim Hetherington;2013;Fresh;100;94;15;0;15;9
Which Way Is Up?;1977;Rotten;20;83;2;8;10;1
While She Was Out;2008;Rotten;31;17;5;11;16;3
While We're Young;2015;Certified-Fresh;84;51;172;33;205;50
While You Were Sleeping;1995;Certified-Fresh;80;79;48;12;60;20
Whip It;2009;Certified-Fresh;84;74;159;30;189;41
Whiplash;2014;Certified-Fresh;94;94;277;19;296;67
Whipped;1999;Rotten;13;32;9;59;68;25
Whirlpool;1949;Fresh;92;62;11;1;12;3
Whiskey Tango Foxtrot;2016;Fresh;68;55;142;67;209;48
Whisky;2004;Fresh;100;75;16;0;16;3
Whisky Galore;2017;Rotten;42;50;11;15;26;9
Whisper of the Heart (Mimi wo sumaseba) (If You Listen Closely);2006;Fresh;94;90;16;1;17;1
Whispering Smith;1948;Fresh;83;65;5;1;6;3
Whispers in the Dark;1992;Rotten;33;34;3;6;9;2
White Nights;1985;Rotten;46;74;6;7;13;1
White Wedding;2010;Rotten;56;52;15;12;27;11
White Bird in a Blizzard;2014;Rotten;54;43;49;41;90;29
White Boy Rick;2018;Rotten;58;50;88;65;153;34
White Chamber;2019;Rotten;43;22;3;4;7;2
White Chicks;2004;Rotten;15;55;18;106;124;35
The White Countess;2005;Rotten;49;50;44;45;89;30
White Dog;1982;Fresh;92;73;12;1;13;0
White Fang (Croc-Blanc);1900;Fresh;80;74;8;2;10;3
White Fang 2: Myth of the White Wolf;1994;Fresh;71;47;5;2;7;2
White God;2015;Certified-Fresh;88;71;98;13;111;29
White Heat;1949;Fresh;97;93;33;1;34;5
White House Down;2013;Rotten;52;62;104;97;201;46
White Hunter Black Heart;;Fresh;86;62;30;5;35;10
White Irish Drinkers;2011;Rotten;47;71;16;18;34;15
White Light/Black Rain: The Destruction of Hiroshima and Nagasaki;2007;Fresh;100;96;6;0;6;3
White Lightnin';2009;Fresh;81;72;13;3;16;5
White Lightning;1973;Fresh;86;61;6;1;7;0
White Material;2010;Certified-Fresh;86;64;77;13;90;28
White Men Can't Jump;1992;Certified-Fresh;76;68;42;13;55;16
White Noise;2005;Rotten;7;31;11;139;150;38
White Noise 2;2007;Fresh;75;43;6;2;8;0
White Oleander;2002;Fresh;68;81;93;43;136;33
White Rabbit;2015;Rotten;21;61;3;11;14;7
White Rabbit;2018;Fresh;88;67;7;1;8;3
The White Ribbon (Das weisse Band);2009;Certified-Fresh;86;79;127;21;148;41
White Sands;1992;Rotten;44;42;7;9;16;2
White Squall;1996;Rotten;58;65;21;15;36;14
The White Stripes Under Great White Northern Lights;2010;Fresh;91;90;10;1;11;4
White Water Summer;1987;Rotten;29;54;2;5;7;0
White Zombie;1932;Fresh;86;58;18;3;21;0
Whiteboyz;1999;Rotten;13;44;2;14;16;5
Whitewash;2014;Fresh;83;34;20;4;24;6
Whitey: United States of America v. James J. Bulger;2014;Certified-Fresh;80;70;40;10;50;20
Whitney;2018;Certified-Fresh;87;75;139;20;159;42
Who Killed Nancy?;2010;Rotten;33;37;7;14;21;12
Jackie Chan's Who Am I? (Wo shi shei) (Who Am I?);1998;Fresh;67;68;6;3;9;0
Who Framed Roger Rabbit;1988;Certified-Fresh;97;84;63;2;65;16
Who Is Dayani Cristal?;2014;Fresh;80;79;20;5;25;8
Who is Harry Nilsson (And Why is Everybody Talkin' About Him)?;2010;Fresh;86;87;12;2;14;6
Who is KK Downey?;2008;Fresh;100;56;5;0;5;1
Who Killed Cock Robin;1900;Rotten;50;71;3;3;6;1
Who Killed the Electric Car?;2006;Certified-Fresh;89;84;94;12;106;36
Who Needs Enemies;1900;Rotten;33;58;2;4;6;2
Who the #$&% Is Jackson Pollock?;2006;Fresh;100;72;15;0;15;7
Who Would You Take to a Deserted Island? (A quien te llevarias a una isla desierta?);1900;Fresh;83;;5;1;6;1
The Whole Nine Yards;2000;Rotten;45;64;45;56;101;27
The Whole Ten Yards;2003;Rotten;4;40;5;115;120;35
The Whole Wide World;1996;Fresh;76;72;13;4;17;6
Who'll Stop the Rain;1978;Fresh;73;64;8;3;11;2
Wholly Moses!;1980;Rotten;14;39;1;6;7;4
Whores' Glory;2012;Fresh;87;74;20;3;23;11
Who's Afraid of Virginia Woolf?;1966;Certified-Fresh;95;91;41;2;43;8
Who's Camus Anyway?;1900;Fresh;86;75;6;1;7;1
Who's Driving Doug;1900;Rotten;20;46;1;4;5;4
Who's Harry Crumb?;1989;Rotten;27;46;3;8;11;0
Who's That Girl?;1987;Rotten;38;47;6;10;16;1
Who's That Knocking at My Door?;1967;Fresh;70;61;14;6;20;6
Who's Watching Oliver;1900;Fresh;86;58;6;1;7;0
Who's Your Caddy?;2007;Rotten;6;59;2;32;34;11
Whose Life Is It Anyway?;1981;Fresh;70;79;7;3;10;2
Why Did I Get Married?;2007;Rotten;48;78;20;22;42;13
Why Did I Get Married Too;2010;Rotten;27;68;13;36;49;17
Why Do Fools Fall In Love;1998;Rotten;52;76;30;28;58;20
Why Don't You Just Die! (Papa, sdokhni);2020;Certified-Fresh;97;81;68;2;70;9
Why Don't You Play in Hell?;2014;Certified-Fresh;80;80;33;8;41;13
Why Him?;2016;Rotten;39;51;60;95;155;33
Why Stop Now?;2012;Rotten;25;28;5;15;20;10
Wichita;1955;Fresh;100;67;7;0;7;2
Wicked Little Things;2006;Rotten;40;34;2;3;5;0
Wicker Park;2004;Rotten;27;79;36;99;135;41
Wide Awake;2006;Fresh;80;52;4;1;5;2
The Widow of Saint-Pierre (The Widow of St. Pierre) (La veuve de Saint-Pierre);2000;Certified-Fresh;90;78;69;8;77;31
Widows;2018;Certified-Fresh;91;61;374;37;411;53
Widows' Peak;1994;Fresh;94;51;15;1;16;4
Wiener-Dog;2016;Certified-Fresh;74;41;85;30;115;40
The Wilby Conspiracy;1975;Fresh;60;44;3;2;5;0
Wilby Wonderful;2005;Fresh;71;65;5;2;7;3
Wild;2014;Certified-Fresh;88;75;240;32;272;58
Wild America;1997;Rotten;27;59;6;16;22;8
The Wild Angels;1966;Fresh;63;45;12;7;19;4
Wild Bill;1995;Rotten;44;27;11;14;25;4
Wild Bill;2011;Fresh;100;82;26;0;26;5
Wild City;2015;Rotten;50;35;4;4;8;4
Wild Combination: A Portrait of Arthur Russell;2008;Fresh;100;82;5;0;5;3
Wild Hearts Can't Be Broken;1991;Fresh;73;89;8;3;11;2
Wild Hogs;2007;Rotten;14;61;20;124;144;44
Wild Honey Pie!;2017;Rotten;20;;1;4;5;2
Wild Horse, Wild Ride;2012;Fresh;81;84;13;3;16;6
Wild Horses;2015;Rotten;17;16;2;10;12;8
Wild in the Country;1961;Rotten;50;58;4;4;8;0
Wild Man Blues;1998;Fresh;86;65;32;5;37;10
The Wild One;1954;Fresh;78;72;18;5;23;3
The Wild Parrots of Telegraph Hill;2005;Certified-Fresh;95;85;96;5;101;31
Wild River;1960;Fresh;100;83;12;0;12;7
Wild Rose;2019;Certified-Fresh;92;87;175;15;190;33
Wild Rovers;1971;Rotten;57;44;8;6;14;6
Wild Strawberries;1957;Certified-Fresh;95;94;42;2;44;6
Wild Style;2013;Fresh;89;87;16;2;18;12
Wild Tales;2015;Certified-Fresh;94;92;147;9;156;39
Wild Target;2010;Rotten;33;56;18;37;55;17
Wild Thing;1987;Rotten;40;56;2;3;5;3
Wild Things;1998;Fresh;62;53;38;23;61;19
The Wild Thornberrys Movie;2002;Certified-Fresh;80;51;71;18;89;30
Vince Vaughn's Wild West Comedy Show: 30 Days & 30 Nights - Hollywood to the Heartland;2008;Rotten;59;50;52;36;88;35
Wild Wild West;1999;Rotten;17;28;22;109;131;39
Wildcats;1986;Rotten;22;49;4;14;18;4
Wilde;1998;Fresh;71;73;35;14;49;13
Wilderness;2006;Rotten;25;47;2;6;8;0
Wilderness Survival For Girls;1900;Rotten;50;37;3;3;6;5
Wildlife;2018;Certified-Fresh;93;73;192;14;206;44
Wildling;2018;Fresh;70;40;32;14;46;8
Will;2011;Rotten;0;45;0;5;5;1
Will Ferrell: You're Welcome America - A Final Night with George W Bush;2009;Fresh;60;62;3;2;5;2
Will Penny;1968;Fresh;85;72;11;2;13;2
Will Success Spoil Rock Hunter?;1957;Fresh;86;76;19;3;22;6
Will You Still Love Me Tomorrow?;2014;Fresh;83;;5;1;6;2
Willard;2003;Fresh;64;51;83;47;130;30
William S. Burroughs: A Man Within;2010;Fresh;88;77;15;2;17;6
William;2019;Rotten;42;50;5;7;12;6
Romeo + Juliet;1996;Fresh;72;77;47;18;65;19
Willow;1988;Rotten;51;79;27;26;53;12
Willow Creek;2014;Certified-Fresh;81;34;46;11;57;12
Willy Wonka and the Chocolate Factory;1971;Fresh;90;87;43;5;48;4
Wilson;2017;Rotten;47;30;62;69;131;33
Wimbledon;2004;Fresh;61;57;89;57;146;39
Win a Date With Tad Hamilton!;2004;Rotten;54;47;80;68;148;37
Win It All;2017;Certified-Fresh;85;55;34;6;40;8
Win Win;2011;Certified-Fresh;94;85;166;10;176;45
Winchester;2018;Rotten;13;32;17;113;130;19
The Wind and the Lion;1975;Fresh;63;70;10;6;16;0
Wind Chill;2007;Rotten;46;31;11;13;24;9
Wind River;2017;Certified-Fresh;88;90;218;31;249;44
The Wind That Shakes the Barley;2007;Certified-Fresh;90;87;105;12;117;36
Windfall;2012;Fresh;72;44;13;5;18;12
The Windmill Movie;2009;Fresh;86;67;18;3;21;10
Windtalkers;2002;Rotten;33;50;55;114;169;42
Wine Country;2019;Fresh;65;30;55;29;84;22
Wing Commander;1999;Rotten;10;25;5;46;51;12
Winged Migration;2003;Certified-Fresh;95;87;127;6;133;38
Wings;1927;Certified-Fresh;93;78;43;3;46;9
Wings of Desire;1987;Certified-Fresh;98;93;55;1;56;9
The Wings of Eagles;1957;Rotten;40;57;2;3;5;0
The Wings of the Dove;1997;Fresh;84;78;27;5;32;9
Winnebago Man;2010;Certified-Fresh;90;80;56;6;62;26
Winnie Mandela;2013;Rotten;19;56;7;30;37;19
Winnie the Pooh;2011;Certified-Fresh;91;80;118;12;130;39
The Winning Season;2010;Rotten;50;55;11;11;22;6
Winning: The Racing Life Of Paul Newman;2015;Fresh;90;91;9;1;10;5
Winter In The Blood;2014;Fresh;67;76;8;4;12;6
Winter in Wartime;2011;Certified-Fresh;75;78;49;16;65;22
Winter Kills;1979;Fresh;88;55;15;2;17;4
Nattvardsgasterna (Winter Light);1962;Fresh;73;91;16;6;22;5
Winter Passing;2006;Rotten;42;62;22;31;53;20
Winter People;1989;Rotten;11;50;1;8;9;4
Winter Solstice;2005;Fresh;60;43;49;32;81;26
Winter's Tale;2014;Rotten;13;43;20;134;154;36
Wirey Spindell;1999;Rotten;24;85;4;13;17;5
Wise Blood;1979;Fresh;87;75;20;3;23;6
Wise Guys;1986;Rotten;31;41;5;11;16;1
Wish I Was Here;2014;Rotten;47;59;62;68;129;39
Wish Upon;2017;Rotten;19;30;18;76;94;23
Wish You Were Here;2013;Fresh;71;49;48;19;66;19
Wishmaster;1997;Rotten;27;38;9;24;33;6
Wishmaster 2: Evil Never Dies;1999;Rotten;9;29;1;10;11;0
Wishmaster 4: The Prophecy Fulfilled;2002;Rotten;20;23;1;4;5;0
Wit;1900;Fresh;83;91;10;2;12;3
Witchboard;1986;Rotten;50;41;7;7;14;0
Witches in the Woods;1900;Rotten;57;62;4;3;7;0
The Witches of Eastwick;1987;Fresh;76;62;26;8;34;1
Witching and Bitching;2014;Fresh;86;60;25;4;29;7
With a Friend like Harry...;2001;Certified-Fresh;96;79;89;4;93;27
With Friends Like These;1998;Rotten;50;40;7;7;14;5
With Honors;1994;Rotten;17;73;4;20;24;4
Withnail and I;1987;Fresh;94;94;33;2;35;6
Without;1900;Fresh;90;;9;1;10;2
Without a Clue;1988;Fresh;60;72;6;4;10;1
Without a Paddle;2004;Rotten;14;68;18;108;126;32
Without Limits;1998;Fresh;79;91;31;8;39;17
Without Name;1900;Fresh;81;50;13;3;16;3
Witless Protection;2008;Rotten;4;46;1;27;28;7
Witness for the Prosecution;1957;Fresh;100;95;31;0;31;5
Witnesses;2004;Fresh;90;81;9;1;10;6
The Wiz;1978;Rotten;42;65;14;19;33;7
The Wizard;1989;Rotten;32;60;7;15;22;3
Wizards;1977;Rotten;59;70;16;11;27;3
Wolf;1900;Fresh;71;69;5;2;7;2
Wolf Creek;2005;Rotten;53;49;62;54;116;29
Wolf Creek 2;2014;Rotten;50;39;26;26;52;11
The Wolf Man;1941;Certified-Fresh;90;80;36;4;40;8
Wolf Totem;2015;Fresh;67;50;20;10;30;15
Wolf Warrior II;2017;Fresh;69;75;9;4;13;4
WolfCop;1900;Fresh;65;46;13;7;20;3
Wolfen;1981;Fresh;75;46;18;6;24;1
Wolke Neun (Cloud 9);2008;Certified-Fresh;89;58;39;5;44;20
X-Men Origins - Wolverine;2009;Rotten;37;58;97;164;261;58
Wolves;2014;Rotten;25;32;5;15;20;8
Wolves;2017;Rotten;33;45;9;18;27;9
Woman in Gold;1900;Rotten;57;79;87;65;152;42
The Woman in Red;1984;Rotten;35;38;6;11;17;5
Woman in the Dunes (Suna no Onna);1964;Fresh;100;93;29;0;29;8
Frau im Mond (By Rocket to the Moon) (Woman in the Moon);1929;Fresh;75;72;6;2;8;1
Woman of the Year;1942;Fresh;89;80;24;3;27;5
Woman on the Run;1950;Fresh;83;78;6;1;6;2
Woman on Top;2000;Rotten;35;42;34;64;98;31
Woman Thou Art Loosed;2004;Rotten;51;84;30;29;59;26
Woman Thou Art Loosed: On the 7th Day;2012;Rotten;20;69;2;8;10;6
A Woman Under the Influence;1975;Fresh;90;92;28;3;31;10
Woman Walks Ahead;2018;Rotten;53;60;20;18;38;12
!Women Art Revolution;2011;Fresh;84;60;21;4;25;12
Women in Trouble;2009;Rotten;29;27;7;17;24;10
Women on the Verge of a Nervous Breakdown (Mujeres al Borde de un Ataque de Nervios);1988;Fresh;90;89;27;3;30;4
Won Ton Ton, the Dog Who Saved Hollywood;1976;Rotten;20;60;1;4;5;0
Wonder;2017;Certified-Fresh;85;88;162;28;190;36
Wonder Boys;2000;Certified-Fresh;82;83;102;23;125;30
Wonder Park;2019;Rotten;34;44;36;70;106;21
Wonder Wheel;2017;Rotten;31;41;62;136;198;42
Wonder Woman;2009;Fresh;82;78;9;2;11;0
Wonder Woman;2017;Certified-Fresh;93;86;427;32;458;59
Wonder Woman: Bloodlines;1900;Fresh;88;50;7;1;8;0
The Wonderful Ice Cream Suit;1998;Fresh;83;71;5;1;6;0
Wonderful Town;2007;Fresh;88;56;21;3;24;8
Wonderland;2003;Rotten;34;65;35;67;102;33
Wonders Are Many: The Making of Doctor Atomic;2008;Fresh;85;;11;2;13;7
Wonders of the Sea;2019;Fresh;76;100;13;4;17;4
Wonderstruck;2017;Fresh;68;55;152;71;223;49
Wonderwall;1969;Fresh;80;40;4;1;5;0
Wong Fei-hung chi tit gai dau neung gung (Deadly China Hero) (Claws of Steel) (Last Hero in China);1993;Fresh;67;72;4;2;6;1
Won't Back Down;2012;Rotten;35;61;37;69;106;36
Won't You Be My Neighbor?;2018;Certified-Fresh;97;94;242;7;249;45
Woo;1998;Rotten;10;62;4;36;40;16
The Wood;1999;Fresh;61;92;35;22;57;18
Woodlawn;2015;Fresh;73;81;11;4;15;3
Woodshock;2017;Rotten;24;24;13;42;55;22
The Woodsman;2004;Certified-Fresh;88;77;117;16;133;37
Woodstock: 3 Days of Peace & Music;1970;Fresh;100;92;24;0;24;2
Woodstock: Three Days That Defined a Generation;2019;Fresh;86;83;25;4;29;9
Woody Woodpecker;1900;Rotten;13;32;1;7;8;0
Wool 100%;2007;Fresh;100;75;5;0;5;2
Word Wars;2004;Fresh;88;67;30;4;34;16
Wordplay;2006;Certified-Fresh;94;80;116;7;123;39
Words and Music;1948;Rotten;20;63;1;4;5;1
Words And Pictures;2014;Rotten;43;50;40;53;93;28
Working Girl;1988;Certified-Fresh;84;67;37;7;44;8
Working Girls;1987;Fresh;90;;9;1;10;1
Working Man;2020;Certified-Fresh;93;82;39;3;42;7
Workingman's Death;2006;Fresh;75;95;9;3;12;8
World War Z;2013;Fresh;66;72;183;94;277;57
The World According to Garp;1982;Fresh;74;79;14;5;19;2
The World Is Not Enough;1999;Rotten;52;49;75;68;143;36
The World of Henry Orient;1964;Fresh;91;58;10;1;11;0
The World of Suzie Wong;1960;Rotten;38;67;3;5;8;3
World of the Dead: The Zombie Diaries 2;2011;Rotten;0;18;0;7;7;3
The World, the Flesh and the Devil;2000;;;67;3;2;;0
World Trade Center;2006;Fresh;67;60;156;77;233;51
The World Unseen;2008;Rotten;24;69;6;19;25;11
The World's Fastest Indian;2005;Certified-Fresh;82;89;117;26;143;35
Would You Rather;2013;Rotten;59;36;13;9;22;8
Wounds;2019;Rotten;49;14;28;29;57;9
The Wraith;1986;Rotten;36;61;5;9;14;3
Wreck-it Ralph;2012;Certified-Fresh;87;86;163;25;188;44
Wrecked;2011;Rotten;48;24;13;14;27;10
Wrecker;2015;Rotten;0;14;0;7;7;1
Wrestling Ernest Hemingway;1994;Rotten;57;69;12;9;21;8
Wrinkles;2014;Fresh;93;80;26;2;28;13
Wrinkles the Clown;2019;Fresh;71;39;24;10;34;5
Wristcutters: A Love Story;2007;Fresh;67;82;62;31;93;31
Written in Blood;2002;Rotten;0;18;0;5;5;0
Wrong;2013;Fresh;67;54;28;14;42;17
Wrong Cops;2013;Rotten;55;42;6;5;11;4
Wrong Is Right;1982;Rotten;30;39;3;7;10;3
Wrong Turn;2003;Rotten;40;54;33;50;83;16
Wrong Turn 2: Dead End;2007;Fresh;70;44;7;3;10;0
Wrongfully Accused;1998;Rotten;21;57;7;26;33;7
Wu xia (Dragon);2012;Fresh;85;74;23;4;27;13
Wuthering Heights;1900;Rotten;25;66;3;9;12;3
Wuthering Heights;2012;Fresh;68;47;77;36;113;35
X2: X-Men United;2003;Certified-Fresh;85;85;208;37;245;52
The X-Files: I Want to Believe (The X Files 2);2008;Rotten;31;32;51;115;166;41
X-Men: The Last Stand;2006;Rotten;57;61;136;102;238;50
X-Men: Apocalypse;2016;Rotten;47;65;159;181;340;53
X-Men: Days of Future Past;2014;Certified-Fresh;90;91;295;32;327;60
X-Men: First Class;2011;Certified-Fresh;86;87;253;42;295;56
X: Night of Vengeance;2011;Fresh;70;37;14;6;20;3
'X'---The Man With the X-Ray Eyes;1963;Fresh;88;66;22;3;25;5
Xanadu;1980;Rotten;27;58;11;30;41;8
Xchange;2001;Rotten;0;30;0;5;5;0
Xenia;2015;Fresh;86;55;12;2;14;5
The X-Files - Fight the Future;1998;Fresh;66;72;48;25;73;18
Xizao;2000;Fresh;87;92;26;4;30;5
X-Men;2000;Certified-Fresh;81;83;140;32;172;40
XOXO;1900;Fresh;71;52;5;2;7;3
XX;2017;Fresh;70;19;43;18;61;11
XX/XY;2003;Rotten;43;44;27;36;63;28
XXX;2002;Rotten;48;58;87;93;180;36
xXx: Return of Xander Cage;2017;Rotten;45;37;66;82;148;28
xXx: State of the Union;2005;Rotten;17;32;23;115;138;34
XXY;2007;Certified-Fresh;85;80;40;7;47;19
Y Tu Mama Tambien;2001;Certified-Fresh;92;88;127;11;138;33
Yakuza Apocalypse;2015;Fresh;61;39;25;16;41;14
Yankee Doodle Dandy;1942;Fresh;90;83;26;3;29;4
Yanks;1979;Rotten;57;63;12;9;21;4
The Yards;2000;Fresh;64;51;62;35;97;35
Yarn;2016;Fresh;78;39;7;2;9;5
Ye ben (Fleeing by Night);2000;Rotten;40;84;4;6;10;5
The Year My Voice Broke;1987;Fresh;94;84;15;1;16;5
The Year of Living Dangerously;1983;Fresh;88;77;28;4;32;6
Year of the Comet;1992;Rotten;0;47;0;11;11;2
Year of the Dog;2007;Fresh;69;43;100;44;144;47
Year of the Fish;2007;Rotten;58;58;14;10;24;11
Year One;2009;Rotten;14;23;25;149;174;46
Yeh Jawaani Hai Deewani;2013;Rotten;57;64;4;3;7;1
Yella;2008;Certified-Fresh;80;53;43;11;54;20
Yelling to the Sky;2012;Rotten;36;46;4;7;11;7
Yellowbeard;1983;Rotten;22;64;2;7;9;1
Yellowbrickroad;2011;Rotten;50;30;9;9;18;6
Yentl;1983;Fresh;65;75;11;6;17;1
Yes, Giorgio;1982;Rotten;33;38;2;4;6;2
Yes, God, Yes;2020;Certified-Fresh;94;68;102;7;109;15
Yes Man;2008;Rotten;46;66;72;84;156;43
The Yes Men;2004;Certified-Fresh;85;67;71;13;84;29
The Yes Men Fix the World;2009;Certified-Fresh;75;78;43;14;57;24
Yesterday;2019;Fresh;63;89;220;129;349;43
Yesterday, Today and Tomorrow (Ieri, oggi, domani);1963;Fresh;88;81;7;1;8;0
Yesterday Was a Lie;2009;Fresh;83;83;5;1;6;1
Yoga Hosers;2016;Rotten;23;35;14;46;60;13
Yogawoman;2012;Rotten;36;78;4;7;11;5
Yogi Bear;2010;Rotten;13;34;13;91;104;25
Yojimbo;1961;Certified-Fresh;95;96;38;2;40;7
Yom Yom;2001;Rotten;50;;3;3;6;1
Yonkers Joe;2009;Rotten;55;50;12;10;22;9
Yosemite;2016;Fresh;77;;10;3;13;7
Yossi;2013;Certified-Fresh;89;70;40;5;45;23
You Don't Know Jack;1900;Certified-Fresh;83;83;20;4;24;15
You Won't Miss Me;2010;Fresh;64;64;7;4;11;5
You Again;2010;Rotten;19;43;18;77;95;27
You Can Count On Me;2000;Certified-Fresh;95;88;100;5;105;32
You Cannot Kill David Arquette;2020;Certified-Fresh;87;95;39;6;45;9
You Can't Take It With You;1938;Certified-Fresh;93;88;41;3;44;11
You Don't Mess With the Zohan;2008;Rotten;38;45;71;118;189;50
You Don't Need Feet to Dance;2013;Rotten;50;;4;4;8;3
You Don't Nomi;1900;Certified-Fresh;89;60;68;8;76;15
You Get Me;2017;;;27;0;4;;0
You Got Served;2004;Rotten;14;70;10;61;71;20
You Got Served: Beat The World;1900;Rotten;0;21;0;5;5;2
You May Not Kiss the Bride;2012;Rotten;0;33;0;9;9;4
You, Me and Dupree;2006;Rotten;20;50;34;135;169;42
You Might Be the Killer;1900;Fresh;60;48;12;8;20;0
You Only Live Twice;1967;Certified-Fresh;73;68;38;14;52;8
You Should Have Left;1900;Rotten;40;23;44;65;109;20
You Were Never Really Here;2018;Certified-Fresh;89;65;247;30;277;42
You Will Be My Son;2013;Fresh;89;69;33;4;37;17
You Will Meet a Tall Dark Stranger;2010;Rotten;46;33;62;74;136;44
Young Adult;2011;Certified-Fresh;80;49;156;39;195;50
Young & Beautiful (Jeune Et Jolie);2014;Certified-Fresh;73;61;60;22;82;37
Young and Innocent;1938;Fresh;100;63;18;0;18;4
Young at Heart;1954;Fresh;86;79;6;1;7;0
The Young Black Stallion;2003;Rotten;45;68;18;22;40;15
Young Einstein;1988;Rotten;36;50;12;21;33;10
Young Frankenstein;1974;Certified-Fresh;94;92;63;4;67;7
Young Guns;1988;Rotten;41;76;15;22;37;9
Young Guns II;;Rotten;35;66;6;11;17;3
The Young Lions;1958;Fresh;71;77;5;2;7;0
Young Man With a Horn;1950;Fresh;80;71;4;1;5;1
Young Mr. Lincoln;1939;Fresh;100;81;22;0;22;4
Young Ones;2014;Rotten;50;33;17;17;34;12
The Young Savages;1961;Rotten;50;47;4;4;8;0
Young Sherlock Holmes;1985;Fresh;64;63;14;8;22;2
The Young Victoria;2009;Certified-Fresh;76;74;119;37;156;42
Young Yakuza;2008;Rotten;30;31;3;7;10;5
Young@Heart;2007;Certified-Fresh;89;91;93;12;105;35
Il Tuo Vizio e una Stanza Chiusa e Solo Io ne ho la Chiave (Your Vice Is a Locked Room and Only I Have the Key);1972;Fresh;100;67;7;0;7;0
Your Friends & Neighbors;1998;Certified-Fresh;77;64;44;13;57;21
Your Highness;2011;Rotten;28;34;50;131;181;44
Your Mommy Kills Animals;2007;Fresh;91;73;32;3;35;4
Your Name. (Kimi No Na Wa.);2017;Certified-Fresh;98;94;112;2;114;27
Your Sister's Sister;2012;Certified-Fresh;83;66;121;24;145;48
Your Son (Tu Hijo);1900;Fresh;100;60;5;0;5;0
You're Next;2013;Certified-Fresh;78;60;124;34;158;33
You're Not You;2014;Rotten;48;70;11;12;23;10
Yours, Mine & Ours;2005;Rotten;6;51;6;101;107;34
Youssou Ndour: I Bring What I Love;2009;Fresh;83;74;20;4;24;13
Youth;2015;Certified-Fresh;72;69;153;59;212;46
Youth in Oregon;2017;Rotten;45;50;9;11;20;8
Youth in Revolt;2010;Fresh;66;52;113;58;171;44
Youth Without Youth;2007;Rotten;32;44;34;71;105;40
You've Been Trumped;2012;Fresh;85;72;29;5;34;19
You've Got Mail;1998;Fresh;70;73;62;27;89;22
Yu-Gi-Oh!: The Movie;2004;Rotten;5;49;3;63;66;22
Yukinojo Henge (An Actor's Revenge);1971;Fresh;95;82;19;1;20;6
Ten Nights of Dreams (Yume ju-ya);2006;Fresh;80;47;4;1;5;2
Yves Saint Laurent - L'amour fou;2011;Fresh;62;56;31;19;50;19
Z;1969;Certified-Fresh;93;93;43;3;46;14
Z;1900;;;;26;1;;2
Z For Zachariah;2015;Certified-Fresh;79;45;71;19;90;26
Zambezia;1900;Rotten;25;43;2;6;8;1
Zandalee;1991;Rotten;33;29;2;4;6;1
Zarafa;2015;Fresh;75;65;15;5;20;7
Zardoz;1974;Rotten;45;54;15;18;33;7
Zathura: A Space Adventure;2005;Certified-Fresh;76;51;122;39;161;37
Zatoichi (The Blind Swordsman: Zatoichi);2003;Certified-Fresh;87;88;110;17;127;37
Zaytoun;2013;Rotten;46;51;18;21;39;15
Zen Noir;2006;Rotten;29;68;4;10;14;6
Zenith;2011;Rotten;55;39;6;5;11;7
Zero Bridge;2011;Fresh;77;44;10;3;13;4
Zero Charisma;2013;Fresh;76;55;19;6;25;8
Zero Dark Thirty;2013;Certified-Fresh;91;80;272;26;298;58
Zero Days;2016;Certified-Fresh;92;75;65;6;71;25
Zero Effect;1997;Fresh;65;77;33;18;51;12
Zero Motivation;2014;Certified-Fresh;88;77;44;6;49;16
Zerophilia;2005;Rotten;25;61;5;15;20;11
Zeus and Roxanne;1997;Rotten;44;42;4;5;9;1
Ziegfeld Follies;1900;Fresh;70;58;7;3;10;0
Ziggy Stardust and the Spiders from Mars;1973;Fresh;73;88;29;11;40;14
Zindagi Na Milegi Dobara;2011;Fresh;92;86;11;1;12;3
Zipper;2015;Rotten;20;26;6;24;30;12
Zodiac;2007;Certified-Fresh;89;77;225;28;253;60
Zombeavers;2015;Fresh;69;31;25;11;36;7
Zombie (Zombi 2);1980;Rotten;42;69;11;15;26;1
Zombie for Sale;1900;Fresh;89;78;25;3;28;1
Zombie Strippers;2008;Rotten;39;30;25;39;64;16
Zombieland;2009;Certified-Fresh;89;86;227;28;255;49
Zombieland: Double Tap;2019;Fresh;68;88;166;78;244;31
ZMD: Zombies of Mass Destruction;2009;Fresh;67;34;4;2;6;0
Zoo;2018;Fresh;88;62;15;2;17;3
Zookeeper;2011;Rotten;14;41;18;114;132;36
Zoolander;2001;Fresh;64;80;88;50;138;33
Zoolander 2;2016;Rotten;22;20;51;181;232;48
Zoom;2006;Rotten;4;33;3;65;68;19
Zoot Suit;1981;Rotten;56;74;5;4;9;2
Zootopia;2016;Certified-Fresh;98;92;285;7;291;50
Zorba the Greek;1964;Fresh;80;86;8;2;10;0
Zulu;1964;Fresh;96;91;22;1;23;6
Zulu Dawn;1979;Rotten;50;62;4;4;8;0
